資訊時間,成交時間,商品代號,ITEM,成交價,成交量,總量,買單量,賣單量
8450008,8450007,TXFE7,128,9951,451,451,152,222
8450009,8450008,TXFE7,128,9951,2,453,153,224
8450011,8450010,TXFE7,128,9951,2,455,154,226
8450011,8450010,TXFE7,128,9951,1,456,155,227
8450011,8450010,TXFE7,128,9951,5,461,156,232
8450015,8450013,TXFE7,128,9951,1,462,157,233
8450021,8450020,TXFE7,128,9951,1,463,158,234
8450029,8450021,TXFE7,128,9950,3,466,160,235
8450042,8450035,TXFE7,128,9951,2,468,161,236
8450042,8450035,TXFE7,128,9951,1,469,162,237
8450042,8450035,TXFE7,128,9951,1,470,163,238
8450042,8450038,TXFE7,128,9950,2,472,164,239
8450042,8450039,TXFE7,128,9951,2,474,165,240
8450054,8450043,TXFE7,128,9950,2,476,166,241
8450054,8450046,TXFE7,128,9951,1,477,167,242
8450054,8450050,TXFE7,128,9951,1,478,168,243
8450054,8450053,TXFE7,128,9950,2,480,169,244
8450067,8450054,TXFE7,128,9950,2,482,170,245
8450067,8450057,TXFE7,128,9951,6,488,171,246
8450067,8450061,TXFE7,128,9950,3,491,172,247
8450067,8450066,TXFE7,128,9950,2,493,173,248
8450079,8450068,TXFE7,128,9950,2,495,174,249
8450079,8450072,TXFE7,128,9950,1,496,175,250
8450079,8450073,TXFE7,128,9951,2,498,176,251
8450079,8450075,TXFE7,128,9951,1,499,177,252
8450092,8450079,TXFE7,128,9950,1,500,178,253
8450092,8450081,TXFE7,128,9951,1,501,179,254
8450092,8450084,TXFE7,128,9950,1,502,180,255
8450104,8450100,TXFE7,128,9951,2,504,181,256
8450117,8450115,TXFE7,128,9951,2,506,182,257
8450117,8450116,TXFE7,128,9950,1,507,183,258
8450129,8450118,TXFE7,128,9950,1,508,184,259
8450129,8450119,TXFE7,128,9950,5,513,185,260
8450129,8450119,TXFE7,128,9950,5,518,187,261
8450129,8450127,TXFE7,128,9950,5,523,189,262
8450142,8450132,TXFE7,128,9950,2,525,190,263
8450142,8450134,TXFE7,128,9950,9,534,197,264
8450142,8450137,TXFE7,128,9951,1,535,198,265
8450154,8450145,TXFE7,128,9951,1,536,199,266
8450154,8450148,TXFE7,128,9950,1,537,200,267
8450167,8450156,TXFE7,128,9951,2,539,201,268
8450167,8450157,TXFE7,128,9951,2,541,202,269
8450167,8450157,TXFE7,128,9950,17,558,208,270
8450167,8450162,TXFE7,128,9950,1,559,209,271
8450167,8450165,TXFE7,128,9951,3,562,210,272
8450179,8450167,TXFE7,128,9950,1,563,211,273
8450179,8450171,TXFE7,128,9950,1,564,212,274
8450179,8450175,TXFE7,128,9950,1,565,213,275
8450179,8450177,TXFE7,128,9950,1,566,214,276
8450192,8450179,TXFE7,128,9950,3,569,216,277
8450192,8450192,TXFE7,128,9950,5,574,220,278
8450204,8450199,TXFE7,128,9950,1,575,221,279
8450217,8450207,TXFE7,128,9950,20,595,223,280
8450217,8450209,TXFE7,128,9950,1,596,224,281
8450217,8450211,TXFE7,128,9950,1,597,225,282
8450217,8450215,TXFE7,128,9951,1,598,226,283
8450229,8450221,TXFE7,128,9950,1,599,227,284
8450229,8450226,TXFE7,128,9951,2,601,228,285
8450242,8450233,TXFE7,128,9951,2,603,229,286
8450242,8450239,TXFE7,128,9950,1,604,230,287
8450242,8450240,TXFE7,128,9950,3,607,231,288
8450254,8450245,TXFE7,128,9951,1,608,232,289
8450254,8450252,TXFE7,128,9950,1,609,233,290
8450267,8450257,TXFE7,128,9950,3,612,234,291
8450267,8450259,TXFE7,128,9951,1,613,235,292
8450279,8450276,TXFE7,128,9950,1,614,236,293
8450279,8450277,TXFE7,128,9950,1,615,237,294
8450279,8450279,TXFE7,128,9950,5,620,238,295
8450292,8450279,TXFE7,128,9950,3,623,239,296
8450292,8450284,TXFE7,128,9950,3,626,240,297
8450292,8450289,TXFE7,128,9950,1,627,241,298
8450292,8450291,TXFE7,128,9950,3,630,242,299
8450304,8450294,TXFE7,128,9951,1,631,243,300
8450304,8450300,TXFE7,128,9951,1,632,244,301
8450304,8450301,TXFE7,128,9950,3,635,245,302
8450317,8450306,TXFE7,128,9950,1,636,246,303
8450317,8450309,TXFE7,128,9951,1,637,247,304
8450317,8450314,TXFE7,128,9950,1,638,248,305
8450317,8450315,TXFE7,128,9950,3,641,249,306
8450317,8450315,TXFE7,128,9950,2,643,250,307
8450329,8450320,TXFE7,128,9950,4,647,251,308
8450342,8450330,TXFE7,128,9950,3,650,252,309
8450342,8450331,TXFE7,128,9950,24,674,253,310
8450354,8450342,TXFE7,128,9950,6,680,254,311
8450354,8450342,TXFE7,128,9950,4,684,255,312
8450354,8450342,TXFE7,128,9950,2,686,256,313
8450354,8450342,TXFE7,128,9950,25,711,260,314
8450354,8450348,TXFE7,128,9950,6,717,261,317
8450367,8450354,TXFE7,128,9949,4,721,265,318
8450367,8450354,TXFE7,128,9949,1,722,266,319
8450367,8450355,TXFE7,128,9948,1,723,267,320
8450367,8450366,TXFE7,128,9949,2,725,268,321
8450379,8450367,TXFE7,128,9948,2,727,270,322
8450379,8450367,TXFE7,128,9948,6,733,273,323
8450379,8450372,TXFE7,128,9949,1,734,274,324
8450379,8450375,TXFE7,128,9949,1,735,275,325
8450379,8450375,TXFE7,128,9948,6,741,280,326
8450379,8450375,TXFE7,128,9947,1,742,281,327
8450392,8450379,TXFE7,128,9947,2,744,283,328
8450404,8450402,TXFE7,128,9947,1,745,284,329
8450429,8450418,TXFE7,128,9948,2,747,285,331
8450429,8450424,TXFE7,130,9947,5,771,304,332
8450429,8450424,TXFE7,130,9946,18,771,304,332
8450429,8450424,TXFE7,130,9945,1,771,304,332
8450442,8450429,TXFE7,128,9945,2,773,305,333
8450442,8450433,TXFE7,128,9947,1,774,306,334
8450454,8450442,TXFE7,128,9946,1,775,307,335
8450467,8450454,TXFE7,128,9945,2,777,308,336
8450467,8450458,TXFE7,128,9946,1,778,309,337
8450479,8450467,TXFE7,128,9945,2,780,310,338
8450479,8450468,TXFE7,128,9946,1,781,311,339
8450479,8450474,TXFE7,128,9947,1,782,312,340
8450479,8450476,TXFE7,129,9946,2,807,325,341
8450479,8450476,TXFE7,129,9945,23,807,325,341
8450492,8450481,TXFE7,128,9946,1,808,326,342
8450492,8450483,TXFE7,128,9945,1,809,327,343
8450504,8450498,TXFE7,128,9945,1,810,328,344
8450504,8450499,TXFE7,128,9945,1,811,329,345
8450517,8450504,TXFE7,128,9945,2,813,330,346
8450529,8450517,TXFE7,128,9944,2,815,331,347
8450529,8450520,TXFE7,128,9945,3,818,332,349
8450529,8450521,TXFE7,129,9944,10,842,342,350
8450529,8450521,TXFE7,129,9943,14,842,342,350
8450529,8450523,TXFE7,128,9945,1,843,343,351
8450542,8450529,TXFE7,128,9943,2,845,344,352
8450542,8450529,TXFE7,128,9945,2,847,345,353
8450542,8450532,TXFE7,128,9945,1,848,346,354
8450542,8450534,TXFE7,130,9944,2,872,357,355
8450542,8450534,TXFE7,130,9943,10,872,357,355
8450542,8450534,TXFE7,130,9942,12,872,357,355
8450554,8450542,TXFE7,128,9944,1,873,358,356
8450554,8450543,TXFE7,128,9943,2,875,359,357
8450554,8450546,TXFE7,128,9942,2,877,360,358
8450554,8450550,TXFE7,128,9944,1,878,361,359
8450554,8450552,TXFE7,128,9945,1,879,362,360
8450567,8450554,TXFE7,128,9944,2,881,363,361
8450567,8450555,TXFE7,128,9945,3,884,364,362
8450567,8450561,TXFE7,128,9945,5,889,365,366
8450579,8450574,TXFE7,129,9945,5,899,366,372
8450579,8450574,TXFE7,129,9946,5,899,366,372
8450592,8450580,TXFE7,128,9944,1,900,367,373
8450592,8450580,TXFE7,129,9945,1,905,368,377
8450592,8450580,TXFE7,129,9946,4,905,368,377
8450604,8450592,TXFE7,128,9945,2,907,369,378
8450604,8450600,TXFE7,128,9944,5,912,372,379
8450604,8450601,TXFE7,129,9944,16,932,381,380
8450604,8450601,TXFE7,129,9943,4,932,381,380
8450629,8450621,TXFE7,128,9945,2,934,382,382
8450642,8450632,TXFE7,128,9945,1,935,383,383
8450642,8450634,TXFE7,128,9944,1,936,384,384
8450654,8450646,TXFE7,128,9945,1,937,385,385
8450654,8450650,TXFE7,128,9943,1,938,386,386
8450667,8450661,TXFE7,128,9943,1,939,387,387
8450679,8450667,TXFE7,128,9945,1,940,388,388
8450679,8450675,TXFE7,128,9945,1,941,389,389
8450679,8450678,TXFE7,128,9944,1,942,390,390
8450692,8450680,TXFE7,128,9944,4,946,391,391
8450692,8450681,TXFE7,128,9944,1,947,392,392
8450704,8450702,TXFE7,128,9944,2,949,393,393
8450729,8450727,TXFE7,129,9944,1,973,408,394
8450729,8450727,TXFE7,129,9943,23,973,408,394
8450742,8450738,TXFE7,129,9943,8,997,420,395
8450742,8450738,TXFE7,129,9942,16,997,420,395
8450742,8450740,TXFE7,128,9943,1,998,421,396
8450767,8450762,TXFE7,128,9944,3,1001,422,397
8450767,8450763,TXFE7,128,9944,3,1004,423,399
8450779,8450767,TXFE7,128,9944,1,1005,424,400
8450829,8450828,TXFE7,128,9943,2,1007,425,401
8450829,8450829,TXFE7,128,9944,1,1008,426,402
8450842,8450841,TXFE7,128,9944,2,1010,427,403
8450854,8450842,TXFE7,128,9944,1,1011,428,404
8450854,8450846,TXFE7,128,9943,1,1012,429,405
8450854,8450848,TXFE7,128,9944,3,1015,430,406
8450879,8450868,TXFE7,128,9943,1,1016,431,407
8450879,8450878,TXFE7,128,9944,7,1023,432,413
8450892,8450879,TXFE7,128,9944,2,1025,433,414
8450892,8450885,TXFE7,128,9944,1,1026,434,415
8450892,8450889,TXFE7,128,9943,1,1027,435,416
8450917,8450908,TXFE7,128,9944,1,1028,436,417
8450929,8450920,TXFE7,128,9944,1,1029,437,418
8450929,8450928,TXFE7,128,9944,4,1033,439,419
8450954,8450948,TXFE7,129,9944,1,1037,441,420
8450954,8450948,TXFE7,129,9943,3,1037,441,420
8450967,8450963,TXFE7,128,9945,1,1038,442,421
8450967,8450963,TXFE7,128,9944,1,1039,443,422
8450967,8450967,TXFE7,128,9944,1,1040,444,423
8450992,8450980,TXFE7,128,9945,1,1041,445,424
8450992,8450988,TXFE7,128,9943,1,1042,446,425
8450992,8450991,TXFE7,129,9944,1,1079,447,438
8450992,8450991,TXFE7,129,9945,36,1079,447,438
8451017,8451004,TXFE7,128,9945,1,1080,448,439
8451029,8451028,TXFE7,128,9945,2,1082,449,440
8451042,8451041,TXFE7,128,9945,3,1085,450,441
8451054,8451042,TXFE7,128,9945,18,1103,455,442
8451067,8451057,TXFE7,128,9944,1,1104,456,443
8451079,8451073,TXFE7,128,9945,1,1105,457,444
8451117,8451110,TXFE7,128,9945,3,1108,458,446
8451142,8451131,TXFE7,128,9945,1,1109,459,447
8451154,8451145,TXFE7,128,9946,1,1110,460,448
8451154,8451147,TXFE7,128,9945,1,1111,461,449
8451167,8451158,TXFE7,130,9946,13,1151,462,466
8451167,8451158,TXFE7,130,9947,21,1151,462,466
8451167,8451158,TXFE7,130,9948,6,1151,462,466
8451167,8451158,TXFE7,128,9948,2,1153,463,467
8451229,8451228,TXFE7,128,9947,4,1157,464,468
8451242,8451230,TXFE7,129,9948,7,1165,465,475
8451242,8451230,TXFE7,129,9949,1,1165,465,475
8451242,8451235,TXFE7,128,9947,1,1166,466,476
8451242,8451238,TXFE7,128,9949,1,1167,467,477
8451254,8451243,TXFE7,128,9947,1,1168,468,478
8451279,8451275,TXFE7,128,9947,2,1170,470,479
8451292,8451288,TXFE7,128,9948,1,1171,471,480
8451292,8451290,TXFE7,128,9948,1,1172,472,481
8451304,8451301,TXFE7,128,9948,1,1173,473,482
8451317,8451309,TXFE7,128,9947,1,1174,474,483
8451392,8451380,TXFE7,128,9948,3,1177,475,484
8451392,8451382,TXFE7,129,9948,8,1187,476,490
8451392,8451382,TXFE7,129,9949,2,1187,476,490
8451417,8451410,TXFE7,128,9948,1,1188,477,491
8451442,8451434,TXFE7,128,9948,1,1189,478,492
8451479,8451470,TXFE7,128,9949,2,1191,479,494
8451479,8451476,TXFE7,128,9949,5,1196,480,497
8451479,8451477,TXFE7,128,9948,5,1201,484,498
8451517,8451509,TXFE7,128,9949,1,1202,485,499
8451517,8451511,TXFE7,128,9948,1,1203,486,500
8451529,8451517,TXFE7,128,9949,1,1204,487,501
8451529,8451519,TXFE7,128,9949,2,1206,488,502
8451529,8451520,TXFE7,128,9948,2,1208,490,503
8451529,8451529,TXFE7,128,9949,1,1209,491,504
8451542,8451532,TXFE7,128,9949,1,1210,492,505
8451542,8451533,TXFE7,128,9949,1,1211,493,506
8451542,8451533,TXFE7,128,9948,1,1212,494,507
8451542,8451535,TXFE7,128,9948,1,1213,495,508
8451554,8451551,TXFE7,128,9948,1,1214,496,509
8451554,8451553,TXFE7,128,9949,3,1217,497,510
8451567,8451560,TXFE7,128,9950,1,1218,498,511
8451567,8451566,TXFE7,128,9949,2,1220,499,512
8451567,8451566,TXFE7,128,9950,1,1221,500,513
8451579,8451575,TXFE7,128,9950,2,1223,501,515
8451592,8451582,TXFE7,128,9949,1,1224,502,516
8451592,8451592,TXFE7,128,9949,5,1229,505,517
8451604,8451601,TXFE7,128,9950,1,1230,506,518
8451617,8451606,TXFE7,128,9948,3,1233,509,519
8451617,8451608,TXFE7,128,9949,1,1234,510,520
8451617,8451614,TXFE7,128,9948,7,1241,514,521
8451629,8451619,TXFE7,128,9949,1,1242,515,522
8451629,8451621,TXFE7,128,9949,1,1243,516,523
8451629,8451627,TXFE7,128,9949,1,1244,517,524
8451629,8451628,TXFE7,128,9949,1,1245,518,525
8451642,8451632,TXFE7,128,9949,1,1246,519,526
8451642,8451633,TXFE7,128,9948,1,1247,520,527
8451667,8451658,TXFE7,128,9949,1,1248,521,528
8451667,8451661,TXFE7,128,9949,1,1249,522,529
8451679,8451679,TXFE7,128,9950,1,1250,523,530
8451692,8451684,TXFE7,128,9949,1,1251,524,531
8451742,8451736,TXFE7,128,9948,1,1252,525,532
8451767,8451757,TXFE7,128,9949,1,1253,526,533
8451767,8451763,TXFE7,128,9948,1,1254,527,534
8451767,8451766,TXFE7,128,9949,1,1255,528,535
8451779,8451769,TXFE7,128,9949,1,1256,529,536
8451779,8451772,TXFE7,128,9948,1,1257,530,537
8451792,8451783,TXFE7,128,9949,1,1258,531,538
8451792,8451791,TXFE7,128,9949,5,1263,532,542
8451804,8451797,TXFE7,128,9949,1,1264,533,543
8451817,8451815,TXFE7,128,9949,5,1269,534,545
8451829,8451829,TXFE7,128,9949,10,1279,535,550
8451842,8451834,TXFE7,129,9949,3,1285,536,555
8451842,8451834,TXFE7,129,9950,3,1285,536,555
8451854,8451845,TXFE7,128,9949,3,1288,537,556
8451854,8451847,TXFE7,128,9950,5,1293,538,561
8451854,8451853,TXFE7,128,9950,1,1294,539,562
8451879,8451873,TXFE7,128,9950,5,1299,540,563
8451904,8451894,TXFE7,128,9950,1,1300,541,564
8451917,8451913,TXFE7,128,9948,1,1301,542,565
8451929,8451929,TXFE7,128,9948,5,1306,544,566
8451942,8451935,TXFE7,128,9948,1,1307,545,567
8451954,8451953,TXFE7,128,9949,1,1308,546,568
8451967,8451955,TXFE7,128,9949,1,1309,547,569
8451967,8451961,TXFE7,128,9949,1,1310,548,570
8452029,8452024,TXFE7,128,9949,1,1311,549,571
8452054,8452051,TXFE7,128,9949,1,1312,550,572
8452054,8452053,TXFE7,128,9950,4,1316,551,574
8452067,8452062,TXFE7,128,9949,1,1317,552,575
8452092,8452090,TXFE7,128,9949,4,1321,554,576
8452104,8452104,TXFE7,128,9949,1,1322,555,577
8452129,8452125,TXFE7,128,9950,1,1323,556,578
8452142,8452131,TXFE7,128,9949,5,1328,558,579
8452167,8452156,TXFE7,128,9950,2,1330,559,581
8452179,8452168,TXFE7,128,9949,1,1331,560,582
8452179,8452177,TXFE7,128,9950,2,1333,561,584
8452192,8452180,TXFE7,128,9950,1,1334,562,585
8452192,8452180,TXFE7,128,9949,1,1335,563,586
8452192,8452182,TXFE7,128,9950,1,1336,564,587
8452217,8452216,TXFE7,128,9950,1,1337,565,588
8452267,8452259,TXFE7,128,9950,1,1338,566,589
8452292,8452280,TXFE7,128,9950,1,1339,567,590
8452292,8452283,TXFE7,128,9950,1,1340,568,591
8452304,8452302,TXFE7,128,9950,5,1345,569,595
8452329,8452327,TXFE7,128,9950,1,1346,570,596
8452367,8452359,TXFE7,128,9949,1,1347,571,597
8452367,8452366,TXFE7,128,9950,1,1348,572,598
8452379,8452379,TXFE7,128,9950,10,1358,573,606
8452404,8452399,TXFE7,128,9949,1,1359,574,607
8452404,8452400,TXFE7,128,9949,1,1360,575,608
8452417,8452410,TXFE7,128,9949,2,1362,576,609
8452429,8452429,TXFE7,128,9949,2,1364,578,610
8452429,8452429,TXFE7,128,9950,1,1365,579,611
8452454,8452444,TXFE7,128,9949,2,1367,580,612
8452454,8452448,TXFE7,128,9949,3,1370,582,613
8452479,8452473,TXFE7,128,9949,3,1373,584,614
8452479,8452476,TXFE7,128,9949,1,1374,585,615
8452492,8452489,TXFE7,128,9949,1,1375,586,616
8452492,8452490,TXFE7,128,9949,1,1376,587,617
8452504,8452494,TXFE7,128,9949,2,1378,588,618
8452517,8452505,TXFE7,128,9949,2,1380,589,619
8452517,8452506,TXFE7,128,9949,1,1381,590,620
8452554,8452545,TXFE7,128,9948,3,1384,593,621
8452554,8452554,TXFE7,128,9949,2,1386,594,622
8452567,8452560,TXFE7,128,9948,20,1406,608,623
8452579,8452567,TXFE7,128,9948,4,1410,611,624
8452579,8452572,TXFE7,128,9948,13,1423,615,625
8452592,8452580,TXFE7,128,9947,11,1434,620,626
8452592,8452587,TXFE7,128,9947,1,1435,621,627
8452679,8452672,TXFE7,128,9948,1,1436,622,628
8452679,8452678,TXFE7,128,9948,1,1437,623,629
8452704,8452703,TXFE7,128,9948,1,1438,624,630
8452717,8452714,TXFE7,128,9948,1,1439,625,631
8452729,8452723,TXFE7,128,9948,3,1442,626,633
8452742,8452729,TXFE7,128,9948,1,1443,627,634
8452742,8452732,TXFE7,128,9949,1,1444,628,635
8452754,8452745,TXFE7,128,9947,1,1445,629,636
8452829,8452819,TXFE7,128,9947,1,1446,630,637
8452854,8452842,TXFE7,128,9948,1,1447,631,638
8452892,8452891,TXFE7,128,9947,1,1448,632,639
8452929,8452926,TXFE7,128,9948,1,1449,633,640
8452942,8452940,TXFE7,128,9948,1,1450,634,641
8452942,8452941,TXFE7,129,9947,26,1490,651,642
8452942,8452941,TXFE7,129,9946,14,1490,651,642
8452979,8452975,TXFE7,129,9947,5,1496,652,646
8452979,8452975,TXFE7,129,9948,1,1496,652,646
8453004,8452997,TXFE7,128,9947,1,1497,653,647
8453004,8453001,TXFE7,129,9947,5,1503,657,648
8453004,8453001,TXFE7,129,9946,1,1503,657,648
8453017,8453010,TXFE7,128,9948,1,1504,658,649
8453017,8453010,TXFE7,128,9948,8,1512,659,654
8453017,8453016,TXFE7,128,9948,1,1513,660,655
8453029,8453017,TXFE7,128,9948,1,1514,661,656
8453029,8453022,TXFE7,128,9947,1,1515,662,657
8453054,8453045,TXFE7,128,9947,1,1516,663,658
8453067,8453066,TXFE7,128,9949,2,1518,664,659
8453079,8453072,TXFE7,128,9948,1,1519,665,660
8453154,8453144,TXFE7,128,9948,1,1520,666,661
8453167,8453155,TXFE7,128,9948,2,1522,667,662
8453204,8453192,TXFE7,128,9948,1,1523,668,663
8453242,8453232,TXFE7,129,9948,1,1539,675,664
8453242,8453232,TXFE7,129,9947,15,1539,675,664
8453242,8453233,TXFE7,128,9947,1,1540,676,665
8453267,8453261,TXFE7,128,9948,2,1542,677,667
8453279,8453277,TXFE7,128,9948,3,1545,678,669
8453292,8453289,TXFE7,128,9948,1,1546,679,670
8453317,8453311,TXFE7,128,9947,1,1547,680,671
8453329,8453327,TXFE7,128,9948,3,1550,681,672
8453392,8453382,TXFE7,128,9949,1,1551,682,673
8453429,8453423,TXFE7,128,9949,1,1552,683,674
8453429,8453428,TXFE7,128,9948,3,1555,684,675
8453442,8453434,TXFE7,128,9949,20,1575,685,686
8453454,8453453,TXFE7,128,9950,1,1576,686,687
8453467,8453454,TXFE7,128,9950,3,1579,687,688
8453479,8453467,TXFE7,128,9949,1,1580,688,689
8453504,8453493,TXFE7,128,9950,7,1587,689,690
8453517,8453510,TXFE7,128,9949,1,1588,690,691
8453517,8453515,TXFE7,128,9950,20,1608,691,704
8453542,8453533,TXFE7,128,9949,1,1609,692,705
8453542,8453538,TXFE7,128,9950,3,1612,693,706
8453554,8453543,TXFE7,128,9950,2,1614,694,707
8453554,8453547,TXFE7,128,9950,11,1625,695,708
8453567,8453559,TXFE7,128,9949,1,1626,696,709
8453567,8453564,TXFE7,128,9949,1,1627,697,710
8453579,8453576,TXFE7,128,9950,1,1628,698,711
8453592,8453582,TXFE7,128,9949,1,1629,699,712
8453604,8453597,TXFE7,128,9950,1,1630,700,713
8453642,8453637,TXFE7,128,9950,1,1631,701,714
8453642,8453641,TXFE7,128,9950,1,1632,702,715
8453654,8453652,TXFE7,128,9950,1,1633,703,716
8453679,8453669,TXFE7,128,9949,1,1634,704,717
8453679,8453670,TXFE7,128,9950,4,1638,705,718
8453679,8453678,TXFE7,128,9949,6,1644,709,719
8453692,8453680,TXFE7,128,9949,6,1650,710,720
8453692,8453682,TXFE7,128,9949,6,1656,712,721
8453692,8453692,TXFE7,128,9950,1,1657,713,722
8453779,8453774,TXFE7,128,9949,1,1658,714,723
8453792,8453785,TXFE7,128,9949,3,1661,716,724
8453817,8453811,TXFE7,128,9950,5,1666,717,725
8453817,8453814,TXFE7,128,9950,1,1667,718,726
8453867,8453867,TXFE7,128,9950,2,1669,719,728
8453879,8453877,TXFE7,128,9950,1,1670,720,729
8453904,8453897,TXFE7,128,9950,54,1724,721,762
8453904,8453897,TXFE7,128,9950,1,1725,722,763
8453904,8453898,TXFE7,128,9950,1,1726,723,764
8453917,8453911,TXFE7,128,9950,1,1727,724,765
8453942,8453935,TXFE7,128,9950,1,1728,725,766
8453954,8453949,TXFE7,128,9950,1,1729,726,767
8453954,8453950,TXFE7,128,9950,5,1734,728,768
8453954,8453953,TXFE7,128,9950,1,1735,729,769
8453992,8453981,TXFE7,128,9950,3,1738,730,770
8453992,8453982,TXFE7,128,9951,1,1739,731,771
8453992,8453986,TXFE7,128,9950,1,1740,732,772
8453992,8453987,TXFE7,128,9950,1,1741,733,773
8453992,8453988,TXFE7,128,9951,1,1742,734,774
8454004,8453992,TXFE7,128,9950,1,1743,735,775
8454017,8454005,TXFE7,128,9950,1,1744,736,776
8454029,8454024,TXFE7,128,9951,5,1749,737,777
8454042,8454031,TXFE7,128,9950,1,1750,738,778
8454042,8454031,TXFE7,128,9950,1,1751,739,779
8454054,8454042,TXFE7,128,9951,74,1825,740,797
8454054,8454043,TXFE7,128,9951,1,1826,741,798
8454067,8454060,TXFE7,128,9952,1,1827,742,799
8454079,8454067,TXFE7,128,9952,2,1829,743,800
8454079,8454067,TXFE7,128,9952,4,1833,744,803
8454079,8454067,TXFE7,128,9952,2,1835,745,805
8454079,8454067,TXFE7,128,9952,6,1841,746,810
8454079,8454068,TXFE7,128,9952,5,1846,747,815
8454079,8454076,TXFE7,128,9952,1,1847,748,816
8454092,8454086,TXFE7,128,9951,10,1857,752,817
8454092,8454086,TXFE7,128,9952,1,1858,753,818
8454104,8454095,TXFE7,128,9951,2,1860,755,819
8454117,8454111,TXFE7,128,9952,1,1861,756,820
8454117,8454113,TXFE7,128,9952,1,1862,757,821
8454129,8454119,TXFE7,128,9952,1,1863,758,822
8454129,8454121,TXFE7,128,9952,1,1864,759,823
8454154,8454144,TXFE7,128,9953,1,1865,760,824
8454154,8454148,TXFE7,128,9953,1,1866,761,825
8454167,8454155,TXFE7,128,9951,1,1867,762,826
8454167,8454160,TXFE7,128,9953,1,1868,763,827
8454167,8454162,TXFE7,128,9951,1,1869,764,828
8454167,8454163,TXFE7,128,9952,1,1870,765,829
8454179,8454177,TXFE7,128,9951,2,1872,766,830
8454179,8454179,TXFE7,128,9951,1,1873,767,831
8454192,8454181,TXFE7,128,9952,1,1874,768,832
8454192,8454185,TXFE7,128,9952,2,1876,769,833
8454192,8454185,TXFE7,128,9951,2,1878,770,834
8454192,8454191,TXFE7,128,9952,1,1879,771,835
8454217,8454213,TXFE7,128,9951,1,1880,772,836
8454229,8454227,TXFE7,128,9952,1,1881,773,837
8454254,8454244,TXFE7,128,9951,2,1883,775,838
8454267,8454254,TXFE7,128,9952,1,1884,776,839
8454267,8454267,TXFE7,128,9952,4,1888,777,840
8454279,8454275,TXFE7,128,9952,1,1889,778,841
8454292,8454280,TXFE7,128,9952,3,1892,779,843
8454304,8454299,TXFE7,128,9951,1,1893,780,844
8454342,8454334,TXFE7,128,9952,1,1894,781,845
8454367,8454362,TXFE7,128,9951,3,1897,782,846
8454379,8454367,TXFE7,128,9951,4,1901,784,847
8454379,8454378,TXFE7,128,9951,1,1902,785,848
8454379,8454379,TXFE7,128,9952,1,1903,786,849
8454429,8454426,TXFE7,128,9951,4,1907,790,850
8454454,8454444,TXFE7,128,9951,1,1908,791,851
8454454,8454445,TXFE7,128,9951,1,1909,792,852
8454467,8454467,TXFE7,128,9950,1,1910,793,853
8454492,8454489,TXFE7,128,9950,1,1911,794,854
8454504,8454498,TXFE7,129,9951,3,1916,795,857
8454504,8454498,TXFE7,129,9952,2,1916,795,857
8454542,8454537,TXFE7,128,9952,1,1917,796,858
8454554,8454553,TXFE7,128,9951,1,1918,797,859
8454567,8454559,TXFE7,128,9950,1,1919,798,860
8454579,8454572,TXFE7,128,9950,1,1920,799,861
8454604,8454593,TXFE7,128,9950,1,1921,800,862
8454617,8454606,TXFE7,128,9950,1,1922,801,863
8454629,8454622,TXFE7,128,9951,1,1923,802,864
8454642,8454638,TXFE7,128,9952,1,1924,803,865
8454642,8454639,TXFE7,128,9952,1,1925,804,866
8454654,8454650,TXFE7,128,9951,1,1926,805,867
8454667,8454663,TXFE7,128,9950,2,1928,806,868
8454679,8454679,TXFE7,128,9952,7,1935,807,875
8454692,8454685,TXFE7,128,9951,1,1936,808,876
8454717,8454707,TXFE7,128,9952,1,1937,809,877
8454742,8454732,TXFE7,128,9952,1,1938,810,878
8454779,8454769,TXFE7,128,9951,3,1941,813,879
8454792,8454792,TXFE7,128,9952,1,1942,814,880
8454804,8454802,TXFE7,128,9952,1,1943,815,881
8454842,8454830,TXFE7,128,9951,3,1946,817,882
8454854,8454842,TXFE7,128,9952,1,1947,818,883
8454867,8454861,TXFE7,128,9952,1,1948,819,884
8454892,8454886,TXFE7,128,9952,1,1949,820,885
8454917,8454905,TXFE7,128,9952,1,1950,821,886
8454929,8454925,TXFE7,128,9951,1,1951,822,887
8454942,8454931,TXFE7,128,9951,1,1952,823,888
8454954,8454949,TXFE7,128,9951,1,1953,824,889
8454967,8454961,TXFE7,128,9951,1,1954,825,890
8455004,8454999,TXFE7,128,9952,1,1955,826,891
8455029,8455025,TXFE7,129,9951,16,1975,836,892
8455029,8455025,TXFE7,129,9950,4,1975,836,892
8455029,8455029,TXFE7,128,9951,1,1976,837,893
8455067,8455055,TXFE7,128,9952,7,1983,838,898
8455067,8455057,TXFE7,128,9950,1,1984,839,899
8455092,8455081,TXFE7,128,9950,1,1985,840,900
8455129,8455123,TXFE7,128,9951,4,1989,841,902
8455167,8455159,TXFE7,128,9951,1,1990,842,903
8455192,8455189,TXFE7,128,9951,1,1991,843,904
8455217,8455206,TXFE7,128,9951,1,1992,844,905
8455229,8455217,TXFE7,128,9951,1,1993,845,906
8455254,8455242,TXFE7,128,9951,1,1994,846,907
8455279,8455271,TXFE7,128,9950,1,1995,847,908
8455279,8455272,TXFE7,128,9950,1,1996,848,909
8455304,8455298,TXFE7,128,9950,1,1997,849,910
8455317,8455311,TXFE7,128,9951,1,1998,850,911
8455379,8455371,TXFE7,128,9950,1,1999,851,912
8455392,8455381,TXFE7,128,9951,7,2006,852,913
8455392,8455385,TXFE7,128,9950,7,2013,853,914
8455392,8455386,TXFE7,128,9951,3,2016,854,916
8455392,8455388,TXFE7,128,9951,1,2017,855,917
8455429,8455427,TXFE7,128,9951,1,2018,856,918
8455442,8455431,TXFE7,128,9950,1,2019,857,919
8455454,8455445,TXFE7,128,9951,1,2020,858,920
8455467,8455455,TXFE7,128,9950,5,2025,860,921
8455479,8455467,TXFE7,128,9950,1,2026,861,922
8455542,8455540,TXFE7,128,9950,1,2027,862,923
8455567,8455559,TXFE7,128,9951,1,2028,863,924
8455592,8455583,TXFE7,128,9950,1,2029,864,925
8455654,8455652,TXFE7,128,9950,4,2033,868,926
8455667,8455655,TXFE7,128,9951,1,2034,869,927
8455692,8455692,TXFE7,128,9951,1,2035,870,928
8455704,8455704,TXFE7,128,9951,1,2036,871,929
8455804,8455799,TXFE7,128,9950,1,2037,872,930
8455829,8455824,TXFE7,128,9950,1,2038,873,931
8455854,8455851,TXFE7,128,9950,5,2043,874,932
8455867,8455856,TXFE7,128,9950,1,2044,875,933
8455879,8455870,TXFE7,128,9950,1,2045,876,934
8455917,8455905,TXFE7,128,9951,1,2046,877,935
8455917,8455910,TXFE7,128,9950,3,2049,879,936
8455917,8455911,TXFE7,128,9950,5,2054,884,937
8455954,8455954,TXFE7,128,9950,2,2056,886,938
8455967,8455963,TXFE7,128,9951,2,2058,887,939
8460017,8460012,TXFE7,128,9951,1,2059,888,940
8460017,8460012,TXFE7,129,9950,8,2069,895,941
8460017,8460012,TXFE7,129,9949,2,2069,895,941
8460054,8460044,TXFE7,128,9950,1,2070,896,942
8460067,8460056,TXFE7,128,9950,1,2071,897,943
8460079,8460070,TXFE7,128,9950,5,2076,898,946
8460079,8460070,TXFE7,128,9950,2,2078,899,947
8460079,8460077,TXFE7,128,9950,1,2079,900,948
8460092,8460086,TXFE7,128,9950,1,2080,901,949
8460104,8460102,TXFE7,129,9949,48,2130,926,950
8460104,8460102,TXFE7,129,9948,2,2130,926,950
8460117,8460109,TXFE7,128,9949,1,2131,927,951
8460129,8460119,TXFE7,128,9949,1,2132,928,952
8460129,8460120,TXFE7,128,9949,1,2133,929,953
8460142,8460129,TXFE7,128,9949,3,2136,930,955
8460167,8460159,TXFE7,128,9949,1,2137,931,956
8460167,8460163,TXFE7,128,9950,15,2152,932,960
8460167,8460163,TXFE7,128,9950,1,2153,933,961
8460217,8460205,TXFE7,128,9949,1,2154,934,962
8460217,8460212,TXFE7,128,9950,1,2155,935,963
8460267,8460255,TXFE7,128,9950,5,2160,936,968
8460304,8460292,TXFE7,128,9950,10,2170,937,972
8460304,8460297,TXFE7,128,9951,1,2171,938,973
8460317,8460311,TXFE7,128,9949,1,2172,939,974
8460367,8460360,TXFE7,128,9949,1,2173,940,975
8460429,8460423,TXFE7,128,9950,10,2183,941,979
8460492,8460484,TXFE7,129,9950,5,2203,942,991
8460492,8460484,TXFE7,129,9951,15,2203,942,991
8460504,8460496,TXFE7,128,9950,1,2204,943,992
8460504,8460500,TXFE7,128,9950,1,2205,944,993
8460517,8460510,TXFE7,128,9950,1,2206,945,994
8460567,8460564,TXFE7,129,9950,1,2211,946,998
8460567,8460564,TXFE7,129,9951,4,2211,946,998
8460617,8460604,TXFE7,128,9950,2,2213,947,999
8460629,8460617,TXFE7,128,9950,1,2214,948,1000
8460679,8460673,TXFE7,128,9949,1,2215,949,1001
8460692,8460680,TXFE7,128,9950,1,2216,950,1002
8460729,8460720,TXFE7,128,9949,1,2217,951,1003
8460729,8460723,TXFE7,129,9950,4,2225,952,1007
8460729,8460723,TXFE7,129,9951,4,2225,952,1007
8460729,8460724,TXFE7,128,9950,1,2226,953,1008
8460767,8460763,TXFE7,128,9950,1,2227,954,1009
8460792,8460779,TXFE7,128,9950,1,2228,955,1010
8460829,8460826,TXFE7,128,9950,1,2229,956,1011
8460879,8460875,TXFE7,128,9950,1,2230,957,1012
8460942,8460929,TXFE7,128,9950,2,2232,958,1013
8460942,8460938,TXFE7,128,9950,1,2233,959,1014
8460992,8460991,TXFE7,128,9950,2,2235,960,1016
8461017,8461011,TXFE7,128,9950,1,2236,961,1017
8461042,8461032,TXFE7,129,9950,2,2243,962,1024
8461042,8461032,TXFE7,129,9951,5,2243,962,1024
8461129,8461129,TXFE7,128,9949,1,2244,963,1025
8461154,8461149,TXFE7,128,9950,1,2245,964,1026
8461167,8461166,TXFE7,128,9950,1,2246,965,1027
8461192,8461187,TXFE7,128,9950,1,2247,966,1028
8461204,8461197,TXFE7,128,9949,1,2248,967,1029
8461204,8461203,TXFE7,128,9950,1,2249,968,1030
8461217,8461209,TXFE7,128,9950,1,2250,969,1031
8461217,8461212,TXFE7,128,9950,1,2251,970,1032
8461229,8461217,TXFE7,128,9950,1,2252,971,1033
8461254,8461244,TXFE7,128,9950,1,2253,972,1034
8461254,8461250,TXFE7,128,9950,1,2254,973,1035
8461292,8461290,TXFE7,128,9949,1,2255,974,1036
8461354,8461348,TXFE7,128,9950,1,2256,975,1037
8461354,8461351,TXFE7,128,9949,1,2257,976,1038
8461392,8461383,TXFE7,128,9950,1,2258,977,1039
8461392,8461389,TXFE7,128,9950,1,2259,978,1040
8461417,8461412,TXFE7,128,9950,1,2260,979,1041
8461492,8461487,TXFE7,128,9949,1,2261,980,1042
8461517,8461506,TXFE7,128,9950,3,2264,981,1044
8461617,8461616,TXFE7,128,9950,1,2265,982,1045
8461667,8461659,TXFE7,128,9950,1,2266,983,1046
8461667,8461665,TXFE7,128,9950,1,2267,984,1047
8461692,8461690,TXFE7,128,9950,1,2268,985,1048
8461704,8461703,TXFE7,128,9950,2,2270,986,1049
8461717,8461711,TXFE7,128,9949,2,2272,988,1050
8461804,8461792,TXFE7,128,9950,14,2286,989,1062
8461929,8461927,TXFE7,128,9951,2,2288,990,1063
8461942,8461934,TXFE7,128,9950,3,2291,991,1064
8461967,8461956,TXFE7,128,9951,1,2292,992,1065
8461967,8461960,TXFE7,128,9950,1,2293,993,1066
8461992,8461982,TXFE7,128,9951,1,2294,994,1067
8462004,8461997,TXFE7,128,9950,1,2295,995,1068
8462042,8462034,TXFE7,128,9950,1,2296,996,1069
8462054,8462042,TXFE7,128,9950,1,2297,997,1070
8462067,8462063,TXFE7,128,9950,2,2299,998,1071
8462067,8462064,TXFE7,128,9950,4,2303,1000,1072
8462092,8462091,TXFE7,128,9950,1,2304,1001,1073
8462104,8462104,TXFE7,128,9950,1,2305,1002,1074
8462154,8462142,TXFE7,128,9950,1,2306,1003,1075
8462167,8462163,TXFE7,128,9951,1,2307,1004,1076
8462217,8462210,TXFE7,128,9950,1,2308,1005,1077
8462254,8462254,TXFE7,128,9951,1,2309,1006,1078
8462292,8462281,TXFE7,128,9951,5,2314,1007,1080
8462292,8462281,TXFE7,128,9951,1,2315,1008,1081
8462304,8462298,TXFE7,128,9951,1,2316,1009,1082
8462379,8462373,TXFE7,128,9951,1,2317,1010,1083
8462392,8462389,TXFE7,128,9950,3,2320,1011,1084
8462417,8462407,TXFE7,128,9950,1,2321,1012,1085
8462492,8462480,TXFE7,128,9951,1,2322,1013,1086
8462492,8462489,TXFE7,128,9951,3,2325,1014,1088
8462504,8462496,TXFE7,128,9951,2,2327,1015,1089
8462504,8462496,TXFE7,128,9951,1,2328,1016,1090
8462504,8462497,TXFE7,128,9951,7,2335,1017,1096
8462517,8462504,TXFE7,128,9951,1,2336,1018,1097
8462517,8462504,TXFE7,128,9951,3,2339,1019,1100
8462554,8462543,TXFE7,128,9950,9,2348,1020,1101
8462554,8462551,TXFE7,128,9951,2,2350,1021,1103
8462567,8462562,TXFE7,128,9951,10,2360,1022,1106
8462592,8462592,TXFE7,128,9951,5,2365,1023,1110
8462604,8462596,TXFE7,128,9951,6,2371,1024,1115
8462617,8462604,TXFE7,128,9951,1,2372,1025,1116
8462629,8462618,TXFE7,128,9951,5,2377,1026,1119
8462642,8462640,TXFE7,128,9951,6,2383,1027,1124
8462679,8462678,TXFE7,128,9951,1,2384,1028,1125
8462717,8462707,TXFE7,128,9952,4,2388,1029,1128
8462742,8462736,TXFE7,128,9952,1,2389,1030,1129
8462767,8462765,TXFE7,128,9952,4,2393,1031,1130
8462804,8462802,TXFE7,128,9951,1,2394,1032,1131
8462842,8462830,TXFE7,128,9952,1,2395,1033,1132
8462854,8462845,TXFE7,128,9952,1,2396,1034,1133
8462867,8462862,TXFE7,128,9952,2,2398,1035,1134
8462867,8462863,TXFE7,128,9952,1,2399,1036,1135
8462879,8462873,TXFE7,128,9952,1,2400,1037,1136
8462904,8462893,TXFE7,128,9952,1,2401,1038,1137
8462917,8462909,TXFE7,128,9951,3,2404,1040,1138
8462979,8462968,TXFE7,128,9951,1,2405,1041,1139
8463004,8462992,TXFE7,128,9951,1,2406,1042,1140
8463029,8463029,TXFE7,128,9952,1,2407,1043,1141
8463042,8463030,TXFE7,128,9951,22,2429,1047,1142
8463042,8463030,TXFE7,128,9951,3,2432,1048,1143
8463054,8463042,TXFE7,128,9951,1,2433,1049,1144
8463054,8463043,TXFE7,128,9951,14,2447,1054,1145
8463054,8463053,TXFE7,129,9951,5,2457,1058,1146
8463054,8463053,TXFE7,129,9950,5,2457,1058,1146
8463079,8463075,TXFE7,128,9951,1,2458,1059,1147
8463079,8463078,TXFE7,128,9951,1,2459,1060,1148
8463104,8463102,TXFE7,128,9951,1,2460,1061,1149
8463129,8463123,TXFE7,128,9951,2,2462,1062,1150
8463142,8463132,TXFE7,128,9951,1,2463,1063,1151
8463154,8463142,TXFE7,128,9951,1,2464,1064,1152
8463179,8463176,TXFE7,128,9951,2,2466,1065,1154
8463192,8463183,TXFE7,128,9951,2,2468,1066,1155
8463192,8463188,TXFE7,128,9951,1,2469,1067,1156
8463242,8463230,TXFE7,128,9951,3,2472,1068,1158
8463292,8463290,TXFE7,128,9950,25,2497,1080,1159
8463304,8463292,TXFE7,128,9950,4,2501,1081,1160
8463354,8463343,TXFE7,128,9951,1,2502,1082,1161
8463417,8463411,TXFE7,128,9951,1,2503,1083,1162
8463529,8463525,TXFE7,128,9950,2,2505,1084,1163
8463579,8463568,TXFE7,128,9951,5,2510,1085,1165
8463592,8463591,TXFE7,128,9951,1,2511,1086,1166
8463629,8463624,TXFE7,128,9951,3,2514,1087,1169
8463629,8463625,TXFE7,128,9950,1,2515,1088,1170
8463679,8463670,TXFE7,128,9951,1,2516,1089,1171
8463679,8463675,TXFE7,128,9950,2,2518,1091,1172
8463704,8463696,TXFE7,128,9951,1,2519,1092,1173
8463742,8463732,TXFE7,128,9950,4,2523,1095,1174
8463754,8463742,TXFE7,128,9950,1,2524,1096,1175
8463767,8463755,TXFE7,128,9950,3,2527,1098,1176
8463817,8463807,TXFE7,128,9950,5,2532,1102,1177
8463892,8463883,TXFE7,128,9951,5,2537,1103,1181
8463929,8463926,TXFE7,128,9951,1,2538,1104,1182
8463979,8463978,TXFE7,128,9950,1,2539,1105,1183
8464117,8464111,TXFE7,128,9950,1,2540,1106,1184
8464154,8464152,TXFE7,128,9950,4,2544,1108,1185
8464167,8464155,TXFE7,128,9950,2,2546,1109,1186
8464217,8464209,TXFE7,128,9951,1,2547,1110,1187
8464217,8464211,TXFE7,128,9950,1,2548,1111,1188
8464217,8464215,TXFE7,128,9951,1,2549,1112,1189
8464242,8464238,TXFE7,128,9950,1,2550,1113,1190
8464279,8464278,TXFE7,128,9950,1,2551,1114,1191
8464342,8464339,TXFE7,128,9950,1,2552,1115,1192
8464367,8464361,TXFE7,128,9950,5,2557,1118,1193
8464379,8464371,TXFE7,128,9950,1,2558,1119,1194
8464379,8464372,TXFE7,128,9950,2,2560,1121,1195
8464404,8464400,TXFE7,128,9951,1,2561,1122,1196
8464417,8464412,TXFE7,128,9950,1,2562,1123,1197
8464429,8464428,TXFE7,128,9950,1,2563,1124,1198
8464442,8464441,TXFE7,128,9950,1,2564,1125,1199
8464454,8464443,TXFE7,128,9950,1,2565,1126,1200
8464517,8464516,TXFE7,128,9950,1,2566,1127,1201
8464604,8464594,TXFE7,128,9950,2,2568,1128,1202
8464617,8464613,TXFE7,128,9950,3,2571,1129,1203
8464667,8464661,TXFE7,128,9951,1,2572,1130,1204
8464704,8464692,TXFE7,128,9950,1,2573,1131,1205
8464704,8464696,TXFE7,128,9950,1,2574,1132,1206
8464829,8464829,TXFE7,128,9950,1,2575,1133,1207
8464954,8464951,TXFE7,128,9951,1,2576,1134,1208
8464967,8464957,TXFE7,128,9950,1,2577,1135,1209
8464979,8464976,TXFE7,128,9950,1,2578,1136,1210
8464992,8464979,TXFE7,128,9950,2,2580,1138,1211
8464992,8464982,TXFE7,128,9950,1,2581,1139,1212
8465004,8464997,TXFE7,128,9951,1,2582,1140,1213
8465017,8465016,TXFE7,128,9950,2,2584,1142,1214
8465092,8465086,TXFE7,128,9951,1,2585,1143,1215
8465117,8465106,TXFE7,128,9950,7,2592,1149,1216
8465192,8465189,TXFE7,128,9950,1,2593,1150,1217
8465204,8465200,TXFE7,128,9950,1,2594,1151,1218
8465254,8465243,TXFE7,128,9951,1,2595,1152,1219
8465279,8465272,TXFE7,128,9950,1,2596,1153,1220
8465304,8465300,TXFE7,128,9950,1,2597,1154,1221
8465317,8465309,TXFE7,128,9950,1,2598,1155,1222
8465392,8465390,TXFE7,128,9951,2,2600,1156,1223
8465392,8465391,TXFE7,128,9950,2,2602,1158,1224
8465529,8465527,TXFE7,128,9950,1,2603,1159,1225
8465579,8465569,TXFE7,128,9950,2,2605,1161,1226
8465692,8465691,TXFE7,128,9951,1,2606,1162,1227
8465704,8465695,TXFE7,128,9950,1,2607,1163,1228
8465742,8465733,TXFE7,128,9951,5,2612,1164,1231
8465742,8465734,TXFE7,128,9951,5,2617,1165,1232
8465817,8465811,TXFE7,128,9950,1,2618,1166,1233
8465979,8465973,TXFE7,128,9950,1,2619,1167,1234
8470017,8470015,TXFE7,128,9950,1,2620,1168,1235
8470029,8470020,TXFE7,128,9951,2,2622,1169,1236
8470054,8470044,TXFE7,128,9951,6,2628,1170,1237
8470054,8470045,TXFE7,128,9950,2,2630,1172,1238
8470054,8470047,TXFE7,128,9951,2,2632,1173,1239
8470079,8470071,TXFE7,128,9950,1,2633,1174,1240
8470092,8470083,TXFE7,128,9950,1,2634,1175,1241
8470104,8470104,TXFE7,129,9950,6,2644,1183,1242
8470104,8470104,TXFE7,129,9949,4,2644,1183,1242
8470167,8470158,TXFE7,128,9949,2,2646,1185,1243
8470179,8470169,TXFE7,128,9950,2,2648,1186,1244
8470242,8470232,TXFE7,128,9950,5,2653,1187,1247
8470292,8470288,TXFE7,128,9949,11,2664,1192,1248
8470317,8470305,TXFE7,128,9949,12,2676,1196,1249
8470317,8470307,TXFE7,128,9949,1,2677,1197,1250
8470342,8470341,TXFE7,128,9950,1,2678,1198,1251
8470367,8470357,TXFE7,128,9950,1,2679,1199,1252
8470367,8470362,TXFE7,128,9950,2,2681,1200,1253
8470404,8470398,TXFE7,128,9949,2,2683,1201,1254
8470417,8470405,TXFE7,128,9949,1,2684,1202,1255
8470429,8470428,TXFE7,128,9949,1,2685,1203,1256
8470492,8470482,TXFE7,128,9950,2,2687,1204,1258
8470542,8470534,TXFE7,128,9949,1,2688,1205,1259
8470592,8470588,TXFE7,128,9950,1,2689,1206,1260
8470629,8470620,TXFE7,128,9950,1,2690,1207,1261
8470629,8470629,TXFE7,128,9949,13,2703,1215,1269
8470642,8470630,TXFE7,128,9949,7,2710,1218,1270
8470642,8470630,TXFE7,128,9950,1,2711,1219,1271
8470667,8470656,TXFE7,128,9950,2,2713,1220,1273
8470679,8470670,TXFE7,128,9950,1,2714,1221,1274
8470679,8470677,TXFE7,128,9949,2,2716,1222,1275
8470692,8470680,TXFE7,128,9949,7,2723,1229,1276
8470717,8470704,TXFE7,128,9949,5,2728,1230,1278
8470729,8470728,TXFE7,128,9949,1,2729,1231,1279
8470754,8470745,TXFE7,128,9949,2,2731,1233,1280
8470954,8470948,TXFE7,128,9949,3,2734,1235,1281
8470992,8470990,TXFE7,128,9950,2,2736,1236,1282
8471042,8471030,TXFE7,128,9949,1,2737,1237,1283
8471042,8471035,TXFE7,128,9950,1,2738,1238,1284
8471079,8471079,TXFE7,128,9950,5,2743,1239,1286
8471154,8471152,TXFE7,128,9949,1,2744,1240,1287
8471317,8471310,TXFE7,128,9949,1,2745,1241,1288
8471442,8471440,TXFE7,128,9950,1,2746,1242,1289
8471642,8471637,TXFE7,128,9949,1,2747,1243,1290
8471704,8471701,TXFE7,128,9950,1,2748,1244,1291
8471704,8471703,TXFE7,128,9949,1,2749,1245,1292
8471792,8471787,TXFE7,128,9949,1,2750,1246,1293
8471842,8471839,TXFE7,128,9950,4,2754,1247,1296
8471904,8471896,TXFE7,128,9950,5,2759,1248,1301
8471904,8471902,TXFE7,128,9950,1,2760,1249,1302
8471917,8471910,TXFE7,128,9949,2,2762,1251,1303
8471942,8471934,TXFE7,128,9950,1,2763,1252,1304
8472017,8472014,TXFE7,128,9949,1,2764,1253,1305
8472029,8472023,TXFE7,128,9949,7,2771,1258,1306
8472042,8472034,TXFE7,128,9949,1,2772,1259,1307
8472054,8472043,TXFE7,128,9949,1,2773,1260,1308
8472092,8472084,TXFE7,128,9949,1,2774,1261,1309
8472154,8472145,TXFE7,128,9948,1,2775,1262,1310
8472167,8472164,TXFE7,128,9948,1,2776,1263,1311
8472229,8472222,TXFE7,128,9949,10,2786,1264,1312
8472254,8472248,TXFE7,128,9948,1,2787,1265,1313
8472304,8472293,TXFE7,128,9949,5,2792,1266,1315
8472429,8472417,TXFE7,128,9948,4,2796,1268,1316
8472429,8472419,TXFE7,128,9948,1,2797,1269,1317
8472454,8472452,TXFE7,128,9949,6,2803,1270,1321
8472479,8472473,TXFE7,128,9948,1,2804,1271,1322
8472554,8472550,TXFE7,128,9949,1,2805,1272,1323
8472692,8472684,TXFE7,128,9948,4,2809,1275,1324
8472854,8472850,TXFE7,128,9948,1,2810,1276,1325
8472879,8472867,TXFE7,128,9949,1,2811,1277,1326
8472917,8472913,TXFE7,128,9948,1,2812,1278,1327
8472967,8472965,TXFE7,128,9949,2,2814,1279,1329
8473017,8473009,TXFE7,128,9949,2,2816,1280,1330
8473067,8473054,TXFE7,128,9948,10,2826,1281,1331
8473092,8473084,TXFE7,128,9949,1,2827,1282,1332
8473292,8473288,TXFE7,128,9948,1,2828,1283,1333
8473379,8473367,TXFE7,128,9948,1,2829,1284,1334
8473442,8473436,TXFE7,128,9949,2,2831,1285,1335
8473542,8473540,TXFE7,128,9948,1,2832,1286,1336
8473579,8473576,TXFE7,128,9949,4,2836,1287,1340
8473654,8473653,TXFE7,128,9948,1,2837,1288,1341
8473742,8473737,TXFE7,128,9948,1,2838,1289,1342
8473742,8473738,TXFE7,128,9948,2,2840,1290,1343
8473804,8473798,TXFE7,128,9948,2,2842,1292,1344
8473817,8473807,TXFE7,128,9948,2,2844,1294,1345
8473817,8473809,TXFE7,128,9949,1,2845,1295,1346
8473829,8473825,TXFE7,128,9949,5,2850,1296,1348
8473992,8473984,TXFE7,128,9948,1,2851,1297,1349
8474079,8474078,TXFE7,128,9948,1,2852,1298,1350
8474192,8474188,TXFE7,128,9948,1,2853,1299,1351
8474329,8474328,TXFE7,128,9948,42,2895,1324,1352
8474342,8474329,TXFE7,128,9948,7,2902,1327,1353
8474342,8474329,TXFE7,128,9948,3,2905,1328,1354
8474342,8474329,TXFE7,128,9948,24,2929,1342,1355
8474354,8474349,TXFE7,128,9948,1,2930,1343,1356
8474367,8474359,TXFE7,128,9947,1,2931,1344,1357
8474367,8474359,TXFE7,128,9947,2,2933,1345,1358
8474379,8474372,TXFE7,128,9947,2,2935,1346,1359
8474392,8474384,TXFE7,128,9947,2,2937,1347,1360
8474429,8474426,TXFE7,128,9948,3,2940,1348,1362
8474492,8474481,TXFE7,128,9948,1,2941,1349,1363
8474742,8474730,TXFE7,128,9948,8,2949,1350,1369
8474742,8474736,TXFE7,129,9948,1,2955,1351,1374
8474742,8474736,TXFE7,129,9949,5,2955,1351,1374
8474792,8474791,TXFE7,128,9948,1,2956,1352,1375
8474804,8474792,TXFE7,128,9948,1,2957,1353,1376
8474804,8474792,TXFE7,128,9948,1,2958,1354,1377
8474854,8474848,TXFE7,128,9948,1,2959,1355,1378
8474879,8474876,TXFE7,128,9948,1,2960,1356,1379
8474892,8474887,TXFE7,128,9948,2,2962,1357,1380
8475054,8475047,TXFE7,128,9948,1,2963,1358,1381
8475054,8475047,TXFE7,128,9948,1,2964,1359,1382
8475054,8475047,TXFE7,128,9948,1,2965,1360,1383
8475129,8475119,TXFE7,128,9948,1,2966,1361,1384
8475267,8475264,TXFE7,128,9948,1,2967,1362,1385
8475392,8475380,TXFE7,128,9948,1,2968,1363,1386
8475517,8475515,TXFE7,128,9949,1,2969,1364,1387
8475554,8475553,TXFE7,128,9948,1,2970,1365,1388
8475654,8475651,TXFE7,128,9949,5,2975,1366,1390
8475729,8475725,TXFE7,128,9949,1,2976,1367,1391
8475767,8475758,TXFE7,128,9948,10,2986,1373,1392
8475804,8475803,TXFE7,128,9948,1,2987,1374,1393
8475929,8475926,TXFE7,128,9948,1,2988,1375,1394
8475967,8475960,TXFE7,128,9948,1,2989,1376,1395
8480004,8475993,TXFE7,128,9948,1,2990,1377,1396
8480029,8480023,TXFE7,128,9949,1,2991,1378,1397
8480054,8480046,TXFE7,128,9948,1,2992,1379,1398
8480079,8480068,TXFE7,128,9948,2,2994,1380,1399
8480079,8480071,TXFE7,129,9948,19,3033,1395,1400
8480079,8480071,TXFE7,129,9947,20,3033,1395,1400
8480092,8480091,TXFE7,128,9948,1,3034,1396,1401
8480129,8480124,TXFE7,128,9948,4,3038,1397,1404
8480192,8480188,TXFE7,128,9948,1,3039,1398,1405
8480204,8480202,TXFE7,128,9948,1,3040,1399,1406
8480229,8480217,TXFE7,128,9948,1,3041,1400,1407
8480254,8480248,TXFE7,128,9948,1,3042,1401,1408
8480342,8480331,TXFE7,128,9948,1,3043,1402,1409
8480342,8480336,TXFE7,128,9948,1,3044,1403,1410
8480429,8480424,TXFE7,128,9948,1,3045,1404,1411
8480467,8480465,TXFE7,128,9949,2,3047,1405,1413
8480667,8480663,TXFE7,128,9948,1,3048,1406,1414
8480717,8480708,TXFE7,128,9948,1,3049,1407,1415
8480729,8480723,TXFE7,128,9948,5,3054,1408,1420
8480754,8480746,TXFE7,128,9947,1,3055,1409,1421
8480892,8480889,TXFE7,128,9947,1,3056,1410,1422
8480929,8480917,TXFE7,128,9948,1,3057,1411,1423
8480967,8480955,TXFE7,128,9948,1,3058,1412,1424
8480992,8480982,TXFE7,128,9947,2,3060,1414,1425
8481067,8481060,TXFE7,128,9947,1,3061,1415,1426
8481192,8481186,TXFE7,128,9947,1,3062,1416,1427
8481229,8481222,TXFE7,128,9947,3,3065,1417,1428
8481267,8481260,TXFE7,128,9947,1,3066,1418,1429
8481304,8481304,TXFE7,128,9947,2,3068,1420,1430
8481304,8481304,TXFE7,128,9948,1,3069,1421,1431
8481329,8481326,TXFE7,128,9948,1,3070,1422,1432
8481367,8481364,TXFE7,128,9948,1,3071,1423,1433
8481379,8481372,TXFE7,128,9948,2,3073,1424,1435
8481392,8481379,TXFE7,128,9948,4,3077,1425,1438
8481392,8481381,TXFE7,128,9948,1,3078,1426,1439
8481454,8481443,TXFE7,128,9947,2,3080,1428,1440
8481467,8481466,TXFE7,128,9948,1,3081,1429,1441
8481492,8481486,TXFE7,128,9948,1,3082,1430,1442
8481529,8481520,TXFE7,128,9947,2,3084,1432,1443
8481542,8481535,TXFE7,128,9949,1,3085,1433,1444
8481567,8481557,TXFE7,128,9948,1,3086,1434,1445
8481642,8481632,TXFE7,129,9948,1,3091,1439,1446
8481642,8481632,TXFE7,129,9947,4,3091,1439,1446
8481767,8481760,TXFE7,128,9948,3,3094,1440,1449
8481879,8481879,TXFE7,128,9948,1,3095,1441,1450
8481992,8481990,TXFE7,128,9948,1,3096,1442,1451
8482017,8482011,TXFE7,128,9948,1,3097,1443,1452
8482204,8482196,TXFE7,128,9949,20,3117,1444,1469
8482217,8482204,TXFE7,128,9949,23,3140,1445,1478
8482217,8482213,TXFE7,128,9950,4,3144,1446,1480
8482229,8482229,TXFE7,128,9949,1,3145,1447,1481
8482229,8482229,TXFE7,128,9950,4,3149,1448,1484
8482242,8482233,TXFE7,128,9949,5,3154,1450,1485
8482254,8482252,TXFE7,128,9949,2,3156,1451,1486
8482429,8482417,TXFE7,128,9949,1,3157,1452,1487
8482479,8482471,TXFE7,128,9950,1,3158,1453,1488
8482492,8482490,TXFE7,128,9949,1,3159,1454,1489
8482554,8482553,TXFE7,128,9950,5,3164,1455,1490
8482604,8482600,TXFE7,128,9950,1,3165,1456,1491
8482654,8482654,TXFE7,128,9950,1,3166,1457,1492
8482692,8482687,TXFE7,128,9950,2,3168,1458,1493
8482704,8482695,TXFE7,128,9950,1,3169,1459,1494
8482704,8482701,TXFE7,128,9950,10,3179,1460,1501
8482754,8482752,TXFE7,128,9950,1,3180,1461,1502
8482767,8482757,TXFE7,128,9950,11,3191,1462,1509
8482792,8482786,TXFE7,128,9950,2,3193,1463,1511
8482804,8482792,TXFE7,128,9950,48,3241,1464,1537
8482817,8482815,TXFE7,128,9950,1,3242,1465,1538
8482867,8482858,TXFE7,128,9950,1,3243,1466,1539
8482867,8482859,TXFE7,128,9951,5,3248,1467,1541
8482879,8482867,TXFE7,128,9951,2,3250,1468,1543
8482892,8482882,TXFE7,128,9951,1,3251,1469,1544
8482954,8482951,TXFE7,128,9950,1,3252,1470,1545
8483004,8483004,TXFE7,128,9951,3,3255,1471,1546
8483017,8483004,TXFE7,128,9951,3,3258,1472,1547
8483029,8483026,TXFE7,128,9951,3,3261,1473,1549
8483054,8483051,TXFE7,128,9951,3,3264,1474,1552
8483067,8483058,TXFE7,128,9951,1,3265,1475,1553
8483079,8483068,TXFE7,128,9951,3,3268,1476,1555
8483117,8483110,TXFE7,128,9950,1,3269,1477,1556
8483192,8483192,TXFE7,128,9951,1,3270,1478,1557
8483217,8483205,TXFE7,128,9950,1,3271,1479,1558
8483229,8483229,TXFE7,128,9950,1,3272,1480,1559
8483254,8483245,TXFE7,128,9950,1,3273,1481,1560
8483279,8483270,TXFE7,128,9951,2,3275,1482,1561
8483429,8483426,TXFE7,128,9951,1,3276,1483,1562
8483442,8483439,TXFE7,128,9951,1,3277,1484,1563
8483554,8483546,TXFE7,128,9951,1,3278,1485,1564
8483579,8483572,TXFE7,128,9950,1,3279,1486,1565
8483592,8483583,TXFE7,128,9951,1,3280,1487,1566
8483742,8483731,TXFE7,128,9951,1,3281,1488,1567
8483817,8483813,TXFE7,128,9951,1,3282,1489,1568
8483817,8483815,TXFE7,128,9951,1,3283,1490,1569
8483992,8483985,TXFE7,128,9950,5,3288,1495,1570
8484054,8484047,TXFE7,128,9950,3,3291,1498,1571
8484267,8484262,TXFE7,128,9950,1,3292,1499,1572
8484467,8484463,TXFE7,128,9950,1,3293,1500,1573
8484554,8484553,TXFE7,128,9951,5,3298,1501,1574
8484654,8484646,TXFE7,128,9950,9,3307,1505,1575
8484667,8484654,TXFE7,128,9950,1,3308,1506,1576
8484679,8484669,TXFE7,128,9950,1,3309,1507,1577
8484679,8484672,TXFE7,128,9950,1,3310,1508,1578
8484729,8484724,TXFE7,128,9950,1,3311,1509,1579
8484804,8484794,TXFE7,128,9951,1,3312,1510,1580
8484829,8484818,TXFE7,128,9950,1,3313,1511,1581
8484842,8484829,TXFE7,128,9950,1,3314,1512,1582
8484842,8484829,TXFE7,128,9950,1,3315,1513,1583
8484879,8484875,TXFE7,128,9951,2,3317,1514,1584
8485029,8485017,TXFE7,128,9950,1,3318,1515,1585
8485029,8485021,TXFE7,128,9950,3,3321,1518,1586
8485079,8485067,TXFE7,128,9950,1,3322,1519,1587
8485142,8485132,TXFE7,128,9951,1,3323,1520,1588
8485179,8485177,TXFE7,128,9950,1,3324,1521,1589
8485304,8485303,TXFE7,128,9951,1,3325,1522,1590
8485392,8485383,TXFE7,128,9951,2,3327,1523,1592
8485429,8485427,TXFE7,128,9950,1,3328,1524,1593
8485567,8485562,TXFE7,128,9950,3,3331,1526,1594
8485604,8485596,TXFE7,128,9951,1,3332,1527,1595
8485617,8485610,TXFE7,128,9950,2,3334,1529,1596
8485692,8485685,TXFE7,128,9951,1,3335,1530,1597
8485767,8485763,TXFE7,128,9951,2,3337,1531,1598
8485779,8485771,TXFE7,128,9950,1,3338,1532,1599
8490104,8490092,TXFE7,128,9951,7,3345,1533,1603
8490167,8490157,TXFE7,128,9951,2,3347,1534,1605
8490454,8490452,TXFE7,128,9951,1,3348,1535,1606
8490504,8490501,TXFE7,128,9951,1,3349,1536,1607
8490567,8490566,TXFE7,128,9951,2,3351,1537,1609
8490654,8490648,TXFE7,128,9951,1,3352,1538,1610
8490704,8490701,TXFE7,128,9951,5,3357,1539,1614
8490792,8490787,TXFE7,128,9950,1,3358,1540,1615
8490817,8490813,TXFE7,128,9951,1,3359,1541,1616
8491004,8491003,TXFE7,128,9951,1,3360,1542,1617
8491017,8491011,TXFE7,128,9951,2,3362,1543,1619
8491029,8491019,TXFE7,128,9951,2,3364,1544,1621
8491154,8491149,TXFE7,128,9951,1,3365,1545,1622
8491217,8491211,TXFE7,128,9951,2,3367,1546,1624
8491417,8491411,TXFE7,128,9951,1,3368,1547,1625
8491442,8491431,TXFE7,128,9950,1,3369,1548,1626
8491567,8491565,TXFE7,128,9950,1,3370,1549,1627
8492192,8492188,TXFE7,128,9951,2,3372,1550,1629
8492292,8492284,TXFE7,128,9951,1,3373,1551,1630
8492454,8492443,TXFE7,128,9950,1,3374,1552,1631
8492492,8492480,TXFE7,128,9951,1,3375,1553,1632
8492617,8492606,TXFE7,128,9950,1,3376,1554,1633
8492667,8492664,TXFE7,128,9951,1,3377,1555,1634
8492767,8492763,TXFE7,128,9951,5,3382,1556,1638
8493017,8493005,TXFE7,128,9951,10,3392,1557,1641
8493242,8493238,TXFE7,128,9951,1,3393,1558,1642
8493254,8493252,TXFE7,128,9951,1,3394,1559,1643
8493379,8493373,TXFE7,128,9950,2,3396,1560,1644
8493467,8493464,TXFE7,128,9951,1,3397,1561,1645
8493742,8493732,TXFE7,128,9950,1,3398,1562,1646
8493754,8493751,TXFE7,128,9950,2,3400,1564,1647
8493817,8493805,TXFE7,128,9950,1,3401,1565,1648
8494129,8494119,TXFE7,128,9951,1,3402,1566,1649
8494342,8494341,TXFE7,128,9951,3,3405,1567,1652
8494354,8494345,TXFE7,128,9951,4,3409,1568,1655
8494379,8494368,TXFE7,128,9951,4,3413,1569,1657
8494417,8494416,TXFE7,128,9951,5,3418,1570,1662
8494454,8494443,TXFE7,128,9951,3,3421,1571,1665
8494467,8494455,TXFE7,128,9951,29,3450,1572,1691
8494492,8494480,TXFE7,128,9951,2,3452,1573,1692
8494567,8494566,TXFE7,128,9952,2,3454,1574,1694
8494692,8494681,TXFE7,128,9952,1,3455,1575,1695
8494792,8494783,TXFE7,128,9951,1,3456,1576,1696
8494804,8494802,TXFE7,128,9952,3,3459,1577,1699
8494817,8494806,TXFE7,128,9952,1,3460,1578,1700
8494817,8494806,TXFE7,128,9952,7,3467,1579,1703
8494817,8494806,TXFE7,128,9952,4,3471,1580,1704
8494817,8494806,TXFE7,128,9952,6,3477,1581,1705
8494817,8494806,TXFE7,128,9952,1,3478,1582,1706
8494817,8494807,TXFE7,128,9952,8,3486,1583,1707
8494817,8494807,TXFE7,128,9952,1,3487,1584,1708
8494817,8494807,TXFE7,128,9952,2,3489,1585,1709
8494817,8494807,TXFE7,128,9952,2,3491,1586,1710
8494817,8494807,TXFE7,128,9952,8,3499,1587,1716
8494817,8494807,TXFE7,128,9952,15,3514,1588,1726
8494817,8494807,TXFE7,128,9952,47,3561,1589,1754
8494829,8494817,TXFE7,128,9953,6,3567,1590,1757
8494829,8494819,TXFE7,128,9953,10,3577,1591,1760
8494829,8494820,TXFE7,128,9953,7,3584,1592,1764
8494842,8494829,TXFE7,128,9953,7,3591,1593,1766
8494842,8494830,TXFE7,128,9952,22,3613,1602,1767
8494842,8494830,TXFE7,128,9952,3,3616,1603,1768
8494842,8494837,TXFE7,128,9953,1,3617,1604,1769
8494854,8494848,TXFE7,128,9953,11,3628,1605,1770
8494867,8494854,TXFE7,128,9953,1,3629,1606,1771
8494867,8494862,TXFE7,128,9953,2,3631,1607,1772
8494892,8494885,TXFE7,128,9953,1,3632,1608,1773
8494892,8494885,TXFE7,128,9953,2,3634,1609,1774
8494892,8494890,TXFE7,128,9953,1,3635,1610,1775
8494904,8494899,TXFE7,128,9953,1,3636,1611,1776
8494917,8494908,TXFE7,128,9953,1,3637,1612,1777
8494992,8494991,TXFE7,128,9953,2,3639,1613,1778
8495092,8495086,TXFE7,128,9953,1,3640,1614,1779
8495104,8495103,TXFE7,128,9953,1,3641,1615,1780
8495129,8495123,TXFE7,128,9953,1,3642,1616,1781
8495142,8495141,TXFE7,128,9953,1,3643,1617,1782
8495179,8495174,TXFE7,128,9953,1,3644,1618,1783
8495179,8495174,TXFE7,128,9953,1,3645,1619,1784
8495179,8495179,TXFE7,128,9952,3,3648,1622,1785
8495204,8495194,TXFE7,128,9953,1,3649,1623,1786
8495204,8495203,TXFE7,128,9953,1,3650,1624,1787
8495204,8495204,TXFE7,128,9953,1,3651,1625,1788
8495304,8495293,TXFE7,128,9953,1,3652,1626,1789
8495317,8495306,TXFE7,128,9952,1,3653,1627,1790
8495317,8495310,TXFE7,128,9953,5,3658,1628,1791
8495329,8495317,TXFE7,128,9953,1,3659,1629,1792
8495329,8495321,TXFE7,128,9953,5,3664,1630,1793
8495329,8495327,TXFE7,128,9953,1,3665,1631,1794
8495329,8495327,TXFE7,128,9953,1,3666,1632,1795
8495342,8495332,TXFE7,128,9953,1,3667,1633,1796
8495342,8495340,TXFE7,128,9953,1,3668,1634,1797
8495354,8495349,TXFE7,128,9953,1,3669,1635,1798
8495354,8495353,TXFE7,128,9952,3,3672,1636,1799
8495367,8495355,TXFE7,128,9953,1,3673,1637,1800
8495367,8495355,TXFE7,128,9953,1,3674,1638,1801
8495367,8495364,TXFE7,128,9953,1,3675,1639,1802
8495367,8495365,TXFE7,128,9953,1,3676,1640,1803
8495367,8495366,TXFE7,128,9953,1,3677,1641,1804
8495392,8495380,TXFE7,128,9953,1,3678,1642,1805
8495392,8495383,TXFE7,128,9953,1,3679,1643,1806
8495392,8495385,TXFE7,128,9953,1,3680,1644,1807
8495404,8495398,TXFE7,128,9953,1,3681,1645,1808
8495404,8495399,TXFE7,128,9953,1,3682,1646,1809
8495417,8495404,TXFE7,128,9953,1,3683,1647,1810
8495417,8495415,TXFE7,128,9953,1,3684,1648,1811
8495442,8495434,TXFE7,128,9953,1,3685,1649,1812
8495467,8495455,TXFE7,128,9952,9,3694,1651,1813
8495467,8495456,TXFE7,128,9953,1,3695,1652,1814
8495467,8495460,TXFE7,128,9953,5,3700,1653,1815
8495479,8495471,TXFE7,128,9953,1,3701,1654,1816
8495504,8495494,TXFE7,128,9952,1,3702,1655,1817
8495517,8495505,TXFE7,128,9953,1,3703,1656,1818
8495517,8495507,TXFE7,128,9953,2,3705,1657,1819
8495542,8495531,TXFE7,128,9953,2,3707,1658,1820
8495592,8495588,TXFE7,128,9953,1,3708,1659,1821
8495617,8495615,TXFE7,128,9953,1,3709,1660,1822
8495642,8495636,TXFE7,128,9953,1,3710,1661,1823
8495667,8495662,TXFE7,128,9953,2,3712,1662,1824
8495679,8495670,TXFE7,128,9953,10,3722,1663,1825
8495692,8495686,TXFE7,128,9953,3,3725,1664,1826
8495704,8495692,TXFE7,128,9953,8,3733,1665,1827
8495717,8495706,TXFE7,128,9953,1,3734,1666,1828
8495717,8495713,TXFE7,128,9953,6,3740,1667,1834
8495742,8495735,TXFE7,128,9953,2,3742,1668,1835
8495742,8495739,TXFE7,128,9952,5,3747,1670,1836
8495754,8495747,TXFE7,128,9953,3,3750,1671,1837
8495767,8495761,TXFE7,128,9953,1,3751,1672,1838
8495767,8495765,TXFE7,128,9953,5,3756,1673,1839
8495767,8495767,TXFE7,128,9952,1,3757,1674,1840
8495792,8495785,TXFE7,128,9953,1,3758,1675,1841
8495804,8495796,TXFE7,128,9953,1,3759,1676,1842
8495817,8495813,TXFE7,128,9953,1,3760,1677,1843
8495817,8495813,TXFE7,128,9953,1,3761,1678,1844
8495829,8495822,TXFE7,128,9953,10,3771,1679,1849
8495829,8495826,TXFE7,128,9953,1,3772,1680,1850
8495854,8495853,TXFE7,128,9953,1,3773,1681,1851
8495867,8495859,TXFE7,128,9953,1,3774,1682,1852
8495867,8495865,TXFE7,128,9952,1,3775,1683,1853
8495879,8495875,TXFE7,128,9953,5,3780,1684,1855
8495892,8495882,TXFE7,128,9953,1,3781,1685,1856
8500029,8500022,TXFE7,128,9953,1,3782,1686,1857
8500067,8500066,TXFE7,128,9952,1,3783,1687,1858
8500117,8500112,TXFE7,128,9953,1,3784,1688,1859
8500117,8500114,TXFE7,128,9953,2,3786,1689,1860
8500179,8500177,TXFE7,128,9953,1,3787,1690,1861
8500192,8500181,TXFE7,128,9953,4,3791,1691,1862
8500217,8500212,TXFE7,128,9952,1,3792,1692,1863
8500242,8500234,TXFE7,128,9953,1,3793,1693,1864
8500329,8500323,TXFE7,128,9953,1,3794,1694,1865
8500342,8500338,TXFE7,128,9953,1,3795,1695,1866
8500392,8500382,TXFE7,128,9953,1,3796,1696,1867
8500542,8500529,TXFE7,128,9953,1,3797,1697,1868
8500554,8500548,TXFE7,128,9953,1,3798,1698,1869
8500579,8500572,TXFE7,128,9952,4,3802,1702,1870
8500754,8500744,TXFE7,128,9953,5,3807,1703,1871
8500779,8500778,TXFE7,128,9953,2,3809,1704,1873
8500942,8500935,TXFE7,128,9952,9,3818,1709,1874
8500954,8500953,TXFE7,128,9952,1,3819,1710,1875
8500967,8500957,TXFE7,128,9953,8,3827,1711,1880
8501042,8501038,TXFE7,128,9953,1,3828,1712,1881
8501142,8501138,TXFE7,128,9953,1,3829,1713,1882
8501167,8501158,TXFE7,128,9953,1,3830,1714,1883
8501179,8501168,TXFE7,128,9953,2,3832,1715,1884
8501229,8501222,TXFE7,128,9953,1,3833,1716,1885
8501254,8501250,TXFE7,128,9953,40,3873,1717,1910
8501254,8501250,TXFE7,128,9953,1,3874,1718,1911
8501267,8501254,TXFE7,128,9953,1,3875,1719,1912
8501267,8501254,TXFE7,128,9953,2,3877,1720,1914
8501267,8501254,TXFE7,128,9953,3,3880,1721,1917
8501267,8501265,TXFE7,128,9954,1,3881,1722,1918
8501279,8501271,TXFE7,128,9954,5,3886,1723,1923
8501292,8501282,TXFE7,128,9954,1,3887,1724,1924
8501304,8501295,TXFE7,128,9954,4,3891,1725,1925
8501304,8501301,TXFE7,128,9954,1,3892,1726,1926
8501329,8501320,TXFE7,128,9954,1,3893,1727,1927
8501417,8501416,TXFE7,128,9954,1,3894,1728,1928
8501429,8501429,TXFE7,128,9953,1,3895,1729,1929
8501492,8501483,TXFE7,128,9953,1,3896,1730,1930
8501504,8501495,TXFE7,128,9954,1,3897,1731,1931
8501517,8501512,TXFE7,128,9953,1,3898,1732,1932
8501529,8501520,TXFE7,128,9953,1,3899,1733,1933
8501554,8501552,TXFE7,128,9954,1,3900,1734,1934
8501667,8501656,TXFE7,128,9953,34,3934,1750,1935
8501679,8501667,TXFE7,128,9953,1,3935,1751,1936
8501679,8501678,TXFE7,128,9953,1,3936,1752,1937
8501692,8501692,TXFE7,128,9953,1,3937,1753,1938
8501767,8501762,TXFE7,128,9953,1,3938,1754,1939
8501792,8501791,TXFE7,128,9952,1,3939,1755,1940
8501842,8501832,TXFE7,128,9953,1,3940,1756,1941
8501854,8501842,TXFE7,128,9953,1,3941,1757,1942
8501854,8501846,TXFE7,128,9953,1,3942,1758,1943
8501854,8501847,TXFE7,128,9953,1,3943,1759,1944
8501854,8501853,TXFE7,128,9953,1,3944,1760,1945
8501879,8501872,TXFE7,128,9953,4,3948,1761,1948
8501892,8501891,TXFE7,128,9954,1,3949,1762,1949
8501979,8501975,TXFE7,128,9953,1,3950,1763,1950
8501992,8501985,TXFE7,128,9953,1,3951,1764,1951
8502104,8502093,TXFE7,128,9953,6,3957,1766,1952
8502129,8502123,TXFE7,128,9953,1,3958,1767,1953
8502154,8502143,TXFE7,128,9954,4,3962,1768,1956
8502179,8502169,TXFE7,128,9954,3,3965,1769,1957
8502192,8502188,TXFE7,128,9953,1,3966,1770,1958
8502204,8502195,TXFE7,128,9953,9,3975,1777,1959
8502279,8502275,TXFE7,128,9953,1,3976,1778,1960
8502292,8502287,TXFE7,128,9952,2,3978,1779,1961
8502304,8502304,TXFE7,128,9953,2,3980,1780,1963
8502317,8502313,TXFE7,128,9953,1,3981,1781,1964
8502442,8502432,TXFE7,128,9953,1,3982,1782,1965
8502454,8502446,TXFE7,128,9953,1,3983,1783,1966
8502479,8502476,TXFE7,128,9953,1,3984,1784,1967
8502492,8502488,TXFE7,128,9952,2,3986,1785,1968
8502517,8502506,TXFE7,128,9952,2,3988,1786,1969
8502529,8502517,TXFE7,128,9953,1,3989,1787,1970
8502604,8502599,TXFE7,128,9953,1,3990,1788,1971
8502617,8502605,TXFE7,128,9953,4,3994,1789,1974
8502642,8502642,TXFE7,128,9952,11,4005,1791,1975
8502667,8502657,TXFE7,128,9952,1,4006,1792,1976
8502667,8502660,TXFE7,128,9953,1,4007,1793,1977
8502667,8502666,TXFE7,128,9954,1,4008,1794,1978
8502867,8502856,TXFE7,128,9954,4,4012,1795,1979
8502879,8502873,TXFE7,128,9953,1,4013,1796,1980
8502879,8502874,TXFE7,128,9954,1,4014,1797,1981
8502904,8502897,TXFE7,128,9953,1,4015,1798,1982
8502942,8502941,TXFE7,128,9953,7,4022,1801,1983
8502954,8502947,TXFE7,129,9953,1,4035,1809,1984
8502954,8502947,TXFE7,129,9952,12,4035,1809,1984
8502979,8502967,TXFE7,128,9953,1,4036,1810,1985
8502992,8502986,TXFE7,128,9953,1,4037,1811,1986
8503054,8503046,TXFE7,128,9953,1,4038,1812,1987
8503154,8503149,TXFE7,128,9953,2,4040,1813,1989
8503167,8503166,TXFE7,128,9953,1,4041,1814,1990
8503242,8503240,TXFE7,128,9953,2,4043,1815,1991
8503392,8503381,TXFE7,128,9954,10,4053,1816,1995
8503392,8503384,TXFE7,128,9953,1,4054,1817,1996
8503417,8503417,TXFE7,128,9953,1,4055,1818,1997
8503492,8503487,TXFE7,128,9953,1,4056,1819,1998
8503529,8503522,TXFE7,128,9953,1,4057,1820,1999
8503529,8503523,TXFE7,128,9953,1,4058,1821,2000
8503529,8503526,TXFE7,128,9953,1,4059,1822,2001
8503679,8503670,TXFE7,128,9954,1,4060,1823,2002
8503729,8503719,TXFE7,128,9953,1,4061,1824,2003
8503742,8503741,TXFE7,128,9954,10,4071,1825,2013
8503754,8503753,TXFE7,128,9954,10,4081,1826,2017
8503829,8503826,TXFE7,128,9954,1,4082,1827,2018
8503929,8503922,TXFE7,128,9954,4,4086,1828,2020
8503954,8503951,TXFE7,128,9953,2,4088,1829,2021
8503967,8503960,TXFE7,128,9954,1,4089,1830,2022
8503992,8503989,TXFE7,128,9954,1,4090,1831,2023
8503992,8503991,TXFE7,128,9954,2,4092,1832,2024
8503992,8503991,TXFE7,128,9954,6,4098,1833,2029
8503992,8503991,TXFE7,128,9954,2,4100,1834,2031
8503992,8503991,TXFE7,128,9954,36,4136,1835,2050
8504017,8504011,TXFE7,128,9954,1,4137,1836,2051
8504054,8504047,TXFE7,128,9955,1,4138,1837,2052
8504054,8504053,TXFE7,128,9954,1,4139,1838,2053
8504067,8504059,TXFE7,128,9955,5,4144,1839,2057
8504067,8504064,TXFE7,128,9955,1,4145,1840,2058
8504079,8504074,TXFE7,128,9955,1,4146,1841,2059
8504079,8504078,TXFE7,128,9955,2,4148,1842,2060
8504092,8504088,TXFE7,128,9955,2,4150,1843,2061
8504117,8504105,TXFE7,128,9955,2,4152,1844,2062
8504129,8504123,TXFE7,128,9955,2,4154,1845,2063
8504142,8504131,TXFE7,128,9954,3,4157,1847,2064
8504154,8504154,TXFE7,128,9955,1,4158,1848,2065
8504192,8504187,TXFE7,128,9955,1,4159,1849,2066
8504242,8504232,TXFE7,128,9955,6,4165,1850,2067
8504279,8504275,TXFE7,128,9955,1,4166,1851,2068
8504342,8504333,TXFE7,128,9955,1,4167,1852,2069
8504354,8504352,TXFE7,128,9955,1,4168,1853,2070
8504392,8504392,TXFE7,128,9954,1,4169,1854,2071
8504429,8504420,TXFE7,128,9954,3,4172,1855,2072
8504504,8504493,TXFE7,128,9955,1,4173,1856,2073
8504504,8504501,TXFE7,128,9955,1,4174,1857,2074
8504542,8504537,TXFE7,128,9955,1,4175,1858,2075
8504542,8504538,TXFE7,128,9954,1,4176,1859,2076
8504579,8504575,TXFE7,128,9954,1,4177,1860,2077
8504617,8504611,TXFE7,128,9955,1,4178,1861,2078
8504617,8504611,TXFE7,128,9955,1,4179,1862,2079
8504679,8504675,TXFE7,128,9955,1,4180,1863,2080
8504692,8504681,TXFE7,128,9955,6,4186,1864,2085
8504717,8504713,TXFE7,128,9955,1,4187,1865,2086
8504729,8504718,TXFE7,128,9955,2,4189,1866,2087
8504779,8504774,TXFE7,128,9954,1,4190,1867,2088
8504804,8504800,TXFE7,128,9955,3,4193,1868,2091
8504804,8504800,TXFE7,128,9955,2,4195,1869,2093
8504829,8504829,TXFE7,128,9955,1,4196,1870,2094
8504842,8504831,TXFE7,128,9955,1,4197,1871,2095
8504867,8504857,TXFE7,128,9955,1,4198,1872,2096
8504904,8504898,TXFE7,128,9954,1,4199,1873,2097
8504929,8504923,TXFE7,128,9954,2,4201,1874,2098
8504929,8504925,TXFE7,128,9954,1,4202,1875,2099
8504979,8504968,TXFE7,128,9955,1,4203,1876,2100
8504979,8504978,TXFE7,128,9954,2,4205,1877,2101
8504992,8504984,TXFE7,128,9955,1,4206,1878,2102
8505042,8505034,TXFE7,128,9954,17,4223,1890,2103
8505054,8505042,TXFE7,128,9954,7,4230,1891,2106
8505054,8505053,TXFE7,128,9954,1,4231,1892,2107
8505054,8505054,TXFE7,128,9954,1,4232,1893,2108
8505067,8505054,TXFE7,128,9954,7,4239,1894,2110
8505067,8505060,TXFE7,128,9954,1,4240,1895,2111
8505117,8505111,TXFE7,128,9954,1,4241,1896,2112
8505129,8505118,TXFE7,128,9954,1,4242,1897,2113
8505154,8505153,TXFE7,128,9954,1,4243,1898,2114
8505179,8505171,TXFE7,128,9954,1,4244,1899,2115
8505242,8505236,TXFE7,128,9954,1,4245,1900,2116
8505279,8505271,TXFE7,128,9954,1,4246,1901,2117
8505342,8505331,TXFE7,128,9954,1,4247,1902,2118
8505342,8505333,TXFE7,128,9954,1,4248,1903,2119
8505379,8505379,TXFE7,128,9954,1,4249,1904,2120
8505392,8505383,TXFE7,128,9953,1,4250,1905,2121
8505429,8505425,TXFE7,128,9954,1,4251,1906,2122
8505429,8505429,TXFE7,128,9954,1,4252,1907,2123
8505467,8505455,TXFE7,128,9954,1,4253,1908,2124
8505517,8505508,TXFE7,128,9954,2,4255,1909,2126
8505554,8505543,TXFE7,128,9954,5,4260,1910,2130
8505567,8505562,TXFE7,128,9954,3,4263,1911,2133
8505617,8505616,TXFE7,128,9954,1,4264,1912,2134
8505654,8505652,TXFE7,128,9954,1,4265,1913,2135
8505717,8505708,TXFE7,128,9953,3,4268,1914,2136
8505754,8505745,TXFE7,128,9954,1,4269,1915,2137
8505792,8505785,TXFE7,128,9954,1,4270,1916,2138
8505829,8505822,TXFE7,128,9954,1,4271,1917,2139
8505892,8505881,TXFE7,128,9954,1,4272,1918,2140
8505929,8505925,TXFE7,128,9954,1,4273,1919,2141
8505992,8505982,TXFE7,128,9954,2,4275,1920,2143
8510017,8510006,TXFE7,128,9954,1,4276,1921,2144
8510017,8510011,TXFE7,128,9954,1,4277,1922,2145
8510054,8510043,TXFE7,128,9954,1,4278,1923,2146
8510054,8510049,TXFE7,128,9954,10,4288,1924,2153
8510067,8510054,TXFE7,128,9954,1,4289,1925,2154
8510142,8510135,TXFE7,128,9955,1,4290,1926,2155
8510154,8510146,TXFE7,128,9955,2,4292,1927,2157
8510167,8510156,TXFE7,128,9955,1,4293,1928,2158
8510179,8510176,TXFE7,128,9954,3,4296,1929,2159
8510204,8510194,TXFE7,128,9954,1,4297,1930,2160
8510204,8510203,TXFE7,128,9954,1,4298,1931,2161
8510217,8510210,TXFE7,128,9954,1,4299,1932,2162
8510217,8510215,TXFE7,128,9954,1,4300,1933,2163
8510229,8510226,TXFE7,128,9955,1,4301,1934,2164
8510329,8510328,TXFE7,128,9954,1,4302,1935,2165
8510342,8510333,TXFE7,128,9954,1,4303,1936,2166
8510342,8510335,TXFE7,128,9954,4,4307,1940,2167
8510354,8510343,TXFE7,128,9954,1,4308,1941,2168
8510367,8510360,TXFE7,128,9954,1,4309,1942,2169
8510367,8510363,TXFE7,128,9954,1,4310,1943,2170
8510429,8510417,TXFE7,128,9954,1,4311,1944,2171
8510454,8510445,TXFE7,128,9955,2,4313,1945,2173
8510492,8510482,TXFE7,128,9955,2,4315,1946,2174
8510492,8510486,TXFE7,128,9955,1,4316,1947,2175
8510529,8510523,TXFE7,128,9955,1,4317,1948,2176
8510554,8510550,TXFE7,128,9954,1,4318,1949,2177
8510617,8510615,TXFE7,128,9954,1,4319,1950,2178
8510629,8510618,TXFE7,128,9955,1,4320,1951,2179
8510679,8510677,TXFE7,128,9955,1,4321,1952,2180
8510717,8510707,TXFE7,128,9955,3,4324,1953,2183
8510854,8510845,TXFE7,128,9955,1,4325,1954,2184
8510879,8510875,TXFE7,128,9955,1,4326,1955,2185
8510904,8510894,TXFE7,128,9955,40,4366,1956,2203
8510929,8510917,TXFE7,128,9955,1,4367,1957,2204
8510967,8510960,TXFE7,128,9955,1,4368,1958,2205
8511004,8511003,TXFE7,128,9954,1,4369,1959,2206
8511029,8511026,TXFE7,128,9955,1,4370,1960,2207
8511042,8511033,TXFE7,128,9954,1,4371,1961,2208
8511042,8511039,TXFE7,128,9955,1,4372,1962,2209
8511092,8511088,TXFE7,128,9954,1,4373,1963,2210
8511104,8511102,TXFE7,128,9955,2,4375,1964,2212
8511142,8511134,TXFE7,128,9955,1,4376,1965,2213
8511154,8511142,TXFE7,128,9955,1,4377,1966,2214
8511204,8511203,TXFE7,128,9955,10,4387,1967,2222
8511217,8511204,TXFE7,128,9955,1,4388,1968,2223
8511254,8511243,TXFE7,128,9955,5,4393,1969,2228
8511267,8511257,TXFE7,128,9955,1,4394,1970,2229
8511279,8511267,TXFE7,128,9955,1,4395,1971,2230
8511292,8511284,TXFE7,128,9955,2,4397,1972,2231
8511304,8511294,TXFE7,128,9955,1,4398,1973,2232
8511304,8511300,TXFE7,128,9955,2,4400,1974,2234
8511304,8511300,TXFE7,128,9955,3,4403,1975,2236
8511317,8511313,TXFE7,128,9955,2,4405,1976,2237
8511329,8511325,TXFE7,128,9955,2,4407,1977,2239
8511354,8511351,TXFE7,128,9955,2,4409,1978,2241
8511367,8511355,TXFE7,128,9955,8,4417,1979,2246
8511367,8511356,TXFE7,128,9955,1,4418,1980,2247
8511379,8511374,TXFE7,128,9955,1,4419,1981,2248
8511392,8511379,TXFE7,128,9955,1,4420,1982,2249
8511392,8511391,TXFE7,128,9955,1,4421,1983,2250
8511417,8511404,TXFE7,128,9955,1,4422,1984,2251
8511554,8511546,TXFE7,128,9955,1,4423,1985,2252
8511579,8511578,TXFE7,128,9955,1,4424,1986,2253
8511592,8511583,TXFE7,128,9955,1,4425,1987,2254
8511629,8511625,TXFE7,128,9955,1,4426,1988,2255
8511692,8511687,TXFE7,128,9955,1,4427,1989,2256
8511717,8511705,TXFE7,128,9955,2,4429,1990,2258
8511754,8511746,TXFE7,128,9954,2,4431,1991,2259
8511792,8511784,TXFE7,128,9954,10,4441,1997,2260
8511817,8511808,TXFE7,128,9955,1,4442,1998,2261
8511817,8511815,TXFE7,128,9955,1,4443,1999,2262
8511867,8511867,TXFE7,128,9954,3,4446,2002,2263
8511879,8511868,TXFE7,128,9955,2,4448,2003,2264
8511929,8511918,TXFE7,128,9955,1,4449,2004,2265
8511954,8511950,TXFE7,128,9954,1,4450,2005,2266
8511992,8511989,TXFE7,128,9955,1,4451,2006,2267
8512004,8511992,TXFE7,128,9954,10,4461,2010,2268
8512004,8512002,TXFE7,128,9954,1,4462,2011,2269
8512017,8512004,TXFE7,128,9954,2,4464,2012,2270
8512029,8512020,TXFE7,128,9953,1,4465,2013,2271
8512092,8512087,TXFE7,128,9954,1,4466,2014,2272
8512092,8512088,TXFE7,128,9954,1,4467,2015,2273
8512104,8512096,TXFE7,128,9955,1,4468,2016,2274
8512117,8512112,TXFE7,128,9954,1,4469,2017,2275
8512117,8512115,TXFE7,128,9955,1,4470,2018,2276
8512142,8512136,TXFE7,128,9954,1,4471,2019,2277
8512142,8512140,TXFE7,128,9954,1,4472,2020,2278
8512192,8512185,TXFE7,128,9955,1,4473,2021,2279
8512204,8512204,TXFE7,128,9955,1,4474,2022,2280
8512267,8512262,TXFE7,128,9955,2,4476,2023,2282
8512304,8512298,TXFE7,128,9954,1,4477,2024,2283
8512342,8512336,TXFE7,128,9955,1,4478,2025,2284
8512429,8512421,TXFE7,128,9954,1,4479,2026,2285
8512479,8512476,TXFE7,128,9954,1,4480,2027,2286
8512504,8512503,TXFE7,128,9954,1,4481,2028,2287
8512542,8512535,TXFE7,128,9955,1,4482,2029,2288
8512542,8512541,TXFE7,128,9954,1,4483,2030,2289
8512579,8512575,TXFE7,128,9954,1,4484,2031,2290
8512579,8512575,TXFE7,128,9954,1,4485,2032,2291
8512617,8512610,TXFE7,128,9954,2,4487,2033,2293
8512629,8512618,TXFE7,128,9953,1,4488,2034,2294
8512629,8512621,TXFE7,128,9953,5,4493,2037,2295
8512704,8512702,TXFE7,128,9954,2,4495,2038,2297
8512717,8512704,TXFE7,128,9954,7,4502,2039,2300
8512779,8512776,TXFE7,128,9955,5,4507,2040,2305
8512829,8512818,TXFE7,128,9954,1,4508,2041,2306
8512829,8512827,TXFE7,128,9954,1,4509,2042,2307
8512867,8512855,TXFE7,128,9954,1,4510,2043,2308
8512904,8512893,TXFE7,128,9955,1,4511,2044,2309
8513167,8513163,TXFE7,128,9955,1,4512,2045,2310
8513242,8513238,TXFE7,128,9955,3,4515,2046,2313
8513254,8513244,TXFE7,129,9954,15,4555,2064,2314
8513254,8513244,TXFE7,129,9953,25,4555,2064,2314
8513279,8513271,TXFE7,128,9954,1,4556,2065,2315
8513304,8513296,TXFE7,128,9954,1,4557,2066,2316
8513304,8513298,TXFE7,128,9954,2,4559,2067,2318
8513317,8513307,TXFE7,128,9954,8,4567,2068,2320
8513342,8513329,TXFE7,128,9954,1,4568,2069,2321
8513354,8513347,TXFE7,128,9954,1,4569,2070,2322
8513367,8513360,TXFE7,128,9953,1,4570,2071,2323
8513429,8513427,TXFE7,128,9954,1,4571,2072,2324
8513479,8513473,TXFE7,128,9955,3,4574,2073,2326
8513642,8513638,TXFE7,128,9955,1,4575,2074,2327
8513667,8513655,TXFE7,128,9954,1,4576,2075,2328
8513679,8513667,TXFE7,128,9954,2,4578,2077,2329
8514004,8513992,TXFE7,128,9954,2,4580,2079,2330
8514017,8514011,TXFE7,128,9955,2,4582,2080,2331
8514117,8514112,TXFE7,128,9954,5,4587,2081,2332
8514342,8514341,TXFE7,128,9954,1,4588,2082,2333
8514392,8514386,TXFE7,128,9954,1,4589,2083,2334
8514404,8514393,TXFE7,128,9954,1,4590,2084,2335
8514429,8514421,TXFE7,128,9954,10,4600,2085,2340
8514454,8514445,TXFE7,128,9953,1,4601,2086,2341
8514454,8514452,TXFE7,128,9954,1,4602,2087,2342
8514479,8514474,TXFE7,128,9954,5,4607,2088,2343
8514579,8514567,TXFE7,128,9954,1,4608,2089,2344
8514592,8514580,TXFE7,128,9954,1,4609,2090,2345
8514604,8514599,TXFE7,128,9954,1,4610,2091,2346
8514792,8514783,TXFE7,128,9954,5,4615,2092,2351
8514842,8514831,TXFE7,128,9954,1,4616,2093,2352
8514867,8514863,TXFE7,128,9953,1,4617,2094,2353
8514904,8514894,TXFE7,128,9953,1,4618,2095,2354
8515004,8515004,TXFE7,128,9954,3,4621,2096,2356
8515029,8515018,TXFE7,128,9954,1,4622,2097,2357
8515054,8515051,TXFE7,128,9954,1,4623,2098,2358
8515067,8515055,TXFE7,128,9954,2,4625,2099,2359
8515079,8515069,TXFE7,128,9954,1,4626,2100,2360
8515092,8515079,TXFE7,128,9954,1,4627,2101,2361
8515142,8515130,TXFE7,128,9954,2,4629,2102,2362
8515254,8515244,TXFE7,128,9954,1,4630,2103,2363
8515379,8515370,TXFE7,128,9954,1,4631,2104,2364
8515417,8515405,TXFE7,128,9953,1,4632,2105,2365
8515467,8515458,TXFE7,128,9954,1,4633,2106,2366
8515554,8515554,TXFE7,128,9953,7,4640,2111,2367
8515567,8515560,TXFE7,128,9954,1,4641,2112,2368
8515679,8515669,TXFE7,128,9954,1,4642,2113,2369
8515742,8515740,TXFE7,128,9954,2,4644,2114,2370
8515754,8515749,TXFE7,128,9953,1,4645,2115,2371
8520067,8520060,TXFE7,128,9954,1,4646,2116,2372
8520229,8520228,TXFE7,128,9953,1,4647,2117,2373
8520292,8520290,TXFE7,128,9954,1,4648,2118,2374
8520329,8520321,TXFE7,128,9953,1,4649,2119,2375
8520367,8520362,TXFE7,128,9953,10,4659,2128,2376
8520367,8520362,TXFE7,128,9953,2,4661,2129,2377
8520367,8520362,TXFE7,128,9953,7,4668,2135,2378
8520367,8520362,TXFE7,128,9953,2,4670,2137,2379
8520367,8520362,TXFE7,128,9953,18,4688,2150,2380
8520367,8520362,TXFE7,128,9953,2,4690,2151,2381
8520367,8520362,TXFE7,128,9953,26,4716,2160,2382
8520367,8520363,TXFE7,128,9953,1,4717,2161,2383
8520367,8520365,TXFE7,128,9953,1,4718,2162,2384
8520379,8520367,TXFE7,128,9953,1,4719,2163,2385
8520379,8520367,TXFE7,128,9953,1,4720,2164,2386
8520379,8520368,TXFE7,128,9953,1,4721,2165,2387
8520379,8520369,TXFE7,128,9953,1,4722,2166,2388
8520379,8520370,TXFE7,128,9953,1,4723,2167,2389
8520379,8520371,TXFE7,128,9953,1,4724,2168,2390
8520379,8520374,TXFE7,128,9953,1,4725,2169,2391
8520442,8520429,TXFE7,128,9952,3,4728,2171,2392
8520454,8520442,TXFE7,128,9953,4,4732,2172,2395
8520454,8520452,TXFE7,128,9953,1,4733,2173,2396
8520467,8520454,TXFE7,128,9953,2,4735,2175,2397
8520479,8520473,TXFE7,128,9954,1,4736,2176,2398
8520504,8520495,TXFE7,128,9953,1,4737,2177,2399
8520504,8520496,TXFE7,128,9952,1,4738,2178,2400
8520504,8520497,TXFE7,128,9953,1,4739,2179,2401
8520504,8520500,TXFE7,128,9953,1,4740,2180,2402
8520629,8520626,TXFE7,129,9953,1,4742,2182,2403
8520629,8520626,TXFE7,129,9952,1,4742,2182,2403
8520729,8520727,TXFE7,128,9954,1,4743,2183,2404
8521292,8521286,TXFE7,128,9954,1,4744,2184,2405
8521692,8521684,TXFE7,128,9953,1,4745,2185,2406
8521729,8521729,TXFE7,128,9954,3,4748,2186,2409
8521742,8521733,TXFE7,128,9954,1,4749,2187,2410
8521879,8521870,TXFE7,128,9954,1,4750,2188,2411
8521979,8521977,TXFE7,128,9954,1,4751,2189,2412
8521992,8521987,TXFE7,128,9954,1,4752,2190,2413
8522017,8522005,TXFE7,128,9953,1,4753,2191,2414
8522067,8522054,TXFE7,128,9953,9,4762,2198,2415
8522079,8522067,TXFE7,128,9953,3,4765,2199,2417
8522079,8522067,TXFE7,128,9953,1,4766,2200,2418
8522079,8522067,TXFE7,128,9953,1,4767,2201,2419
8522129,8522129,TXFE7,128,9952,5,4772,2202,2420
8522179,8522174,TXFE7,128,9953,2,4774,2203,2421
8522254,8522251,TXFE7,128,9953,2,4776,2204,2423
8522467,8522465,TXFE7,128,9953,3,4779,2205,2424
8522604,8522593,TXFE7,128,9953,1,4780,2206,2425
8522667,8522659,TXFE7,128,9952,1,4781,2207,2426
8522967,8522954,TXFE7,128,9953,1,4782,2208,2427
8523054,8523050,TXFE7,128,9953,4,4786,2209,2431
8523217,8523208,TXFE7,128,9953,1,4787,2210,2432
8523329,8523328,TXFE7,128,9952,1,4788,2211,2433
8523367,8523357,TXFE7,128,9953,1,4789,2212,2434
8523429,8523425,TXFE7,128,9953,1,4790,2213,2435
8523467,8523464,TXFE7,128,9952,1,4791,2214,2436
8523629,8523625,TXFE7,128,9953,4,4795,2215,2439
8523692,8523681,TXFE7,128,9953,1,4796,2216,2440
8523704,8523700,TXFE7,128,9952,1,4797,2217,2441
8523729,8523721,TXFE7,128,9953,1,4798,2218,2442
8523729,8523729,TXFE7,128,9952,1,4799,2219,2443
8523742,8523730,TXFE7,128,9952,1,4800,2220,2444
8523917,8523915,TXFE7,128,9952,1,4801,2221,2445
8524292,8524285,TXFE7,128,9952,1,4802,2222,2446
8524592,8524587,TXFE7,128,9952,1,4803,2223,2447
8524617,8524611,TXFE7,128,9953,2,4805,2224,2448
8524979,8524973,TXFE7,128,9952,1,4806,2225,2449
8525092,8525083,TXFE7,128,9953,1,4807,2226,2450
8525192,8525186,TXFE7,128,9952,5,4812,2231,2451
8525379,8525370,TXFE7,128,9953,1,4813,2232,2452
8525392,8525381,TXFE7,128,9952,2,4815,2234,2453
8525542,8525529,TXFE7,128,9952,1,4816,2235,2454
8525792,8525789,TXFE7,128,9952,1,4817,2236,2455
8525904,8525892,TXFE7,128,9952,2,4819,2237,2456
8525904,8525892,TXFE7,128,9952,1,4820,2238,2457
8525904,8525892,TXFE7,128,9952,3,4823,2239,2458
8525904,8525892,TXFE7,128,9952,1,4824,2240,2459
8525904,8525892,TXFE7,128,9952,1,4825,2241,2460
8525904,8525892,TXFE7,128,9952,1,4826,2242,2461
8525904,8525892,TXFE7,128,9952,1,4827,2243,2462
8525904,8525892,TXFE7,128,9952,9,4836,2249,2463
8525904,8525892,TXFE7,128,9952,1,4837,2250,2464
8525904,8525892,TXFE7,128,9952,6,4843,2253,2465
8525904,8525892,TXFE7,128,9952,15,4858,2263,2466
8525904,8525892,TXFE7,128,9952,2,4860,2264,2467
8525904,8525900,TXFE7,128,9952,1,4861,2265,2468
8525904,8525900,TXFE7,128,9952,5,4866,2268,2469
8525917,8525904,TXFE7,128,9952,4,4870,2272,2470
8525917,8525904,TXFE7,128,9952,1,4871,2273,2471
8525917,8525904,TXFE7,128,9952,2,4873,2275,2472
8525917,8525904,TXFE7,128,9952,4,4877,2279,2473
8525917,8525904,TXFE7,128,9952,3,4880,2282,2474
8525954,8525942,TXFE7,128,9952,1,4881,2283,2475
8525967,8525954,TXFE7,128,9952,5,4886,2284,2478
8525967,8525955,TXFE7,128,9952,1,4887,2285,2479
8530104,8530102,TXFE7,128,9952,1,4888,2286,2480
8530179,8530167,TXFE7,128,9952,1,4889,2287,2481
8530179,8530173,TXFE7,128,9952,1,4890,2288,2482
8530517,8530512,TXFE7,128,9952,1,4891,2289,2483
8530542,8530536,TXFE7,128,9952,1,4892,2290,2484
8530667,8530654,TXFE7,128,9952,2,4894,2292,2485
8530692,8530683,TXFE7,128,9953,1,4895,2293,2486
8530692,8530691,TXFE7,128,9952,2,4897,2294,2487
8530704,8530699,TXFE7,128,9952,1,4898,2295,2488
8530754,8530748,TXFE7,128,9952,1,4899,2296,2489
8530767,8530766,TXFE7,128,9952,3,4902,2297,2491
8530817,8530810,TXFE7,128,9952,2,4904,2298,2493
8530854,8530853,TXFE7,128,9952,2,4906,2299,2495
8530867,8530854,TXFE7,128,9952,1,4907,2300,2496
8530967,8530955,TXFE7,128,9952,1,4908,2301,2497
8531079,8531075,TXFE7,128,9951,1,4909,2302,2498
8531092,8531087,TXFE7,128,9952,2,4911,2303,2500
8531204,8531192,TXFE7,128,9952,1,4912,2304,2501
8531204,8531204,TXFE7,128,9952,10,4922,2305,2506
8531217,8531204,TXFE7,128,9952,1,4923,2306,2507
8531217,8531204,TXFE7,128,9952,1,4924,2307,2508
8531342,8531329,TXFE7,128,9952,1,4925,2308,2509
8531354,8531352,TXFE7,128,9951,1,4926,2309,2510
8531417,8531408,TXFE7,128,9952,1,4927,2310,2511
8531442,8531438,TXFE7,128,9952,1,4928,2311,2512
8531454,8531452,TXFE7,128,9952,2,4930,2312,2513
8531517,8531506,TXFE7,128,9951,1,4931,2313,2514
8531617,8531606,TXFE7,128,9952,1,4932,2314,2515
8531654,8531654,TXFE7,128,9951,1,4933,2315,2516
8531717,8531716,TXFE7,128,9952,3,4936,2316,2517
8532042,8532036,TXFE7,128,9952,1,4937,2317,2518
8532067,8532060,TXFE7,128,9952,1,4938,2318,2519
8532154,8532149,TXFE7,128,9952,1,4939,2319,2520
8532217,8532215,TXFE7,128,9952,13,4952,2320,2527
8532229,8532217,TXFE7,128,9952,2,4954,2321,2529
8532229,8532221,TXFE7,128,9952,1,4955,2322,2530
8532279,8532270,TXFE7,128,9952,1,4956,2323,2531
8532317,8532309,TXFE7,128,9952,1,4957,2324,2532
8532392,8532381,TXFE7,128,9952,1,4958,2325,2533
8532442,8532439,TXFE7,128,9952,5,4963,2328,2534
8532454,8532449,TXFE7,128,9952,1,4964,2329,2535
8532629,8532629,TXFE7,128,9952,1,4965,2330,2536
8532729,8532719,TXFE7,128,9952,11,4976,2337,2537
8532954,8532944,TXFE7,128,9953,3,4979,2338,2540
8533354,8533352,TXFE7,128,9952,1,4980,2339,2541
8533517,8533508,TXFE7,128,9952,5,4985,2343,2542
8533654,8533643,TXFE7,128,9952,4,4989,2347,2543
8533979,8533971,TXFE7,128,9952,1,4990,2348,2544
8533992,8533992,TXFE7,128,9952,3,4993,2350,2545
8534079,8534075,TXFE7,128,9953,1,4994,2351,2546
8534092,8534084,TXFE7,128,9952,1,4995,2352,2547
8534092,8534085,TXFE7,128,9952,2,4997,2354,2548
8534179,8534173,TXFE7,128,9952,2,4999,2356,2549
8534204,8534193,TXFE7,128,9952,2,5001,2358,2550
8534329,8534328,TXFE7,128,9952,1,5002,2359,2551
8534517,8534510,TXFE7,128,9952,1,5003,2360,2552
8534542,8534537,TXFE7,128,9953,2,5005,2361,2554
8534554,8534548,TXFE7,128,9952,1,5006,2362,2555
8534617,8534606,TXFE7,128,9953,1,5007,2363,2556
8534654,8534644,TXFE7,128,9952,1,5008,2364,2557
8534917,8534915,TXFE7,128,9952,1,5009,2365,2558
8534979,8534973,TXFE7,128,9952,1,5010,2366,2559
8535142,8535133,TXFE7,128,9952,1,5011,2367,2560
8535142,8535134,TXFE7,128,9952,1,5012,2368,2561
8535367,8535357,TXFE7,128,9952,1,5013,2369,2562
8535392,8535389,TXFE7,128,9952,5,5018,2371,2563
8535517,8535507,TXFE7,129,9952,6,5038,2376,2564
8535517,8535507,TXFE7,129,9951,14,5038,2376,2564
8535967,8535964,TXFE7,128,9951,1,5039,2377,2565
8540017,8540007,TXFE7,128,9952,3,5042,2378,2568
8540229,8540222,TXFE7,128,9951,1,5043,2379,2569
8540317,8540314,TXFE7,128,9952,1,5044,2380,2570
8540342,8540341,TXFE7,128,9952,1,5045,2381,2571
8540467,8540460,TXFE7,128,9952,1,5046,2382,2572
8540754,8540751,TXFE7,128,9952,1,5047,2383,2573
8540804,8540796,TXFE7,128,9951,1,5048,2384,2574
8540854,8540848,TXFE7,128,9951,2,5050,2386,2575
8540904,8540902,TXFE7,128,9952,10,5060,2387,2584
8541067,8541066,TXFE7,128,9952,1,5061,2388,2585
8541142,8541139,TXFE7,128,9951,1,5062,2389,2586
8541317,8541311,TXFE7,128,9951,1,5063,2390,2587
8541342,8541329,TXFE7,128,9952,2,5065,2391,2589
8541417,8541408,TXFE7,128,9952,1,5066,2392,2590
8541417,8541414,TXFE7,128,9952,1,5067,2393,2591
8541604,8541593,TXFE7,128,9952,1,5068,2394,2592
8541967,8541957,TXFE7,128,9952,5,5073,2397,2593
8541967,8541966,TXFE7,128,9952,1,5074,2398,2594
8541992,8541989,TXFE7,128,9952,5,5079,2399,2595
8542042,8542032,TXFE7,128,9951,3,5082,2402,2596
8542142,8542134,TXFE7,128,9952,1,5083,2403,2597
8542429,8542423,TXFE7,128,9952,2,5085,2404,2598
8542717,8542707,TXFE7,128,9952,1,5086,2405,2599
8542867,8542856,TXFE7,128,9952,1,5087,2406,2600
8542879,8542870,TXFE7,128,9952,1,5088,2407,2601
8543017,8543008,TXFE7,128,9952,2,5090,2408,2603
8543029,8543021,TXFE7,128,9952,2,5092,2409,2605
8543042,8543033,TXFE7,128,9952,1,5093,2410,2606
8543204,8543195,TXFE7,128,9952,1,5094,2411,2607
8543217,8543217,TXFE7,128,9952,1,5095,2412,2608
8543242,8543234,TXFE7,128,9952,1,5096,2413,2609
8543304,8543298,TXFE7,128,9952,1,5097,2414,2610
8543317,8543308,TXFE7,128,9952,1,5098,2415,2611
8543567,8543561,TXFE7,128,9952,1,5099,2416,2612
8543604,8543602,TXFE7,128,9952,5,5104,2417,2613
8543642,8543629,TXFE7,128,9952,1,5105,2418,2614
8543829,8543829,TXFE7,128,9952,1,5106,2419,2615
8543929,8543925,TXFE7,128,9952,2,5108,2421,2616
8543942,8543930,TXFE7,128,9952,2,5110,2423,2617
8544054,8544045,TXFE7,128,9952,1,5111,2424,2618
8544467,8544456,TXFE7,128,9952,1,5112,2425,2619
8544529,8544521,TXFE7,128,9953,16,5128,2426,2630
8544567,8544560,TXFE7,128,9952,31,5159,2445,2631
8544792,8544790,TXFE7,128,9953,15,5174,2446,2644
8545092,8545083,TXFE7,128,9953,2,5176,2447,2646
8545417,8545410,TXFE7,128,9953,1,5177,2448,2647
8545579,8545579,TXFE7,128,9953,20,5197,2449,2657
8545592,8545592,TXFE7,128,9953,1,5198,2450,2658
8545604,8545592,TXFE7,128,9953,1,5199,2451,2659
8545667,8545663,TXFE7,128,9953,1,5200,2452,2660
8545767,8545755,TXFE7,128,9952,5,5205,2455,2661
8545854,8545842,TXFE7,128,9953,1,5206,2456,2662
8545879,8545867,TXFE7,128,9953,2,5208,2457,2664
8550167,8550157,TXFE7,128,9953,1,5209,2458,2665
8550204,8550202,TXFE7,128,9953,1,5210,2459,2666
8550254,8550245,TXFE7,128,9953,1,5211,2460,2667
8550279,8550268,TXFE7,128,9953,2,5213,2461,2669
8550279,8550272,TXFE7,128,9953,4,5217,2462,2671
8550304,8550292,TXFE7,128,9952,2,5219,2463,2672
8550304,8550295,TXFE7,128,9952,3,5222,2465,2673
8550329,8550324,TXFE7,128,9953,1,5223,2466,2674
8550329,8550327,TXFE7,128,9953,1,5224,2467,2675
8550379,8550375,TXFE7,128,9953,3,5227,2468,2677
8550404,8550393,TXFE7,128,9953,1,5228,2469,2678
8550404,8550399,TXFE7,128,9953,3,5231,2470,2681
8550404,8550404,TXFE7,128,9953,1,5232,2471,2682
8550417,8550404,TXFE7,128,9953,2,5234,2472,2683
8550417,8550414,TXFE7,128,9953,3,5237,2473,2684
8550442,8550431,TXFE7,128,9953,2,5239,2474,2686
8550479,8550474,TXFE7,128,9954,1,5240,2475,2687
8550479,8550474,TXFE7,128,9954,2,5242,2476,2688
8550479,8550474,TXFE7,128,9954,1,5243,2477,2689
8550479,8550475,TXFE7,128,9953,1,5244,2478,2690
8550479,8550478,TXFE7,128,9954,3,5247,2479,2692
8550504,8550495,TXFE7,128,9954,1,5248,2480,2693
8550554,8550547,TXFE7,128,9953,1,5249,2481,2694
8550654,8550653,TXFE7,128,9954,1,5250,2482,2695
8550692,8550692,TXFE7,128,9953,1,5251,2483,2696
8550929,8550921,TXFE7,128,9953,1,5252,2484,2697
8550942,8550932,TXFE7,128,9953,1,5253,2485,2698
8551229,8551227,TXFE7,128,9953,1,5254,2486,2699
8551242,8551235,TXFE7,128,9953,5,5259,2490,2700
8551404,8551399,TXFE7,128,9953,1,5260,2491,2701
8551467,8551462,TXFE7,128,9953,1,5261,2492,2702
8551517,8551507,TXFE7,128,9953,1,5262,2493,2703
8551517,8551511,TXFE7,128,9953,1,5263,2494,2704
8551717,8551707,TXFE7,128,9953,1,5264,2495,2705
8551754,8551746,TXFE7,128,9954,1,5265,2496,2706
8551892,8551886,TXFE7,128,9953,6,5271,2500,2707
8551892,8551891,TXFE7,128,9954,1,5272,2501,2708
8551917,8551916,TXFE7,128,9953,1,5273,2502,2709
8551942,8551932,TXFE7,128,9954,5,5278,2503,2714
8551967,8551959,TXFE7,128,9954,1,5279,2504,2715
8551992,8551989,TXFE7,128,9953,3,5282,2506,2716
8551992,8551989,TXFE7,128,9954,3,5285,2507,2717
8552054,8552050,TXFE7,128,9954,1,5286,2508,2718
8552204,8552200,TXFE7,128,9954,1,5287,2509,2719
8552317,8552305,TXFE7,128,9954,1,5288,2510,2720
8552767,8552766,TXFE7,128,9954,3,5291,2511,2723
8552779,8552773,TXFE7,128,9953,1,5292,2512,2724
8552804,8552797,TXFE7,128,9954,12,5304,2513,2731
8552954,8552947,TXFE7,128,9953,3,5307,2516,2732
8552979,8552974,TXFE7,128,9954,3,5310,2517,2735
8553017,8553012,TXFE7,128,9953,1,5311,2518,2736
8553029,8553022,TXFE7,128,9954,1,5312,2519,2737
8553042,8553030,TXFE7,128,9953,1,5313,2520,2738
8553104,8553103,TXFE7,128,9954,1,5314,2521,2739
8553167,8553155,TXFE7,128,9954,8,5322,2522,2743
8553229,8553220,TXFE7,128,9953,1,5323,2523,2744
8553292,8553286,TXFE7,128,9954,2,5325,2524,2746
8553392,8553382,TXFE7,128,9954,1,5326,2525,2747
8553579,8553567,TXFE7,128,9954,1,5327,2526,2748
8553604,8553596,TXFE7,128,9954,2,5329,2527,2749
8553667,8553657,TXFE7,128,9954,1,5330,2528,2750
8553679,8553676,TXFE7,128,9954,1,5331,2529,2751
8553829,8553823,TXFE7,128,9953,1,5332,2530,2752
8553879,8553869,TXFE7,128,9954,1,5333,2531,2753
8554054,8554042,TXFE7,128,9954,1,5334,2532,2754
8554142,8554135,TXFE7,128,9954,3,5337,2533,2757
8554217,8554208,TXFE7,128,9954,1,5338,2534,2758
8554279,8554278,TXFE7,128,9954,1,5339,2535,2759
8554342,8554338,TXFE7,128,9953,3,5342,2538,2760
8554392,8554382,TXFE7,128,9954,1,5343,2539,2761
8554492,8554487,TXFE7,128,9954,1,5344,2540,2762
8554517,8554512,TXFE7,128,9954,1,5345,2541,2763
8554542,8554541,TXFE7,128,9954,1,5346,2542,2764
8554742,8554734,TXFE7,128,9953,3,5349,2544,2765
8554829,8554824,TXFE7,128,9954,1,5350,2545,2766
8554967,8554955,TXFE7,128,9954,1,5351,2546,2767
8555104,8555095,TXFE7,128,9954,1,5352,2547,2768
8555142,8555131,TXFE7,128,9954,1,5353,2548,2769
8555267,8555260,TXFE7,128,9954,1,5354,2549,2770
8555342,8555330,TXFE7,128,9954,3,5357,2550,2773
8555342,8555336,TXFE7,128,9954,1,5358,2551,2774
8555392,8555385,TXFE7,128,9954,1,5359,2552,2775
8555404,8555403,TXFE7,128,9954,9,5368,2553,2781
8555454,8555452,TXFE7,128,9954,6,5374,2554,2783
8555517,8555516,TXFE7,128,9954,1,5375,2555,2784
8555529,8555520,TXFE7,128,9954,1,5376,2556,2785
8555654,8555647,TXFE7,128,9954,1,5377,2557,2786
8555767,8555756,TXFE7,128,9955,1,5378,2558,2787
8555792,8555785,TXFE7,128,9954,3,5381,2560,2788
8555804,8555797,TXFE7,128,9954,1,5382,2561,2789
8555829,8555823,TXFE7,128,9955,2,5384,2562,2790
8555842,8555841,TXFE7,128,9954,1,5385,2563,2791
8555942,8555936,TXFE7,128,9955,1,5386,2564,2792
8555979,8555979,TXFE7,128,9954,1,5387,2565,2793
8560029,8560021,TXFE7,128,9955,1,5388,2566,2794
8560042,8560037,TXFE7,128,9954,1,5389,2567,2795
8560054,8560053,TXFE7,128,9955,1,5390,2568,2796
8560092,8560090,TXFE7,128,9955,1,5391,2569,2797
8560167,8560161,TXFE7,128,9954,1,5392,2570,2798
8560254,8560252,TXFE7,128,9954,2,5394,2572,2799
8560254,8560253,TXFE7,128,9954,4,5398,2575,2800
8560279,8560267,TXFE7,128,9954,4,5402,2578,2801
8560392,8560388,TXFE7,128,9955,1,5403,2579,2802
8560517,8560508,TXFE7,128,9955,2,5405,2580,2804
8560604,8560597,TXFE7,128,9955,5,5410,2581,2808
8560604,8560604,TXFE7,128,9955,6,5416,2582,2814
8560654,8560645,TXFE7,128,9954,1,5417,2583,2815
8560754,8560746,TXFE7,128,9955,1,5418,2584,2816
8560967,8560961,TXFE7,128,9955,1,5419,2585,2817
8561067,8561060,TXFE7,128,9954,2,5421,2586,2818
8561179,8561172,TXFE7,128,9955,1,5422,2587,2819
8561217,8561215,TXFE7,128,9954,3,5425,2588,2820
8561417,8561409,TXFE7,128,9954,1,5426,2589,2821
8561454,8561449,TXFE7,128,9954,1,5427,2590,2822
8561504,8561497,TXFE7,128,9955,1,5428,2591,2823
8561617,8561607,TXFE7,128,9954,1,5429,2592,2824
8561817,8561809,TXFE7,128,9955,5,5434,2593,2825
8561829,8561829,TXFE7,128,9954,1,5435,2594,2826
8561854,8561846,TXFE7,128,9955,1,5436,2595,2827
8561854,8561851,TXFE7,128,9955,5,5441,2596,2828
8562004,8561998,TXFE7,128,9954,1,5442,2597,2829
8562042,8562029,TXFE7,128,9954,3,5445,2600,2830
8562117,8562114,TXFE7,128,9955,1,5446,2601,2831
8562667,8562662,TXFE7,128,9955,1,5447,2602,2832
8562692,8562688,TXFE7,128,9955,3,5450,2603,2835
8562729,8562723,TXFE7,128,9954,3,5453,2606,2836
8562742,8562732,TXFE7,128,9955,5,5458,2607,2840
8562754,8562747,TXFE7,128,9954,1,5459,2608,2841
8563179,8563178,TXFE7,128,9955,1,5460,2609,2842
8563304,8563303,TXFE7,128,9955,1,5461,2610,2843
8563542,8563534,TXFE7,128,9955,1,5462,2611,2844
8563904,8563894,TXFE7,128,9955,1,5463,2612,2845
8564442,8564441,TXFE7,128,9954,1,5464,2613,2846
8565067,8565063,TXFE7,128,9955,2,5469,2616,2849
8565129,8565117,TXFE7,128,9955,1,5470,2617,2850
8565217,8565204,TXFE7,128,9955,4,5474,2618,2854
8565229,8565219,TXFE7,128,9955,1,5475,2619,2855
8565392,8565380,TXFE7,128,9955,1,5476,2620,2856
8570054,8570048,TXFE7,128,9955,1,5482,2624,2862
8570104,8570099,TXFE7,128,9954,4,5486,2628,2863
8570117,8570110,TXFE7,128,9954,2,5488,2630,2864
8570454,8570448,TXFE7,128,9955,2,5499,2637,2874
8570454,8570452,TXFE7,128,9954,1,5500,2638,2875
8570467,8570461,TXFE7,128,9954,1,5501,2639,2876
8570517,8570512,TXFE7,128,9954,1,5502,2640,2877
8570704,8570704,TXFE7,128,9954,1,5503,2641,2878
8571004,8571004,TXFE7,128,9954,2,5505,2642,2879
8571029,8571023,TXFE7,128,9954,10,5515,2648,2880
8571042,8571035,TXFE7,128,9955,1,5516,2649,2881
8571117,8571109,TXFE7,128,9954,1,5517,2650,2882
8571117,8571112,TXFE7,128,9954,14,5531,2662,2883
8571129,8571117,TXFE7,128,9954,6,5537,2666,2884
8571142,8571129,TXFE7,128,9954,6,5543,2671,2885
8571142,8571129,TXFE7,128,9954,2,5545,2673,2886
8571179,8571168,TXFE7,128,9954,19,5564,2674,2895
8571179,8571172,TXFE7,129,9954,5,5570,2675,2900
8571179,8571172,TXFE7,129,9955,1,5570,2675,2900
8571192,8571179,TXFE7,128,9954,8,5578,2676,2904
8571192,8571179,TXFE7,128,9954,1,5579,2677,2905
8571467,8571466,TXFE7,128,9954,6,5585,2678,2910
8571617,8571615,TXFE7,128,9954,1,5586,2679,2911
8571679,8571679,TXFE7,128,9954,1,5587,2680,2912
8571779,8571777,TXFE7,128,9954,1,5588,2681,2913
8571942,8571941,TXFE7,128,9954,3,5591,2682,2915
8571979,8571972,TXFE7,128,9953,1,5592,2683,2916
8572004,8572003,TXFE7,128,9953,6,5598,2685,2917
8572029,8572024,TXFE7,128,9954,2,5600,2686,2919
8572042,8572031,TXFE7,128,9953,1,5601,2687,2920
8572117,8572114,TXFE7,128,9954,20,5621,2688,2924
8572217,8572212,TXFE7,128,9954,1,5622,2689,2925
8572517,8572507,TXFE7,128,9954,2,5624,2690,2926
8572579,8572569,TXFE7,128,9954,1,5625,2691,2927
8572667,8572665,TXFE7,128,9954,1,5626,2692,2928
8572817,8572816,TXFE7,128,9953,1,5627,2693,2929
8572879,8572873,TXFE7,128,9953,4,5631,2695,2930
8572917,8572911,TXFE7,128,9954,1,5632,2696,2931
8572917,8572915,TXFE7,128,9954,5,5637,2697,2935
8572967,8572955,TXFE7,128,9954,2,5639,2698,2936
8573054,8573047,TXFE7,128,9954,5,5644,2699,2939
8573067,8573057,TXFE7,128,9953,1,5645,2700,2940
8573429,8573422,TXFE7,128,9953,2,5648,2703,2942
8573542,8573540,TXFE7,128,9954,1,5649,2704,2943
8573592,8573586,TXFE7,128,9954,1,5650,2705,2944
8573629,8573618,TXFE7,128,9954,1,5651,2706,2945
8573667,8573658,TXFE7,128,9954,2,5653,2707,2946
8573717,8573711,TXFE7,128,9954,1,5654,2708,2947
8573729,8573722,TXFE7,128,9954,1,5655,2709,2948
8573854,8573847,TXFE7,128,9954,1,5656,2710,2949
8573879,8573873,TXFE7,128,9954,1,5657,2711,2950
8574017,8574014,TXFE7,128,9954,1,5658,2712,2951
8574079,8574068,TXFE7,128,9954,2,5660,2713,2952
8574154,8574148,TXFE7,128,9954,1,5661,2714,2953
8574229,8574219,TXFE7,128,9954,5,5666,2715,2954
8574242,8574238,TXFE7,128,9953,1,5667,2716,2955
8574254,8574248,TXFE7,128,9953,1,5668,2717,2956
8574292,8574286,TXFE7,128,9953,1,5669,2718,2957
8574354,8574347,TXFE7,128,9953,1,5670,2719,2958
8574417,8574414,TXFE7,128,9954,1,5671,2720,2959
8574492,8574484,TXFE7,128,9954,1,5672,2721,2960
8574592,8574581,TXFE7,128,9953,1,5673,2722,2961
8574604,8574596,TXFE7,128,9954,2,5675,2723,2963
8574604,8574597,TXFE7,128,9954,1,5676,2724,2964
8574604,8574598,TXFE7,128,9954,1,5677,2725,2965
8574729,8574721,TXFE7,128,9954,1,5678,2726,2966
8574754,8574746,TXFE7,128,9954,1,5679,2727,2967
8574854,8574844,TXFE7,128,9954,1,5680,2728,2968
8574892,8574881,TXFE7,128,9954,1,5681,2729,2969
8575079,8575074,TXFE7,128,9953,1,5682,2730,2970
8575204,8575196,TXFE7,128,9954,1,5683,2731,2971
8575229,8575225,TXFE7,128,9954,1,5684,2732,2972
8575279,8575276,TXFE7,128,9954,3,5687,2733,2974
8575354,8575342,TXFE7,128,9954,1,5688,2734,2975
8575379,8575368,TXFE7,128,9953,10,5698,2739,2976
8575404,8575401,TXFE7,128,9954,1,5699,2740,2977
8575429,8575417,TXFE7,128,9954,1,5700,2741,2978
8575429,8575418,TXFE7,128,9954,8,5708,2742,2984
8575479,8575473,TXFE7,128,9954,6,5714,2743,2989
8575579,8575570,TXFE7,128,9954,1,5715,2744,2990
8575629,8575618,TXFE7,128,9955,1,5716,2745,2991
8580017,8580007,TXFE7,128,9955,1,5717,2746,2992
8580029,8580018,TXFE7,128,9955,1,5718,2747,2993
8580029,8580020,TXFE7,128,9955,2,5720,2748,2994
8580029,8580022,TXFE7,128,9955,1,5721,2749,2995
8580142,8580141,TXFE7,128,9954,1,5722,2750,2996
8580154,8580150,TXFE7,128,9955,10,5732,2751,3004
8580179,8580169,TXFE7,128,9954,2,5734,2752,3005
8580329,8580317,TXFE7,128,9954,1,5735,2753,3006
8580342,8580334,TXFE7,128,9955,6,5741,2754,3009
8580404,8580396,TXFE7,128,9955,1,5742,2755,3010
8580504,8580498,TXFE7,128,9954,3,5745,2757,3011
8580592,8580580,TXFE7,128,9955,1,5746,2758,3012
8581379,8581377,TXFE7,128,9955,1,5747,2759,3013
8581467,8581465,TXFE7,128,9954,1,5748,2760,3014
8581854,8581851,TXFE7,128,9955,1,5749,2761,3015
8581967,8581967,TXFE7,128,9955,1,5750,2762,3016
8581992,8581985,TXFE7,128,9955,1,5751,2763,3017
8582154,8582154,TXFE7,128,9954,1,5752,2764,3018
8582242,8582234,TXFE7,128,9955,3,5755,2765,3020
8582354,8582343,TXFE7,128,9955,1,5756,2766,3021
8582354,8582348,TXFE7,128,9954,1,5757,2767,3022
8582517,8582512,TXFE7,128,9955,5,5762,2768,3025
8582529,8582520,TXFE7,128,9955,6,5768,2769,3029
8582554,8582542,TXFE7,128,9955,4,5772,2770,3033
8582554,8582542,TXFE7,128,9955,56,5828,2771,3061
8582554,8582542,TXFE7,128,9955,1,5829,2772,3062
8582567,8582562,TXFE7,128,9956,8,5837,2773,3066
8582579,8582567,TXFE7,128,9956,14,5851,2774,3072
8582579,8582567,TXFE7,128,9955,23,5874,2780,3073
8582579,8582570,TXFE7,128,9956,10,5884,2781,3074
8582579,8582571,TXFE7,128,9956,1,5885,2782,3075
8582579,8582573,TXFE7,128,9956,1,5886,2783,3076
8582579,8582574,TXFE7,128,9956,1,5887,2784,3077
8582579,8582578,TXFE7,128,9956,1,5888,2785,3078
8582592,8582580,TXFE7,128,9956,1,5889,2786,3079
8582592,8582589,TXFE7,128,9955,3,5892,2789,3080
8582604,8582597,TXFE7,128,9955,1,5893,2790,3081
8582604,8582598,TXFE7,128,9956,4,5897,2791,3082
8582617,8582608,TXFE7,128,9956,1,5898,2792,3083
8582617,8582610,TXFE7,128,9956,1,5899,2793,3084
8582617,8582614,TXFE7,128,9956,1,5900,2794,3085
8582629,8582617,TXFE7,128,9956,2,5902,2795,3086
8582629,8582623,TXFE7,128,9956,1,5903,2796,3087
8582767,8582754,TXFE7,128,9955,1,5904,2797,3088
8582767,8582760,TXFE7,128,9956,10,5914,2798,3089
8582767,8582762,TXFE7,128,9956,10,5924,2799,3090
8582767,8582765,TXFE7,128,9956,10,5934,2800,3091
8582817,8582812,TXFE7,128,9956,1,5935,2801,3092
8582829,8582821,TXFE7,128,9956,1,5936,2802,3093
8582854,8582851,TXFE7,128,9956,1,5937,2803,3094
8582867,8582858,TXFE7,128,9956,1,5938,2804,3095
8583004,8582994,TXFE7,128,9955,1,5939,2805,3096
8583067,8583058,TXFE7,128,9956,1,5940,2806,3097
8583079,8583068,TXFE7,128,9956,1,5941,2807,3098
8583142,8583133,TXFE7,128,9956,4,5945,2808,3099
8583154,8583144,TXFE7,128,9956,1,5946,2809,3100
8583217,8583205,TXFE7,128,9956,7,5953,2810,3101
8583267,8583267,TXFE7,128,9956,1,5954,2811,3102
8583304,8583300,TXFE7,128,9956,5,5959,2812,3103
8583304,8583304,TXFE7,128,9956,1,5960,2813,3104
8583317,8583304,TXFE7,128,9956,4,5964,2814,3105
8583329,8583317,TXFE7,128,9956,2,5966,2815,3106
8583329,8583325,TXFE7,128,9956,2,5968,2816,3107
8583342,8583341,TXFE7,128,9956,10,5978,2817,3112
8583342,8583341,TXFE7,128,9956,2,5980,2818,3114
8583342,8583341,TXFE7,128,9956,6,5986,2819,3116
8583354,8583342,TXFE7,128,9956,2,5988,2820,3117
8583354,8583342,TXFE7,128,9956,1,5989,2821,3118
8583354,8583342,TXFE7,128,9956,3,5992,2822,3121
8583354,8583342,TXFE7,128,9956,7,5999,2823,3126
8583354,8583342,TXFE7,128,9956,4,6003,2824,3127
8583354,8583342,TXFE7,128,9956,6,6009,2825,3132
8583354,8583342,TXFE7,128,9956,3,6012,2826,3135
8583354,8583342,TXFE7,128,9956,1,6013,2827,3136
8583467,8583459,TXFE7,128,9956,1,6014,2828,3137
8583467,8583466,TXFE7,128,9956,1,6015,2829,3138
8583479,8583473,TXFE7,128,9957,1,6016,2830,3139
8583492,8583480,TXFE7,128,9957,19,6035,2831,3153
8583492,8583480,TXFE7,128,9957,2,6037,2832,3155
8583492,8583482,TXFE7,128,9957,10,6047,2833,3163
8583492,8583483,TXFE7,128,9957,1,6048,2834,3164
8583492,8583484,TXFE7,128,9957,1,6049,2835,3165
8583492,8583490,TXFE7,128,9957,1,6050,2836,3166
8583504,8583492,TXFE7,128,9957,1,6051,2837,3167
8583592,8583586,TXFE7,128,9957,1,6052,2838,3168
8583729,8583726,TXFE7,128,9957,1,6053,2839,3169
8583742,8583733,TXFE7,128,9957,12,6065,2840,3176
8583779,8583779,TXFE7,128,9957,5,6070,2841,3177
8583804,8583796,TXFE7,128,9957,1,6071,2842,3178
8583804,8583799,TXFE7,128,9957,1,6072,2843,3179
8583817,8583808,TXFE7,128,9956,1,6073,2844,3180
8583817,8583816,TXFE7,128,9957,1,6074,2845,3181
8583854,8583843,TXFE7,128,9957,5,6079,2846,3185
8583854,8583843,TXFE7,128,9957,1,6080,2847,3186
8583854,8583846,TXFE7,128,9957,1,6081,2848,3187
8583854,8583851,TXFE7,128,9957,10,6091,2849,3194
8583867,8583855,TXFE7,128,9957,7,6098,2850,3197
8583867,8583863,TXFE7,128,9957,1,6099,2851,3198
8583879,8583867,TXFE7,128,9957,2,6101,2852,3199
8583892,8583880,TXFE7,128,9958,1,6102,2853,3200
8583892,8583888,TXFE7,128,9958,5,6107,2854,3202
8583904,8583895,TXFE7,128,9958,10,6117,2855,3203
8583904,8583902,TXFE7,128,9958,10,6127,2856,3204
8583917,8583910,TXFE7,128,9957,1,6128,2857,3205
8583917,8583915,TXFE7,128,9957,1,6129,2858,3206
8583942,8583933,TXFE7,128,9958,1,6130,2859,3207
8583954,8583949,TXFE7,128,9958,1,6131,2860,3208
8583954,8583952,TXFE7,128,9958,2,6133,2861,3209
8583967,8583956,TXFE7,128,9958,1,6134,2862,3210
8583967,8583964,TXFE7,128,9958,2,6136,2863,3212
8584017,8584015,TXFE7,128,9957,1,6137,2864,3213
8584029,8584017,TXFE7,128,9958,5,6142,2865,3216
8584042,8584036,TXFE7,128,9958,1,6143,2866,3217
8584067,8584063,TXFE7,128,9957,1,6144,2867,3218
8584079,8584073,TXFE7,128,9958,1,6145,2868,3219
8584117,8584117,TXFE7,128,9957,1,6146,2869,3220
8584204,8584201,TXFE7,128,9958,1,6147,2870,3221
8584229,8584220,TXFE7,128,9957,1,6148,2871,3222
8584229,8584221,TXFE7,128,9957,6,6154,2875,3223
8584229,8584224,TXFE7,128,9958,4,6158,2876,3227
8584242,8584240,TXFE7,128,9957,1,6159,2877,3228
8584242,8584241,TXFE7,128,9957,20,6179,2885,3229
8584254,8584242,TXFE7,128,9957,4,6183,2888,3230
8584254,8584242,TXFE7,128,9957,6,6189,2890,3231
8584254,8584247,TXFE7,128,9957,2,6191,2891,3232
8584267,8584254,TXFE7,128,9957,4,6195,2893,3233
8584267,8584254,TXFE7,128,9957,4,6199,2896,3234
8584267,8584265,TXFE7,128,9957,2,6201,2897,3235
8584292,8584283,TXFE7,128,9957,1,6202,2898,3236
8584304,8584296,TXFE7,128,9957,1,6203,2899,3237
8584342,8584337,TXFE7,128,9957,1,6204,2900,3238
8584342,8584340,TXFE7,128,9957,1,6205,2901,3239
8584354,8584354,TXFE7,128,9956,1,6206,2902,3240
8584404,8584396,TXFE7,128,9957,1,6207,2903,3241
8584467,8584464,TXFE7,128,9957,1,6208,2904,3242
8584604,8584599,TXFE7,128,9957,1,6209,2905,3243
8584729,8584719,TXFE7,128,9957,17,6226,2906,3254
8584729,8584729,TXFE7,128,9958,1,6227,2907,3255
8584754,8584749,TXFE7,128,9957,1,6228,2908,3256
8584754,8584751,TXFE7,128,9957,1,6229,2909,3257
8584779,8584769,TXFE7,128,9957,1,6230,2910,3258
8584892,8584883,TXFE7,128,9958,1,6231,2911,3259
8584954,8584950,TXFE7,128,9958,2,6233,2912,3260
8584967,8584962,TXFE7,128,9958,1,6234,2913,3261
8585004,8584998,TXFE7,128,9957,1,6235,2914,3262
8585042,8585035,TXFE7,128,9958,2,6237,2915,3263
8585054,8585046,TXFE7,128,9957,1,6238,2916,3264
8585154,8585154,TXFE7,128,9957,1,6239,2917,3265
8585179,8585176,TXFE7,128,9957,3,6242,2919,3266
8585204,8585198,TXFE7,128,9958,2,6244,2920,3267
8585242,8585232,TXFE7,128,9958,2,6246,2921,3268
8585279,8585271,TXFE7,128,9957,3,6249,2924,3269
8585292,8585284,TXFE7,128,9958,1,6250,2925,3270
8585342,8585339,TXFE7,128,9958,10,6260,2926,3273
8585354,8585347,TXFE7,128,9957,1,6261,2927,3274
8585417,8585412,TXFE7,128,9958,1,6262,2928,3275
8585479,8585475,TXFE7,128,9958,1,6263,2929,3276
8585479,8585477,TXFE7,128,9958,23,6286,2930,3282
8585492,8585484,TXFE7,128,9957,1,6287,2931,3283
8585542,8585537,TXFE7,128,9958,1,6288,2932,3284
8585567,8585559,TXFE7,128,9958,2,6290,2933,3286
8585567,8585564,TXFE7,128,9958,1,6291,2934,3287
8585617,8585609,TXFE7,128,9958,1,6292,2935,3288
8585717,8585709,TXFE7,128,9958,1,6293,2936,3289
8585792,8585782,TXFE7,128,9958,1,6294,2937,3290
8585792,8585783,TXFE7,128,9958,2,6296,2938,3292
8585829,8585829,TXFE7,128,9958,1,6297,2939,3293
8585842,8585841,TXFE7,128,9958,1,6298,2940,3294
8585867,8585864,TXFE7,128,9958,2,6300,2941,3295
8585929,8585926,TXFE7,128,9958,1,6301,2942,3296
8585942,8585937,TXFE7,128,9958,1,6302,2943,3297
8585942,8585939,TXFE7,128,9958,1,6303,2944,3298
8585967,8585956,TXFE7,128,9958,1,6304,2945,3299
8585967,8585961,TXFE7,128,9958,1,6305,2946,3300
8585992,8585986,TXFE7,128,9958,15,6320,2947,3314
8590004,8590003,TXFE7,128,9958,2,6322,2948,3315
8590017,8590015,TXFE7,128,9958,1,6323,2949,3316
8590054,8590049,TXFE7,128,9958,1,6324,2950,3317
8590079,8590076,TXFE7,128,9958,5,6329,2951,3321
8590079,8590079,TXFE7,128,9958,1,6330,2952,3322
8590104,8590094,TXFE7,128,9958,2,6332,2953,3323
8590142,8590130,TXFE7,128,9958,2,6334,2954,3324
8590142,8590133,TXFE7,128,9958,1,6335,2955,3325
8590142,8590139,TXFE7,128,9958,1,6336,2956,3326
8590154,8590145,TXFE7,128,9957,2,6338,2958,3327
8590167,8590162,TXFE7,128,9957,3,6341,2959,3328
8590179,8590168,TXFE7,128,9957,1,6342,2960,3329
8590179,8590174,TXFE7,128,9958,1,6343,2961,3330
8590179,8590177,TXFE7,128,9958,1,6344,2962,3331
8590192,8590191,TXFE7,128,9958,1,6345,2963,3332
8590204,8590199,TXFE7,128,9958,1,6346,2964,3333
8590204,8590199,TXFE7,129,9958,5,6355,2965,3341
8590204,8590199,TXFE7,129,9959,4,6355,2965,3341
8590204,8590202,TXFE7,128,9957,2,6357,2967,3342
8590204,8590204,TXFE7,128,9957,2,6359,2968,3343
8590217,8590209,TXFE7,128,9959,10,6369,2969,3350
8590217,8590209,TXFE7,128,9958,1,6370,2970,3351
8590217,8590211,TXFE7,128,9957,1,6371,2971,3352
8590229,8590217,TXFE7,128,9958,4,6375,2972,3353
8590229,8590224,TXFE7,128,9959,2,6377,2973,3354
8590292,8590281,TXFE7,128,9959,1,6378,2974,3355
8590304,8590301,TXFE7,128,9957,1,6379,2975,3356
8590317,8590304,TXFE7,128,9958,1,6380,2976,3357
8590329,8590321,TXFE7,128,9958,2,6382,2977,3358
8590367,8590362,TXFE7,128,9958,1,6383,2978,3359
8590404,8590400,TXFE7,128,9958,1,6384,2979,3360
8590404,8590404,TXFE7,128,9957,1,6385,2980,3361
8590442,8590438,TXFE7,128,9958,1,6386,2981,3362
8590454,8590447,TXFE7,128,9958,1,6387,2982,3363
8590467,8590464,TXFE7,128,9958,1,6388,2983,3364
8590479,8590471,TXFE7,128,9958,1,6389,2984,3365
8590517,8590507,TXFE7,128,9958,1,6390,2985,3366
8590554,8590550,TXFE7,128,9958,1,6391,2986,3367
8590592,8590588,TXFE7,128,9957,1,6392,2987,3368
8590617,8590607,TXFE7,128,9958,1,6393,2988,3369
8590642,8590637,TXFE7,128,9958,2,6395,2989,3370
8590667,8590663,TXFE7,128,9958,1,6396,2990,3371
8590679,8590668,TXFE7,128,9958,22,6418,2991,3381
8590679,8590675,TXFE7,128,9957,1,6419,2992,3382
8590692,8590679,TXFE7,128,9958,1,6420,2993,3383
8590704,8590699,TXFE7,128,9958,1,6421,2994,3384
8590729,8590719,TXFE7,128,9958,1,6422,2995,3385
8590754,8590750,TXFE7,128,9958,1,6423,2996,3386
8590779,8590769,TXFE7,128,9958,2,6425,2997,3387
8590842,8590840,TXFE7,128,9958,1,6426,2998,3388
8590854,8590846,TXFE7,128,9958,1,6427,2999,3389
8590854,8590849,TXFE7,128,9958,2,6429,3000,3390
8590867,8590856,TXFE7,128,9958,1,6430,3001,3391
8590879,8590870,TXFE7,128,9958,1,6431,3002,3392
8591004,8590999,TXFE7,128,9958,1,6432,3003,3393
8591017,8591009,TXFE7,128,9958,1,6433,3004,3394
8591029,8591021,TXFE7,128,9958,2,6435,3005,3396
8591042,8591036,TXFE7,128,9958,1,6436,3006,3397
8591054,8591042,TXFE7,128,9958,3,6439,3007,3398
8591054,8591043,TXFE7,128,9958,1,6440,3008,3399
8591092,8591080,TXFE7,128,9958,1,6441,3009,3400
8591092,8591081,TXFE7,128,9958,1,6442,3010,3401
8591204,8591197,TXFE7,128,9958,1,6443,3011,3402
8591204,8591199,TXFE7,128,9959,2,6445,3012,3404
8591279,8591271,TXFE7,128,9959,1,6446,3013,3405
8591354,8591354,TXFE7,128,9959,1,6447,3014,3406
8591392,8591390,TXFE7,128,9959,1,6448,3015,3407
8591504,8591492,TXFE7,128,9959,10,6458,3016,3408
8591517,8591516,TXFE7,128,9959,3,6461,3017,3410
8591542,8591541,TXFE7,128,9958,1,6462,3018,3411
8591554,8591548,TXFE7,128,9958,1,6463,3019,3412
8591592,8591589,TXFE7,128,9958,1,6464,3020,3413
8591754,8591748,TXFE7,128,9959,6,6470,3021,3419
8591754,8591749,TXFE7,128,9959,6,6476,3022,3425
8591767,8591758,TXFE7,128,9959,1,6477,3023,3426
8592167,8592162,TXFE7,128,9959,2,6479,3024,3428
8592192,8592190,TXFE7,128,9959,1,6480,3025,3429
8592217,8592213,TXFE7,128,9958,1,6481,3026,3430
8592279,8592271,TXFE7,128,9958,2,6483,3028,3431
8592292,8592281,TXFE7,128,9959,13,6496,3029,3435
8592304,8592304,TXFE7,128,9958,1,6497,3030,3436
8592454,8592443,TXFE7,128,9959,8,6505,3031,3440
8592454,8592453,TXFE7,128,9958,2,6507,3032,3441
8592479,8592472,TXFE7,128,9958,3,6510,3033,3442
8592567,8592566,TXFE7,128,9959,5,6515,3034,3447
8592692,8592685,TXFE7,128,9958,1,6516,3035,3448
8592692,8592689,TXFE7,128,9959,1,6517,3036,3449
8592742,8592729,TXFE7,128,9959,2,6519,3037,3450
8592854,8592851,TXFE7,128,9958,1,6520,3038,3451
8592904,8592895,TXFE7,128,9959,1,6521,3039,3452
8592929,8592929,TXFE7,128,9959,1,6522,3040,3453
8592954,8592943,TXFE7,128,9959,1,6523,3041,3454
8592979,8592967,TXFE7,128,9959,2,6525,3042,3456
8593029,8593019,TXFE7,128,9959,1,6526,3043,3457
8593029,8593024,TXFE7,128,9958,8,6534,3047,3458
8593042,8593030,TXFE7,128,9958,1,6535,3048,3459
8593129,8593121,TXFE7,128,9958,8,6543,3053,3460
8593142,8593138,TXFE7,128,9958,2,6545,3055,3461
8593154,8593150,TXFE7,128,9959,1,6546,3056,3462
8593204,8593199,TXFE7,128,9959,1,6547,3057,3463
8593204,8593203,TXFE7,128,9959,1,6548,3058,3464
8593267,8593265,TXFE7,128,9958,8,6556,3064,3465
8593292,8593287,TXFE7,128,9959,2,6558,3065,3466
8593367,8593361,TXFE7,128,9958,1,6559,3066,3467
8593417,8593406,TXFE7,128,9958,1,6560,3067,3468
8593454,8593453,TXFE7,128,9958,1,6561,3068,3469
8593517,8593504,TXFE7,128,9958,8,6569,3072,3470
8593542,8593529,TXFE7,128,9959,1,6570,3073,3471
8593542,8593534,TXFE7,128,9959,1,6571,3074,3472
8593567,8593566,TXFE7,128,9958,1,6572,3075,3473
8593617,8593617,TXFE7,128,9959,1,6573,3076,3474
8593629,8593619,TXFE7,128,9959,1,6574,3077,3475
8593642,8593631,TXFE7,128,9958,1,6575,3078,3476
8593667,8593659,TXFE7,128,9959,1,6576,3079,3477
8593667,8593660,TXFE7,128,9959,1,6577,3080,3478
8593704,8593697,TXFE7,128,9959,1,6578,3081,3479
8593717,8593711,TXFE7,128,9958,8,6586,3089,3480
8593729,8593726,TXFE7,128,9958,1,6587,3090,3481
8593754,8593743,TXFE7,128,9959,1,6588,3091,3482
8593779,8593769,TXFE7,128,9958,1,6589,3092,3483
8593804,8593796,TXFE7,128,9959,1,6590,3093,3484
8593842,8593830,TXFE7,128,9959,1,6591,3094,3485
8593879,8593878,TXFE7,128,9958,2,6593,3095,3486
8593904,8593903,TXFE7,128,9958,8,6601,3100,3487
8593929,8593929,TXFE7,128,9958,1,6602,3101,3488
8594029,8594028,TXFE7,128,9958,1,6603,3102,3489
8594104,8594101,TXFE7,128,9958,2,6605,3104,3490
8594117,8594104,TXFE7,128,9958,1,6606,3105,3491
8594117,8594106,TXFE7,128,9958,5,6611,3106,3492
8594142,8594131,TXFE7,128,9958,1,6612,3107,3493
8594167,8594162,TXFE7,128,9957,1,6613,3108,3494
8594217,8594207,TXFE7,128,9958,1,6614,3109,3495
8594217,8594214,TXFE7,128,9957,2,6616,3110,3496
8594292,8594281,TXFE7,128,9958,2,6618,3111,3497
8594304,8594296,TXFE7,128,9958,2,6620,3112,3498
8594304,8594302,TXFE7,128,9958,2,6622,3113,3500
8594354,8594348,TXFE7,128,9958,1,6623,3114,3501
8594367,8594361,TXFE7,128,9957,1,6624,3115,3502
8594392,8594385,TXFE7,128,9957,1,6625,3116,3503
8594417,8594412,TXFE7,128,9957,1,6626,3117,3504
8594479,8594479,TXFE7,128,9958,1,6627,3118,3505
8594492,8594487,TXFE7,128,9958,3,6630,3119,3508
8594642,8594641,TXFE7,128,9958,1,6631,3120,3509
8594692,8594690,TXFE7,128,9958,4,6635,3121,3510
8594717,8594706,TXFE7,128,9958,10,6645,3122,3514
8594729,8594728,TXFE7,128,9957,1,6646,3123,3515
8594742,8594739,TXFE7,128,9958,1,6647,3124,3516
8594754,8594751,TXFE7,128,9958,2,6649,3125,3517
8594767,8594762,TXFE7,128,9958,4,6653,3126,3520
8594829,8594823,TXFE7,128,9958,1,6654,3127,3521
8594842,8594842,TXFE7,128,9958,2,6656,3128,3522
8594867,8594858,TXFE7,128,9957,2,6658,3130,3523
8594867,8594860,TXFE7,128,9958,1,6659,3131,3524
8594879,8594877,TXFE7,128,9958,1,6660,3132,3525
8594942,8594934,TXFE7,128,9958,1,6661,3133,3526
8594967,8594962,TXFE7,128,9959,1,6662,3134,3527
8594967,8594966,TXFE7,128,9959,1,6663,3135,3528
8595004,8595003,TXFE7,128,9959,3,6666,3136,3530
8595054,8595045,TXFE7,128,9959,1,6667,3137,3531
8595079,8595074,TXFE7,128,9958,1,6668,3138,3532
8595092,8595090,TXFE7,128,9958,1,6669,3139,3533
8595142,8595138,TXFE7,128,9958,1,6670,3140,3534
8595217,8595211,TXFE7,128,9959,1,6671,3141,3535
8595229,8595223,TXFE7,128,9959,2,6673,3142,3536
8595254,8595243,TXFE7,128,9958,1,6674,3143,3537
8595304,8595295,TXFE7,128,9958,1,6675,3144,3538
8595367,8595364,TXFE7,128,9958,1,6676,3145,3539
8595379,8595373,TXFE7,128,9958,15,6691,3150,3540
8595392,8595385,TXFE7,128,9958,1,6692,3151,3541
8595442,8595432,TXFE7,128,9958,1,6693,3152,3542
8595454,8595443,TXFE7,128,9958,1,6694,3153,3543
8595504,8595503,TXFE7,128,9958,1,6695,3154,3544
8595517,8595515,TXFE7,128,9958,1,6696,3155,3545
8595667,8595657,TXFE7,128,9958,1,6697,3156,3546
8595717,8595710,TXFE7,128,9958,1,6698,3157,3547
8595792,8595791,TXFE7,128,9959,17,6715,3158,3557
8595804,8595796,TXFE7,128,9959,2,6717,3159,3559
8595854,8595852,TXFE7,128,9959,2,6719,3160,3560
8595867,8595861,TXFE7,128,9958,6,6725,3163,3561
8595942,8595941,TXFE7,128,9959,2,6727,3164,3562
9000017,9000009,TXFE7,128,9958,1,6728,3165,3563
9000054,9000042,TXFE7,128,9958,1,6729,3166,3564
9000054,9000052,TXFE7,128,9959,1,6730,3167,3565
9000104,9000097,TXFE7,128,9959,1,6731,3168,3566
9000104,9000103,TXFE7,128,9959,1,6732,3169,3567
9000117,9000115,TXFE7,128,9959,5,6737,3170,3571
9000117,9000117,TXFE7,128,9958,2,6739,3171,3572
9000129,9000118,TXFE7,128,9958,2,6741,3173,3573
9000129,9000118,TXFE7,128,9958,2,6743,3174,3574
9000129,9000127,TXFE7,128,9959,4,6747,3175,3577
9000129,9000128,TXFE7,128,9959,6,6753,3176,3578
9000167,9000163,TXFE7,128,9959,1,6754,3177,3579
9000167,9000166,TXFE7,128,9959,2,6756,3178,3580
9000179,9000172,TXFE7,128,9958,2,6758,3180,3581
9000204,9000194,TXFE7,128,9959,1,6759,3181,3582
9000204,9000195,TXFE7,128,9958,1,6760,3182,3583
9000204,9000199,TXFE7,128,9958,1,6761,3183,3584
9000204,9000204,TXFE7,128,9959,1,6762,3184,3585
9000217,9000204,TXFE7,128,9959,1,6763,3185,3586
9000217,9000204,TXFE7,128,9959,2,6765,3186,3587
9000217,9000209,TXFE7,128,9959,2,6767,3187,3588
9000242,9000232,TXFE7,128,9958,4,6771,3188,3589
9000254,9000248,TXFE7,128,9959,1,6772,3189,3590
9000292,9000284,TXFE7,128,9959,1,6773,3190,3591
9000292,9000286,TXFE7,128,9958,1,6774,3191,3592
9000367,9000357,TXFE7,128,9959,1,6775,3192,3593
9000379,9000369,TXFE7,128,9958,1,6776,3193,3594
9000379,9000375,TXFE7,128,9958,1,6777,3194,3595
9000467,9000457,TXFE7,128,9958,1,6778,3195,3596
9000504,9000504,TXFE7,128,9958,1,6779,3196,3597
9000517,9000509,TXFE7,128,9958,3,6782,3198,3598
9000554,9000545,TXFE7,128,9959,1,6783,3199,3599
9000567,9000556,TXFE7,128,9959,1,6784,3200,3600
9000567,9000564,TXFE7,128,9958,5,6789,3202,3601
9000617,9000613,TXFE7,128,9958,5,6794,3203,3602
9000629,9000617,TXFE7,128,9958,3,6797,3204,3603
9000629,9000617,TXFE7,128,9958,5,6802,3208,3604
9000654,9000647,TXFE7,128,9958,2,6804,3209,3605
9000667,9000663,TXFE7,128,9958,4,6808,3210,3606
9000742,9000736,TXFE7,128,9958,1,6809,3211,3607
9000792,9000785,TXFE7,128,9957,2,6811,3212,3608
9000804,9000799,TXFE7,128,9958,1,6812,3213,3609
9000817,9000809,TXFE7,128,9957,1,6813,3214,3610
9000842,9000833,TXFE7,128,9957,1,6814,3215,3611
9000842,9000835,TXFE7,128,9958,1,6815,3216,3612
9000842,9000840,TXFE7,128,9957,5,6820,3220,3613
9000854,9000846,TXFE7,128,9957,1,6821,3221,3614
9000867,9000862,TXFE7,128,9957,2,6823,3222,3615
9000892,9000881,TXFE7,128,9957,1,6824,3223,3616
9000929,9000924,TXFE7,128,9957,1,6825,3224,3617
9000929,9000926,TXFE7,128,9958,1,6826,3225,3618
9000942,9000942,TXFE7,128,9957,1,6827,3226,3619
9000954,9000943,TXFE7,128,9957,1,6828,3227,3620
9000967,9000964,TXFE7,128,9958,4,6832,3228,3622
9000979,9000978,TXFE7,128,9958,2,6834,3229,3623
9000992,9000983,TXFE7,128,9958,3,6837,3230,3625
9001004,9000997,TXFE7,128,9958,3,6840,3231,3626
9001042,9001040,TXFE7,128,9958,1,6841,3232,3627
9001079,9001073,TXFE7,128,9957,38,6879,3259,3628
9001167,9001162,TXFE7,128,9957,1,6880,3260,3629
9001179,9001179,TXFE7,128,9957,2,6882,3261,3630
9001217,9001212,TXFE7,128,9957,1,6883,3262,3631
9001229,9001219,TXFE7,128,9957,2,6885,3263,3632
9001229,9001226,TXFE7,128,9957,3,6888,3264,3634
9001242,9001236,TXFE7,128,9957,1,6889,3265,3635
9001267,9001266,TXFE7,128,9957,3,6892,3266,3637
9001292,9001283,TXFE7,128,9956,1,6893,3267,3638
9001304,9001302,TXFE7,128,9956,2,6895,3268,3639
9001317,9001308,TXFE7,128,9956,1,6896,3269,3640
9001317,9001317,TXFE7,128,9957,2,6898,3270,3641
9001392,9001391,TXFE7,128,9958,2,6900,3271,3642
9001417,9001411,TXFE7,128,9958,2,6902,3272,3643
9001429,9001425,TXFE7,128,9958,1,6903,3273,3644
9001442,9001431,TXFE7,128,9958,4,6907,3274,3646
9001454,9001448,TXFE7,128,9958,4,6911,3275,3648
9001467,9001455,TXFE7,128,9957,1,6912,3276,3649
9001479,9001467,TXFE7,128,9958,1,6913,3277,3650
9001479,9001474,TXFE7,128,9957,1,6914,3278,3651
9001529,9001520,TXFE7,128,9957,1,6915,3279,3652
9001529,9001522,TXFE7,128,9958,1,6916,3280,3653
9001592,9001584,TXFE7,128,9958,44,6960,3281,3666
9001592,9001584,TXFE7,128,9958,2,6962,3282,3668
9001604,9001592,TXFE7,128,9958,3,6965,3283,3671
9001604,9001601,TXFE7,128,9959,3,6968,3284,3674
9001604,9001604,TXFE7,128,9959,5,6973,3285,3679
9001617,9001606,TXFE7,128,9959,2,6975,3286,3681
9001629,9001624,TXFE7,128,9959,4,6979,3287,3684
9001629,9001627,TXFE7,128,9959,5,6984,3288,3685
9001642,9001630,TXFE7,128,9958,1,6985,3289,3686
9001679,9001679,TXFE7,128,9958,1,6986,3290,3687
9001692,9001684,TXFE7,128,9958,5,6991,3292,3688
9001692,9001687,TXFE7,128,9959,2,6993,3293,3689
9001704,9001692,TXFE7,128,9958,1,6994,3294,3690
9001717,9001715,TXFE7,128,9959,3,6997,3295,3692
9001729,9001723,TXFE7,128,9959,1,6998,3296,3693
9001792,9001781,TXFE7,128,9959,1,6999,3297,3694
9001792,9001784,TXFE7,128,9958,1,7000,3298,3695
9001804,9001799,TXFE7,128,9958,1,7001,3299,3696
9001817,9001816,TXFE7,128,9959,1,7002,3300,3697
9001829,9001826,TXFE7,128,9959,2,7004,3301,3698
9001879,9001874,TXFE7,128,9959,1,7005,3302,3699
9001892,9001887,TXFE7,128,9959,1,7006,3303,3700
9001904,9001903,TXFE7,128,9959,1,7007,3304,3701
9001954,9001947,TXFE7,128,9959,1,7008,3305,3702
9001954,9001952,TXFE7,128,9959,1,7009,3306,3703
9001967,9001955,TXFE7,128,9959,1,7010,3307,3704
9001967,9001959,TXFE7,128,9958,2,7012,3308,3705
9001979,9001976,TXFE7,128,9959,1,7013,3309,3706
9002004,9001993,TXFE7,128,9959,5,7018,3310,3707
9002017,9002012,TXFE7,128,9959,2,7020,3311,3708
9002029,9002020,TXFE7,128,9959,3,7023,3312,3710
9002104,9002092,TXFE7,128,9958,27,7050,3324,3711
9002142,9002132,TXFE7,128,9958,1,7051,3325,3712
9002142,9002141,TXFE7,128,9957,2,7053,3327,3713
9002167,9002165,TXFE7,128,9958,1,7054,3328,3714
9002329,9002326,TXFE7,128,9957,1,7055,3329,3715
9002354,9002349,TXFE7,128,9957,1,7056,3330,3716
9002429,9002421,TXFE7,128,9957,1,7057,3331,3717
9002442,9002431,TXFE7,128,9957,1,7058,3332,3718
9002454,9002450,TXFE7,128,9957,1,7059,3333,3719
9002454,9002454,TXFE7,128,9958,1,7060,3334,3720
9002467,9002455,TXFE7,128,9957,1,7061,3335,3721
9002467,9002457,TXFE7,128,9957,3,7064,3336,3722
9002467,9002463,TXFE7,128,9957,1,7065,3337,3723
9002479,9002473,TXFE7,128,9957,1,7066,3338,3724
9002479,9002479,TXFE7,128,9958,1,7067,3339,3725
9002517,9002510,TXFE7,128,9957,4,7071,3342,3726
9002517,9002512,TXFE7,128,9957,1,7072,3343,3727
9002529,9002526,TXFE7,128,9957,1,7073,3344,3728
9002529,9002527,TXFE7,128,9958,1,7074,3345,3729
9002567,9002561,TXFE7,128,9957,2,7076,3346,3730
9002567,9002562,TXFE7,128,9957,1,7077,3347,3731
9002579,9002568,TXFE7,128,9958,1,7078,3348,3732
9002579,9002576,TXFE7,128,9957,2,7080,3350,3733
9002579,9002578,TXFE7,128,9957,1,7081,3351,3734
9002592,9002580,TXFE7,128,9957,1,7082,3352,3735
9002592,9002582,TXFE7,128,9957,1,7083,3353,3736
9002617,9002615,TXFE7,128,9957,1,7084,3354,3737
9002629,9002626,TXFE7,128,9958,1,7085,3355,3738
9002679,9002667,TXFE7,128,9958,1,7086,3356,3739
9002692,9002687,TXFE7,128,9957,1,7087,3357,3740
9002704,9002694,TXFE7,128,9957,1,7088,3358,3741
9002717,9002707,TXFE7,128,9958,1,7089,3359,3742
9002754,9002746,TXFE7,128,9958,4,7093,3360,3744
9002754,9002749,TXFE7,128,9957,1,7094,3361,3745
9002767,9002760,TXFE7,128,9958,4,7098,3362,3747
9002779,9002777,TXFE7,128,9958,1,7099,3363,3748
9002792,9002780,TXFE7,128,9958,7,7106,3364,3750
9002792,9002789,TXFE7,128,9958,12,7118,3365,3759
9002829,9002828,TXFE7,128,9958,4,7122,3366,3760
9002842,9002830,TXFE7,128,9958,4,7126,3368,3761
9002854,9002850,TXFE7,128,9958,3,7129,3369,3762
9002879,9002879,TXFE7,128,9958,1,7130,3370,3763
9002904,9002898,TXFE7,128,9958,5,7135,3372,3764
9002929,9002921,TXFE7,128,9959,1,7136,3373,3765
9002942,9002932,TXFE7,128,9958,5,7141,3375,3766
9002954,9002946,TXFE7,128,9958,5,7146,3379,3767
9003004,9002996,TXFE7,128,9959,1,7147,3380,3768
9003017,9003007,TXFE7,128,9958,1,7148,3381,3769
9003017,9003015,TXFE7,128,9958,1,7149,3382,3770
9003029,9003027,TXFE7,128,9958,1,7150,3383,3771
9003067,9003059,TXFE7,128,9958,1,7151,3384,3772
9003092,9003079,TXFE7,128,9958,1,7152,3385,3773
9003117,9003112,TXFE7,128,9959,1,7153,3386,3774
9003129,9003119,TXFE7,128,9958,1,7154,3387,3775
9003179,9003171,TXFE7,128,9958,10,7164,3392,3776
9003204,9003197,TXFE7,128,9959,1,7165,3393,3777
9003229,9003218,TXFE7,128,9959,2,7167,3394,3779
9003229,9003221,TXFE7,128,9959,1,7168,3395,3780
9003254,9003247,TXFE7,128,9959,5,7173,3396,3782
9003267,9003254,TXFE7,128,9959,4,7177,3397,3786
9003267,9003256,TXFE7,128,9959,21,7198,3398,3799
9003279,9003267,TXFE7,128,9959,8,7206,3399,3805
9003279,9003267,TXFE7,128,9959,5,7211,3400,3808
9003279,9003272,TXFE7,128,9960,1,7212,3401,3809
9003292,9003280,TXFE7,128,9959,9,7221,3406,3810
9003292,9003280,TXFE7,128,9959,10,7231,3407,3811
9003292,9003281,TXFE7,128,9959,3,7234,3408,3812
9003292,9003281,TXFE7,128,9959,3,7237,3409,3813
9003292,9003284,TXFE7,128,9960,10,7247,3410,3819
9003292,9003289,TXFE7,128,9960,1,7248,3411,3820
9003292,9003290,TXFE7,128,9960,1,7249,3412,3821
9003304,9003292,TXFE7,128,9960,15,7264,3413,3831
9003304,9003292,TXFE7,128,9960,1,7265,3414,3832
9003317,9003309,TXFE7,128,9959,1,7266,3415,3833
9003317,9003310,TXFE7,128,9960,1,7267,3416,3834
9003317,9003316,TXFE7,128,9959,3,7270,3417,3835
9003342,9003336,TXFE7,128,9959,1,7271,3418,3836
9003342,9003339,TXFE7,128,9960,4,7275,3419,3838
9003354,9003348,TXFE7,128,9960,4,7279,3420,3840
9003354,9003353,TXFE7,128,9960,1,7280,3421,3841
9003367,9003364,TXFE7,128,9960,3,7283,3422,3844
9003379,9003369,TXFE7,128,9959,1,7284,3423,3845
9003379,9003378,TXFE7,128,9960,1,7285,3424,3846
9003404,9003396,TXFE7,128,9960,1,7286,3425,3847
9003404,9003398,TXFE7,128,9960,1,7287,3426,3848
9003417,9003408,TXFE7,128,9959,1,7288,3427,3849
9003429,9003418,TXFE7,128,9959,2,7290,3429,3850
9003442,9003436,TXFE7,128,9959,1,7291,3430,3851
9003442,9003440,TXFE7,128,9959,1,7292,3431,3852
9003454,9003442,TXFE7,128,9959,2,7294,3433,3853
9003454,9003447,TXFE7,128,9960,1,7295,3434,3854
9003454,9003452,TXFE7,128,9960,2,7297,3435,3855
9003479,9003471,TXFE7,128,9960,1,7298,3436,3856
9003504,9003501,TXFE7,128,9960,1,7299,3437,3857
9003517,9003516,TXFE7,128,9960,1,7300,3438,3858
9003542,9003536,TXFE7,128,9959,1,7301,3439,3859
9003554,9003548,TXFE7,128,9960,1,7302,3440,3860
9003554,9003550,TXFE7,128,9960,1,7303,3441,3861
9003567,9003556,TXFE7,128,9960,2,7305,3442,3862
9003629,9003626,TXFE7,128,9959,1,7306,3443,3863
9003654,9003642,TXFE7,128,9959,1,7307,3444,3864
9003654,9003644,TXFE7,128,9960,1,7308,3445,3865
9003654,9003647,TXFE7,128,9959,2,7310,3447,3866
9003667,9003661,TXFE7,128,9960,1,7311,3448,3867
9003667,9003666,TXFE7,128,9960,1,7312,3449,3868
9003704,9003699,TXFE7,128,9960,1,7313,3450,3869
9003717,9003709,TXFE7,128,9960,1,7314,3451,3870
9003717,9003710,TXFE7,128,9959,4,7318,3452,3871
9003742,9003735,TXFE7,128,9959,1,7319,3453,3872
9003767,9003761,TXFE7,128,9959,1,7320,3454,3873
9003779,9003778,TXFE7,128,9958,2,7322,3456,3874
9003792,9003779,TXFE7,128,9958,1,7323,3457,3875
9003804,9003798,TXFE7,128,9958,2,7325,3458,3876
9003804,9003799,TXFE7,128,9959,1,7326,3459,3877
9003804,9003800,TXFE7,128,9959,3,7329,3460,3879
9003817,9003806,TXFE7,128,9958,1,7330,3461,3880
9003817,9003808,TXFE7,128,9958,4,7334,3464,3881
9003867,9003858,TXFE7,128,9958,1,7335,3465,3882
9003929,9003926,TXFE7,128,9958,2,7337,3466,3884
9003979,9003973,TXFE7,128,9957,5,7342,3470,3885
9003992,9003984,TXFE7,128,9957,1,7343,3471,3886
9004004,9003992,TXFE7,128,9957,1,7344,3472,3887
9004017,9004016,TXFE7,128,9958,2,7346,3473,3888
9004042,9004029,TXFE7,128,9958,2,7348,3474,3889
9004092,9004083,TXFE7,128,9958,1,7349,3475,3890
9004092,9004084,TXFE7,128,9958,1,7350,3476,3891
9004092,9004086,TXFE7,128,9958,4,7354,3477,3893
9004104,9004103,TXFE7,128,9958,1,7355,3478,3894
9004129,9004126,TXFE7,128,9958,5,7360,3479,3897
9004142,9004129,TXFE7,128,9958,1,7361,3480,3898
9004142,9004137,TXFE7,128,9957,1,7362,3481,3899
9004154,9004147,TXFE7,128,9958,1,7363,3482,3900
9004154,9004149,TXFE7,128,9958,1,7364,3483,3901
9004167,9004163,TXFE7,128,9957,2,7366,3485,3902
9004167,9004164,TXFE7,128,9958,1,7367,3486,3903
9004179,9004168,TXFE7,128,9958,1,7368,3487,3904
9004192,9004190,TXFE7,128,9958,4,7372,3488,3905
9004217,9004205,TXFE7,128,9959,3,7375,3489,3906
9004217,9004215,TXFE7,128,9958,1,7376,3490,3907
9004242,9004232,TXFE7,128,9959,1,7377,3491,3908
9004267,9004267,TXFE7,128,9958,1,7378,3492,3909
9004292,9004284,TXFE7,128,9959,1,7379,3493,3910
9004304,9004296,TXFE7,128,9959,11,7390,3494,3919
9004342,9004337,TXFE7,128,9959,2,7392,3495,3920
9004379,9004370,TXFE7,128,9959,1,7393,3496,3921
9004392,9004380,TXFE7,128,9959,21,7414,3497,3932
9004392,9004381,TXFE7,128,9958,1,7415,3498,3933
9004454,9004453,TXFE7,128,9959,1,7416,3499,3934
9004479,9004471,TXFE7,128,9960,1,7417,3500,3935
9004479,9004472,TXFE7,128,9960,1,7418,3501,3936
9004479,9004473,TXFE7,128,9960,1,7419,3502,3937
9004492,9004481,TXFE7,128,9959,2,7421,3503,3938
9004517,9004507,TXFE7,128,9959,1,7422,3504,3939
9004529,9004522,TXFE7,128,9960,5,7427,3505,3944
9004529,9004526,TXFE7,128,9959,2,7429,3507,3945
9004554,9004543,TXFE7,128,9959,1,7430,3508,3946
9004629,9004622,TXFE7,128,9960,1,7431,3509,3947
9004667,9004657,TXFE7,128,9960,6,7437,3510,3953
9004667,9004660,TXFE7,128,9960,1,7438,3511,3954
9004679,9004667,TXFE7,128,9959,1,7439,3512,3955
9004692,9004688,TXFE7,128,9959,3,7442,3513,3956
9004767,9004756,TXFE7,128,9959,1,7443,3514,3957
9004817,9004816,TXFE7,128,9959,1,7444,3515,3958
9004829,9004829,TXFE7,128,9960,1,7445,3516,3959
9004879,9004876,TXFE7,128,9960,1,7446,3517,3960
9004942,9004934,TXFE7,128,9959,1,7447,3518,3961
9004979,9004974,TXFE7,128,9960,2,7449,3519,3963
9005054,9005043,TXFE7,128,9959,1,7450,3520,3964
9005054,9005046,TXFE7,128,9960,1,7451,3521,3965
9005092,9005082,TXFE7,128,9960,1,7452,3522,3966
9005117,9005109,TXFE7,128,9959,1,7453,3523,3967
9005117,9005109,TXFE7,128,9959,5,7458,3527,3968
9005142,9005134,TXFE7,128,9959,3,7461,3529,3969
9005154,9005152,TXFE7,128,9959,1,7462,3530,3970
9005192,9005191,TXFE7,128,9960,1,7463,3531,3971
9005204,9005204,TXFE7,128,9959,3,7466,3534,3972
9005217,9005207,TXFE7,128,9960,4,7470,3535,3976
9005242,9005230,TXFE7,128,9959,1,7471,3536,3977
9005254,9005243,TXFE7,128,9960,1,7472,3537,3978
9005304,9005292,TXFE7,128,9959,2,7474,3538,3979
9005317,9005307,TXFE7,128,9959,1,7475,3539,3980
9005354,9005346,TXFE7,128,9959,1,7476,3540,3981
9005367,9005359,TXFE7,128,9960,6,7482,3541,3985
9005367,9005359,TXFE7,128,9960,1,7483,3542,3986
9005379,9005370,TXFE7,128,9959,1,7484,3543,3987
9005417,9005409,TXFE7,128,9959,1,7485,3544,3988
9005429,9005429,TXFE7,128,9959,5,7490,3545,3989
9005542,9005531,TXFE7,128,9959,1,7491,3546,3990
9005617,9005609,TXFE7,128,9959,1,7492,3547,3991
9005642,9005640,TXFE7,128,9959,2,7494,3549,3992
9005667,9005666,TXFE7,128,9960,3,7497,3550,3995
9005679,9005676,TXFE7,128,9960,5,7502,3551,3998
9005692,9005684,TXFE7,128,9959,1,7503,3552,3999
9005754,9005751,TXFE7,128,9960,1,7504,3553,4000
9005767,9005756,TXFE7,128,9959,1,7505,3554,4001
9005767,9005766,TXFE7,128,9959,2,7507,3556,4002
9005804,9005792,TXFE7,128,9960,2,7509,3557,4003
9005804,9005803,TXFE7,128,9959,3,7512,3560,4004
9005817,9005811,TXFE7,128,9959,2,7514,3562,4005
9005817,9005812,TXFE7,128,9959,1,7515,3563,4006
9005892,9005888,TXFE7,128,9959,2,7517,3564,4007
9005917,9005910,TXFE7,128,9959,1,7518,3565,4008
9010004,9010004,TXFE7,128,9959,6,7524,3566,4012
9010042,9010037,TXFE7,128,9958,2,7526,3567,4013
9010054,9010052,TXFE7,128,9958,5,7531,3570,4014
9010067,9010057,TXFE7,128,9958,4,7535,3574,4015
9010079,9010074,TXFE7,128,9958,1,7536,3575,4016
9010104,9010093,TXFE7,128,9958,3,7539,3577,4017
9010167,9010156,TXFE7,128,9959,10,7549,3578,4024
9010167,9010165,TXFE7,128,9958,1,7550,3579,4025
9010167,9010167,TXFE7,128,9958,1,7551,3580,4026
9010192,9010181,TXFE7,128,9958,1,7552,3581,4027
9010229,9010217,TXFE7,128,9958,2,7554,3582,4028
9010229,9010218,TXFE7,128,9959,3,7557,3583,4029
9010229,9010229,TXFE7,128,9958,2,7559,3584,4030
9010242,9010234,TXFE7,128,9958,11,7570,3592,4031
9010267,9010260,TXFE7,128,9958,1,7571,3593,4032
9010279,9010277,TXFE7,128,9958,6,7577,3596,4033
9010304,9010294,TXFE7,128,9958,3,7580,3599,4034
9010342,9010339,TXFE7,128,9958,1,7581,3600,4035
9010367,9010355,TXFE7,129,9958,5,7592,3605,4036
9010367,9010355,TXFE7,129,9957,6,7592,3605,4036
9010367,9010366,TXFE7,128,9957,11,7603,3610,4037
9010392,9010389,TXFE7,128,9958,2,7605,3611,4039
9010417,9010406,TXFE7,128,9958,5,7610,3612,4041
9010417,9010407,TXFE7,128,9958,2,7612,3613,4042
9010442,9010437,TXFE7,128,9958,1,7613,3614,4043
9010454,9010449,TXFE7,128,9957,1,7614,3615,4044
9010467,9010466,TXFE7,128,9957,3,7617,3616,4045
9010479,9010468,TXFE7,128,9958,1,7618,3617,4046
9010479,9010474,TXFE7,128,9957,1,7619,3618,4047
9010479,9010478,TXFE7,128,9958,1,7620,3619,4048
9010517,9010513,TXFE7,128,9957,4,7624,3623,4049
9010517,9010514,TXFE7,128,9957,2,7626,3625,4050
9010554,9010553,TXFE7,128,9958,1,7627,3626,4051
9010567,9010558,TXFE7,128,9957,1,7628,3627,4052
9010604,9010601,TXFE7,128,9958,1,7629,3628,4053
9010629,9010623,TXFE7,128,9958,4,7633,3629,4056
9010642,9010635,TXFE7,128,9957,20,7653,3641,4057
9010642,9010636,TXFE7,128,9958,1,7654,3642,4058
9010767,9010765,TXFE7,128,9957,1,7655,3643,4059
9010792,9010788,TXFE7,128,9957,1,7656,3644,4060
9010854,9010847,TXFE7,128,9957,3,7659,3647,4061
9010979,9010972,TXFE7,128,9957,2,7661,3648,4062
9010992,9010982,TXFE7,128,9957,1,7662,3649,4063
9011004,9010998,TXFE7,128,9957,2,7664,3651,4064
9011054,9011046,TXFE7,128,9957,1,7665,3652,4065
9011067,9011064,TXFE7,128,9957,1,7666,3653,4066
9011079,9011071,TXFE7,128,9956,5,7671,3655,4067
9011092,9011092,TXFE7,128,9956,1,7672,3656,4068
9011104,9011092,TXFE7,128,9956,2,7674,3658,4069
9011117,9011106,TXFE7,128,9956,1,7675,3659,4070
9011179,9011172,TXFE7,128,9956,1,7676,3660,4071
9011179,9011175,TXFE7,128,9956,25,7701,3674,4072
9011179,9011175,TXFE7,128,9956,2,7703,3675,4073
9011192,9011182,TXFE7,128,9956,2,7705,3677,4074
9011192,9011183,TXFE7,128,9956,3,7708,3679,4075
9011204,9011192,TXFE7,128,9956,1,7709,3680,4076
9011217,9011206,TXFE7,128,9957,1,7710,3681,4077
9011217,9011206,TXFE7,128,9956,2,7712,3683,4078
9011229,9011220,TXFE7,128,9956,1,7713,3684,4079
9011242,9011232,TXFE7,128,9956,1,7714,3685,4080
9011242,9011233,TXFE7,128,9956,3,7717,3686,4081
9011254,9011249,TXFE7,128,9956,1,7718,3687,4082
9011254,9011250,TXFE7,128,9956,1,7719,3688,4083
9011304,9011302,TXFE7,128,9956,2,7721,3690,4084
9011304,9011303,TXFE7,128,9956,1,7722,3691,4085
9011317,9011315,TXFE7,128,9956,1,7723,3692,4086
9011329,9011319,TXFE7,129,9956,1,7752,3710,4087
9011329,9011319,TXFE7,129,9955,28,7752,3710,4087
9011329,9011319,TXFE7,128,9956,1,7753,3711,4088
9011329,9011324,TXFE7,128,9955,7,7760,3716,4089
9011342,9011339,TXFE7,128,9955,1,7761,3717,4090
9011354,9011349,TXFE7,128,9955,2,7763,3719,4091
9011354,9011354,TXFE7,128,9956,1,7764,3720,4092
9011367,9011359,TXFE7,128,9955,1,7765,3721,4093
9011379,9011377,TXFE7,128,9955,1,7766,3722,4094
9011379,9011378,TXFE7,128,9956,1,7767,3723,4095
9011392,9011381,TXFE7,128,9955,25,7792,3733,4096
9011392,9011390,TXFE7,128,9956,2,7794,3734,4098
9011429,9011427,TXFE7,128,9956,2,7796,3735,4099
9011442,9011438,TXFE7,128,9956,1,7797,3736,4100
9011467,9011455,TXFE7,128,9955,1,7798,3737,4101
9011467,9011455,TXFE7,128,9955,2,7800,3738,4102
9011492,9011487,TXFE7,128,9955,1,7801,3739,4103
9011517,9011513,TXFE7,128,9955,1,7802,3740,4104
9011554,9011549,TXFE7,128,9955,1,7803,3741,4105
9011567,9011561,TXFE7,128,9955,1,7804,3742,4106
9011579,9011579,TXFE7,128,9955,2,7806,3743,4107
9011592,9011589,TXFE7,128,9955,1,7807,3744,4108
9011654,9011649,TXFE7,128,9955,3,7810,3745,4109
9011667,9011658,TXFE7,128,9955,6,7816,3750,4110
9011679,9011667,TXFE7,128,9955,4,7820,3753,4111
9011679,9011679,TXFE7,129,9955,1,7825,3757,4112
9011679,9011679,TXFE7,129,9954,4,7825,3757,4112
9011692,9011680,TXFE7,128,9954,5,7830,3758,4113
9011692,9011682,TXFE7,128,9954,2,7832,3760,4114
9011692,9011691,TXFE7,128,9954,1,7833,3761,4115
9011717,9011713,TXFE7,128,9955,5,7838,3762,4117
9011717,9011716,TXFE7,128,9955,3,7841,3763,4118
9011717,9011716,TXFE7,128,9954,1,7842,3764,4119
9011729,9011722,TXFE7,128,9954,1,7843,3765,4120
9011729,9011727,TXFE7,128,9955,1,7844,3766,4121
9011767,9011764,TXFE7,128,9955,3,7847,3767,4124
9011779,9011773,TXFE7,128,9954,1,7848,3768,4125
9011779,9011774,TXFE7,128,9954,1,7849,3769,4126
9011779,9011778,TXFE7,128,9955,1,7850,3770,4127
9011792,9011791,TXFE7,128,9954,1,7851,3771,4128
9011804,9011800,TXFE7,128,9955,1,7852,3772,4129
9011829,9011827,TXFE7,128,9954,1,7853,3773,4130
9011842,9011829,TXFE7,128,9955,1,7854,3774,4131
9011854,9011850,TXFE7,128,9954,1,7855,3775,4132
9011867,9011861,TXFE7,128,9954,1,7856,3776,4133
9011867,9011862,TXFE7,128,9954,1,7857,3777,4134
9011867,9011862,TXFE7,128,9955,1,7858,3778,4135
9011917,9011904,TXFE7,128,9954,3,7861,3781,4136
9011929,9011921,TXFE7,128,9954,1,7862,3782,4137
9011942,9011937,TXFE7,128,9955,1,7863,3783,4138
9011954,9011953,TXFE7,128,9954,1,7864,3784,4139
9011967,9011959,TXFE7,128,9955,1,7865,3785,4140
9011979,9011973,TXFE7,128,9954,1,7866,3786,4141
9012042,9012030,TXFE7,128,9954,2,7868,3787,4142
9012042,9012038,TXFE7,128,9955,1,7869,3788,4143
9012042,9012039,TXFE7,128,9954,1,7870,3789,4144
9012054,9012048,TXFE7,128,9955,1,7871,3790,4145
9012054,9012052,TXFE7,128,9955,2,7873,3791,4147
9012079,9012074,TXFE7,128,9954,2,7875,3793,4148
9012092,9012091,TXFE7,128,9955,1,7876,3794,4149
9012104,9012100,TXFE7,128,9954,1,7877,3795,4150
9012117,9012110,TXFE7,128,9955,2,7879,3796,4151
9012129,9012124,TXFE7,128,9955,1,7880,3797,4152
9012142,9012137,TXFE7,128,9955,2,7882,3798,4154
9012154,9012152,TXFE7,128,9955,1,7883,3799,4155
9012179,9012170,TXFE7,128,9955,1,7884,3800,4156
9012267,9012264,TXFE7,128,9955,2,7886,3801,4157
9012279,9012270,TXFE7,128,9955,1,7887,3802,4158
9012304,9012296,TXFE7,128,9955,1,7888,3803,4159
9012317,9012311,TXFE7,128,9955,1,7889,3804,4160
9012354,9012350,TXFE7,128,9955,2,7891,3805,4161
9012354,9012351,TXFE7,128,9955,1,7892,3806,4162
9012379,9012370,TXFE7,128,9954,5,7897,3809,4163
9012379,9012373,TXFE7,128,9954,1,7898,3810,4164
9012404,9012392,TXFE7,128,9955,3,7901,3811,4165
9012404,9012401,TXFE7,128,9954,1,7902,3812,4166
9012417,9012405,TXFE7,128,9955,1,7903,3813,4167
9012429,9012418,TXFE7,128,9954,2,7905,3814,4168
9012442,9012432,TXFE7,128,9955,1,7906,3815,4169
9012454,9012447,TXFE7,128,9954,20,7926,3825,4170
9012467,9012454,TXFE7,128,9954,6,7932,3829,4171
9012479,9012471,TXFE7,128,9954,2,7934,3831,4172
9012492,9012490,TXFE7,128,9954,2,7936,3833,4173
9012504,9012494,TXFE7,128,9955,1,7937,3834,4174
9012529,9012527,TXFE7,128,9954,1,7938,3835,4175
9012542,9012537,TXFE7,128,9954,1,7939,3836,4176
9012567,9012557,TXFE7,128,9954,1,7940,3837,4177
9012567,9012567,TXFE7,128,9955,1,7941,3838,4178
9012617,9012607,TXFE7,128,9954,1,7942,3839,4179
9012642,9012636,TXFE7,128,9955,1,7943,3840,4180
9012654,9012651,TXFE7,128,9955,1,7944,3841,4181
9012704,9012692,TXFE7,128,9954,1,7945,3842,4182
9012704,9012702,TXFE7,128,9954,1,7946,3843,4183
9012742,9012730,TXFE7,128,9954,1,7947,3844,4184
9012742,9012734,TXFE7,128,9955,1,7948,3845,4185
9012754,9012744,TXFE7,128,9954,1,7949,3846,4186
9012792,9012789,TXFE7,128,9955,1,7950,3847,4187
9012867,9012854,TXFE7,128,9955,2,7952,3848,4189
9012867,9012854,TXFE7,128,9955,4,7956,3849,4192
9012879,9012879,TXFE7,128,9955,1,7957,3850,4193
9012892,9012882,TXFE7,128,9954,2,7959,3852,4194
9012929,9012918,TXFE7,128,9955,1,7960,3853,4195
9012929,9012919,TXFE7,128,9955,5,7965,3854,4199
9012942,9012929,TXFE7,128,9955,2,7967,3855,4200
9012954,9012952,TXFE7,128,9954,1,7968,3856,4201
9012967,9012958,TXFE7,128,9954,3,7971,3858,4202
9013017,9013015,TXFE7,128,9955,1,7972,3859,4203
9013042,9013031,TXFE7,128,9954,1,7973,3860,4204
9013042,9013032,TXFE7,128,9954,1,7974,3861,4205
9013067,9013058,TXFE7,128,9954,1,7975,3862,4206
9013092,9013091,TXFE7,128,9954,1,7976,3863,4207
9013117,9013113,TXFE7,128,9954,1,7977,3864,4208
9013167,9013155,TXFE7,128,9955,1,7978,3865,4209
9013167,9013159,TXFE7,128,9955,1,7979,3866,4210
9013167,9013159,TXFE7,128,9955,1,7980,3867,4211
9013192,9013179,TXFE7,128,9955,1,7981,3868,4212
9013192,9013185,TXFE7,128,9956,1,7982,3869,4213
9013229,9013221,TXFE7,128,9956,2,7984,3870,4214
9013267,9013259,TXFE7,128,9956,1,7985,3871,4215
9013279,9013277,TXFE7,128,9956,3,7988,3872,4218
9013304,9013296,TXFE7,128,9956,1,7989,3873,4219
9013317,9013313,TXFE7,128,9956,1,7990,3874,4220
9013342,9013341,TXFE7,128,9956,5,7995,3875,4224
9013379,9013371,TXFE7,128,9955,1,7996,3876,4225
9013379,9013376,TXFE7,128,9955,2,7998,3878,4226
9013379,9013376,TXFE7,128,9956,1,7999,3879,4227
9013404,9013397,TXFE7,128,9956,1,8000,3880,4228
9013404,9013397,TXFE7,128,9956,1,8001,3881,4229
9013404,9013401,TXFE7,128,9955,1,8002,3882,4230
9013429,9013428,TXFE7,128,9955,1,8003,3883,4231
9013492,9013482,TXFE7,128,9956,2,8005,3884,4233
9013504,9013495,TXFE7,128,9955,2,8007,3886,4234
9013542,9013530,TXFE7,128,9955,9,8016,3893,4235
9013567,9013558,TXFE7,128,9955,1,8017,3894,4236
9013617,9013611,TXFE7,128,9954,1,8018,3895,4237
9013654,9013654,TXFE7,128,9955,1,8019,3896,4238
9013717,9013712,TXFE7,128,9955,1,8020,3897,4239
9013729,9013721,TXFE7,128,9955,1,8021,3898,4240
9013767,9013759,TXFE7,128,9955,1,8022,3899,4241
9013817,9013812,TXFE7,128,9955,1,8023,3900,4242
9013829,9013828,TXFE7,128,9955,1,8024,3901,4243
9013842,9013836,TXFE7,128,9954,1,8025,3902,4244
9013854,9013846,TXFE7,128,9954,1,8026,3903,4245
9013867,9013860,TXFE7,128,9955,8,8034,3904,4247
9013879,9013870,TXFE7,128,9954,1,8035,3905,4248
9013954,9013947,TXFE7,128,9954,1,8036,3906,4249
9013954,9013947,TXFE7,128,9955,1,8037,3907,4250
9013967,9013960,TXFE7,128,9954,2,8039,3908,4251
9014017,9014005,TXFE7,128,9954,1,8040,3909,4252
9014017,9014006,TXFE7,128,9954,1,8041,3910,4253
9014042,9014034,TXFE7,128,9954,1,8042,3911,4254
9014142,9014139,TXFE7,128,9954,5,8047,3914,4255
9014154,9014150,TXFE7,128,9955,3,8050,3915,4256
9014292,9014284,TXFE7,128,9955,5,8055,3916,4259
9014329,9014317,TXFE7,128,9955,1,8056,3917,4260
9014329,9014323,TXFE7,128,9954,1,8057,3918,4261
9014342,9014336,TXFE7,128,9954,2,8059,3919,4262
9014379,9014369,TXFE7,128,9954,2,8061,3920,4263
9014467,9014455,TXFE7,128,9955,3,8064,3921,4264
9014517,9014513,TXFE7,128,9954,1,8065,3922,4265
9014542,9014539,TXFE7,128,9955,1,8066,3923,4266
9014617,9014608,TXFE7,128,9955,2,8068,3924,4268
9014717,9014709,TXFE7,128,9954,1,8069,3925,4269
9014754,9014745,TXFE7,128,9954,1,8070,3926,4270
9014804,9014792,TXFE7,128,9955,1,8071,3927,4271
9014917,9014906,TXFE7,128,9955,1,8072,3928,4272
9014929,9014923,TXFE7,128,9955,10,8082,3929,4278
9014979,9014972,TXFE7,128,9955,1,8083,3930,4279
9015029,9015023,TXFE7,128,9955,1,8084,3931,4280
9015067,9015054,TXFE7,128,9955,1,8085,3932,4281
9015079,9015076,TXFE7,128,9955,2,8087,3933,4282
9015117,9015113,TXFE7,128,9955,1,8088,3934,4283
9015204,9015203,TXFE7,128,9955,1,8089,3935,4284
9015229,9015224,TXFE7,128,9954,1,8090,3936,4285
9015279,9015272,TXFE7,128,9954,1,8091,3937,4286
9015392,9015385,TXFE7,128,9955,1,8092,3938,4287
9015417,9015414,TXFE7,128,9954,2,8094,3940,4288
9015492,9015488,TXFE7,128,9955,1,8095,3941,4289
9015604,9015593,TXFE7,128,9955,1,8096,3942,4290
9015642,9015631,TXFE7,128,9955,1,8097,3943,4291
9015642,9015632,TXFE7,128,9955,20,8117,3944,4307
9015642,9015638,TXFE7,128,9955,2,8119,3945,4308
9015692,9015688,TXFE7,128,9955,10,8129,3946,4311
9015767,9015759,TXFE7,128,9955,2,8131,3947,4313
9015779,9015771,TXFE7,128,9955,1,8132,3948,4314
9015817,9015809,TXFE7,128,9955,1,8133,3949,4315
9015829,9015820,TXFE7,128,9955,1,8134,3950,4316
9015879,9015867,TXFE7,128,9955,1,8135,3951,4317
9015892,9015885,TXFE7,128,9955,2,8137,3952,4319
9015904,9015894,TXFE7,128,9954,1,8138,3953,4320
9015929,9015921,TXFE7,128,9955,4,8142,3954,4322
9020029,9020021,TXFE7,128,9954,2,8144,3956,4323
9020029,9020023,TXFE7,128,9955,1,8145,3957,4324
9020029,9020025,TXFE7,128,9955,1,8146,3958,4325
9020042,9020030,TXFE7,128,9954,2,8148,3960,4326
9020042,9020036,TXFE7,128,9954,1,8149,3961,4327
9020054,9020044,TXFE7,128,9954,1,8150,3962,4328
9020054,9020050,TXFE7,128,9954,1,8151,3963,4329
9020067,9020056,TXFE7,128,9955,1,8152,3964,4330
9020067,9020056,TXFE7,128,9954,1,8153,3965,4331
9020079,9020077,TXFE7,128,9955,4,8157,3966,4332
9020092,9020088,TXFE7,128,9955,6,8163,3967,4334
9020192,9020184,TXFE7,128,9955,1,8164,3968,4335
9020217,9020209,TXFE7,128,9954,1,8165,3969,4336
9020242,9020241,TXFE7,128,9955,1,8166,3970,4337
9020354,9020346,TXFE7,128,9955,1,8167,3971,4338
9020379,9020371,TXFE7,128,9954,5,8172,3976,4339
9020392,9020380,TXFE7,128,9954,77,8249,4023,4340
9020404,9020397,TXFE7,128,9953,1,8250,4024,4341
9020417,9020404,TXFE7,128,9953,4,8254,4027,4342
9020417,9020406,TXFE7,128,9953,5,8259,4032,4343
9020417,9020406,TXFE7,128,9953,6,8265,4038,4344
9020417,9020417,TXFE7,128,9953,4,8269,4040,4345
9020429,9020417,TXFE7,128,9953,2,8271,4042,4346
9020429,9020417,TXFE7,128,9953,1,8272,4043,4347
9020429,9020417,TXFE7,128,9953,4,8276,4047,4348
9020429,9020417,TXFE7,128,9953,4,8280,4051,4349
9020429,9020419,TXFE7,128,9953,1,8281,4052,4350
9020429,9020422,TXFE7,128,9953,33,8314,4076,4351
9020442,9020435,TXFE7,128,9952,1,8315,4077,4352
9020442,9020441,TXFE7,128,9953,1,8316,4078,4353
9020454,9020444,TXFE7,128,9953,5,8321,4079,4356
9020454,9020445,TXFE7,128,9952,3,8324,4080,4357
9020454,9020451,TXFE7,128,9952,1,8325,4081,4358
9020467,9020462,TXFE7,128,9952,1,8326,4082,4359
9020479,9020468,TXFE7,128,9953,2,8328,4083,4360
9020479,9020470,TXFE7,128,9952,2,8330,4084,4361
9020479,9020471,TXFE7,128,9952,1,8331,4085,4362
9020479,9020472,TXFE7,128,9952,1,8332,4086,4363
9020479,9020477,TXFE7,128,9952,2,8334,4088,4364
9020492,9020485,TXFE7,128,9952,1,8335,4089,4365
9020492,9020488,TXFE7,128,9952,2,8337,4091,4366
9020504,9020501,TXFE7,128,9952,1,8338,4092,4367
9020504,9020501,TXFE7,128,9952,1,8339,4093,4368
9020504,9020502,TXFE7,128,9952,3,8342,4095,4369
9020504,9020504,TXFE7,128,9952,3,8345,4096,4370
9020517,9020505,TXFE7,128,9952,5,8350,4097,4371
9020529,9020522,TXFE7,128,9952,47,8397,4124,4372
9020567,9020558,TXFE7,128,9951,2,8399,4126,4373
9020567,9020564,TXFE7,128,9952,1,8400,4127,4374
9020579,9020572,TXFE7,128,9951,10,8410,4129,4375
9020579,9020574,TXFE7,128,9952,3,8413,4130,4376
9020592,9020582,TXFE7,128,9951,1,8414,4131,4377
9020592,9020583,TXFE7,128,9952,2,8416,4132,4378
9020604,9020596,TXFE7,128,9951,3,8419,4135,4379
9020604,9020600,TXFE7,128,9951,6,8425,4139,4380
9020617,9020604,TXFE7,128,9952,1,8426,4140,4381
9020617,9020607,TXFE7,128,9952,1,8427,4141,4382
9020617,9020608,TXFE7,128,9952,1,8428,4142,4383
9020617,9020609,TXFE7,128,9951,1,8429,4143,4384
9020617,9020610,TXFE7,128,9951,1,8430,4144,4385
9020617,9020613,TXFE7,128,9951,40,8470,4168,4386
9020617,9020616,TXFE7,128,9951,1,8471,4169,4387
9020629,9020617,TXFE7,128,9951,37,8508,4191,4388
9020642,9020634,TXFE7,128,9950,1,8509,4192,4389
9020654,9020642,TXFE7,128,9950,2,8511,4193,4390
9020654,9020645,TXFE7,128,9950,8,8519,4201,4391
9020654,9020647,TXFE7,128,9950,1,8520,4202,4392
9020654,9020648,TXFE7,128,9950,1,8521,4203,4393
9020654,9020648,TXFE7,128,9950,1,8522,4204,4394
9020654,9020649,TXFE7,128,9950,2,8524,4206,4395
9020654,9020650,TXFE7,128,9950,10,8534,4212,4396
9020654,9020650,TXFE7,128,9950,2,8536,4214,4397
9020654,9020652,TXFE7,128,9950,1,8537,4215,4398
9020654,9020652,TXFE7,128,9950,1,8538,4216,4399
9020667,9020654,TXFE7,128,9950,1,8539,4217,4400
9020667,9020655,TXFE7,128,9950,9,8548,4220,4401
9020667,9020656,TXFE7,128,9950,1,8549,4221,4402
9020667,9020657,TXFE7,128,9950,6,8555,4223,4403
9020667,9020658,TXFE7,128,9950,1,8556,4224,4404
9020667,9020659,TXFE7,128,9950,1,8557,4225,4405
9020667,9020659,TXFE7,128,9950,1,8558,4226,4406
9020667,9020661,TXFE7,128,9950,1,8559,4227,4407
9020667,9020662,TXFE7,128,9951,1,8560,4228,4408
9020667,9020664,TXFE7,128,9951,2,8562,4229,4409
9020667,9020665,TXFE7,128,9950,1,8563,4230,4410
9020679,9020667,TXFE7,128,9950,1,8564,4231,4411
9020679,9020669,TXFE7,128,9951,1,8565,4232,4412
9020679,9020672,TXFE7,128,9950,1,8566,4233,4413
9020679,9020674,TXFE7,128,9951,1,8567,4234,4414
9020679,9020677,TXFE7,128,9950,3,8570,4236,4415
9020679,9020677,TXFE7,128,9950,2,8572,4237,4416
9020679,9020678,TXFE7,128,9950,1,8573,4238,4417
9020679,9020679,TXFE7,128,9951,3,8576,4239,4418
9020692,9020683,TXFE7,128,9950,2,8578,4240,4419
9020692,9020686,TXFE7,128,9950,3,8581,4242,4420
9020692,9020691,TXFE7,128,9951,2,8583,4243,4422
9020704,9020704,TXFE7,128,9950,1,8584,4244,4423
9020729,9020720,TXFE7,128,9950,1,8585,4245,4424
9020729,9020728,TXFE7,128,9951,1,8586,4246,4425
9020742,9020730,TXFE7,128,9950,1,8587,4247,4426
9020742,9020731,TXFE7,128,9950,1,8588,4248,4427
9020742,9020737,TXFE7,128,9950,1,8589,4249,4428
9020742,9020739,TXFE7,128,9950,4,8593,4253,4429
9020754,9020749,TXFE7,128,9950,2,8595,4255,4430
9020754,9020752,TXFE7,128,9950,3,8598,4258,4431
9020779,9020771,TXFE7,128,9950,8,8606,4265,4432
9020792,9020781,TXFE7,128,9950,1,8607,4266,4433
9020804,9020803,TXFE7,128,9950,5,8612,4269,4434
9020817,9020811,TXFE7,128,9951,1,8613,4270,4435
9020817,9020813,TXFE7,128,9951,1,8614,4271,4436
9020829,9020819,TXFE7,128,9950,1,8615,4272,4437
9020829,9020819,TXFE7,128,9950,2,8617,4273,4438
9020829,9020822,TXFE7,128,9950,1,8618,4274,4439
9020829,9020825,TXFE7,128,9950,2,8620,4276,4440
9020829,9020826,TXFE7,128,9950,2,8622,4278,4441
9020829,9020826,TXFE7,128,9950,2,8624,4280,4442
9020854,9020850,TXFE7,128,9949,3,8627,4282,4443
9020854,9020851,TXFE7,128,9950,1,8628,4283,4444
9020867,9020855,TXFE7,128,9950,3,8631,4284,4445
9020867,9020855,TXFE7,128,9949,5,8636,4289,4446
9020867,9020856,TXFE7,128,9949,1,8637,4290,4447
9020867,9020857,TXFE7,128,9950,2,8639,4291,4448
9020867,9020857,TXFE7,128,9949,2,8641,4293,4449
9020867,9020859,TXFE7,128,9950,1,8642,4294,4450
9020892,9020885,TXFE7,128,9949,2,8644,4296,4451
9020892,9020889,TXFE7,128,9949,1,8645,4297,4452
9020892,9020890,TXFE7,128,9949,1,8646,4298,4453
9020904,9020893,TXFE7,128,9950,1,8647,4299,4454
9020904,9020897,TXFE7,128,9949,1,8648,4300,4455
9020904,9020903,TXFE7,128,9949,1,8649,4301,4456
9020917,9020908,TXFE7,128,9949,3,8652,4304,4457
9020929,9020925,TXFE7,128,9949,2,8654,4306,4458
9020942,9020930,TXFE7,128,9949,1,8655,4307,4459
9020942,9020938,TXFE7,128,9950,1,8656,4308,4460
9020954,9020942,TXFE7,128,9950,2,8658,4309,4462
9020954,9020948,TXFE7,128,9949,1,8659,4310,4463
9020954,9020948,TXFE7,128,9949,1,8660,4311,4464
9020967,9020954,TXFE7,128,9950,4,8664,4312,4466
9020967,9020955,TXFE7,128,9949,2,8666,4313,4467
9020967,9020960,TXFE7,128,9950,11,8677,4314,4474
9020967,9020960,TXFE7,128,9950,1,8678,4315,4475
9020967,9020964,TXFE7,128,9950,1,8679,4316,4476
9020979,9020967,TXFE7,128,9950,1,8680,4317,4477
9020992,9020981,TXFE7,128,9950,1,8681,4318,4478
9021004,9020992,TXFE7,128,9950,4,8685,4320,4479
9021042,9021032,TXFE7,128,9950,1,8686,4321,4480
9021054,9021048,TXFE7,128,9951,1,8687,4322,4481
9021067,9021061,TXFE7,128,9950,6,8693,4323,4482
9021067,9021066,TXFE7,128,9951,3,8696,4324,4484
9021104,9021094,TXFE7,128,9950,1,8697,4325,4485
9021104,9021099,TXFE7,128,9951,1,8698,4326,4486
9021117,9021112,TXFE7,128,9951,1,8699,4327,4487
9021129,9021117,TXFE7,128,9951,1,8700,4328,4488
9021129,9021122,TXFE7,128,9951,1,8701,4329,4489
9021142,9021133,TXFE7,128,9951,1,8702,4330,4490
9021204,9021201,TXFE7,128,9950,3,8705,4333,4491
9021242,9021238,TXFE7,128,9950,6,8711,4339,4492
9021242,9021238,TXFE7,128,9950,1,8712,4340,4493
9021242,9021238,TXFE7,128,9950,1,8713,4341,4494
9021292,9021282,TXFE7,128,9950,1,8714,4342,4495
9021317,9021309,TXFE7,128,9949,5,8719,4347,4496
9021317,9021315,TXFE7,128,9950,1,8720,4348,4497
9021329,9021324,TXFE7,128,9950,1,8721,4349,4498
9021367,9021366,TXFE7,128,9949,1,8722,4350,4499
9021379,9021368,TXFE7,128,9949,1,8723,4351,4500
9021392,9021387,TXFE7,128,9949,11,8734,4357,4501
9021404,9021396,TXFE7,128,9949,1,8735,4358,4502
9021417,9021404,TXFE7,128,9949,2,8737,4359,4503
9021417,9021407,TXFE7,128,9950,1,8738,4360,4504
9021417,9021407,TXFE7,128,9950,5,8743,4361,4507
9021417,9021410,TXFE7,128,9950,1,8744,4362,4508
9021417,9021413,TXFE7,128,9950,1,8745,4363,4509
9021429,9021418,TXFE7,128,9950,1,8746,4364,4510
9021429,9021422,TXFE7,128,9950,9,8755,4365,4514
9021442,9021439,TXFE7,128,9949,1,8756,4366,4515
9021454,9021446,TXFE7,128,9949,20,8776,4377,4516
9021454,9021448,TXFE7,128,9950,2,8778,4378,4517
9021479,9021476,TXFE7,128,9949,1,8779,4379,4518
9021504,9021496,TXFE7,128,9950,1,8780,4380,4519
9021517,9021505,TXFE7,128,9950,1,8781,4381,4520
9021529,9021527,TXFE7,128,9950,2,8783,4382,4522
9021542,9021530,TXFE7,128,9950,4,8787,4383,4525
9021542,9021534,TXFE7,128,9949,1,8788,4384,4526
9021554,9021550,TXFE7,128,9949,2,8790,4385,4527
9021554,9021551,TXFE7,128,9949,1,8791,4386,4528
9021567,9021560,TXFE7,128,9950,2,8793,4387,4530
9021592,9021587,TXFE7,128,9950,1,8794,4388,4531
9021592,9021589,TXFE7,128,9951,3,8797,4389,4534
9021642,9021630,TXFE7,128,9951,2,8799,4390,4536
9021642,9021630,TXFE7,128,9951,2,8801,4391,4537
9021642,9021639,TXFE7,128,9951,1,8802,4392,4538
9021642,9021640,TXFE7,128,9950,1,8803,4393,4539
9021642,9021641,TXFE7,128,9950,10,8813,4399,4540
9021654,9021649,TXFE7,128,9950,2,8815,4401,4541
9021654,9021650,TXFE7,128,9950,1,8816,4402,4542
9021667,9021658,TXFE7,128,9949,6,8822,4405,4543
9021667,9021665,TXFE7,128,9950,2,8824,4406,4544
9021667,9021666,TXFE7,128,9950,1,8825,4407,4545
9021667,9021667,TXFE7,128,9950,1,8826,4408,4546
9021679,9021669,TXFE7,128,9951,3,8829,4409,4548
9021692,9021687,TXFE7,128,9951,9,8838,4410,4551
9021692,9021688,TXFE7,128,9950,2,8840,4412,4552
9021704,9021697,TXFE7,128,9951,3,8843,4413,4553
9021729,9021729,TXFE7,128,9951,1,8844,4414,4554
9021742,9021729,TXFE7,128,9951,1,8845,4415,4555
9021742,9021740,TXFE7,128,9951,1,8846,4416,4556
9021742,9021742,TXFE7,128,9951,1,8847,4417,4557
9021754,9021754,TXFE7,129,9951,1,8850,4419,4558
9021754,9021754,TXFE7,129,9950,2,8850,4419,4558
9021779,9021773,TXFE7,128,9950,1,8851,4420,4559
9021817,9021811,TXFE7,128,9950,1,8852,4421,4560
9021817,9021814,TXFE7,128,9950,4,8856,4422,4561
9021842,9021831,TXFE7,128,9951,2,8858,4423,4562
9021879,9021873,TXFE7,128,9951,3,8861,4424,4563
9021929,9021923,TXFE7,129,9951,1,8863,4426,4564
9021929,9021923,TXFE7,129,9950,1,8863,4426,4564
9021979,9021976,TXFE7,128,9951,3,8866,4427,4566
9022129,9022121,TXFE7,128,9951,1,8867,4428,4567
9022142,9022131,TXFE7,128,9951,2,8869,4429,4568
9022142,9022139,TXFE7,128,9951,2,8871,4430,4569
9022179,9022177,TXFE7,128,9951,1,8872,4431,4570
9022192,9022180,TXFE7,128,9951,1,8873,4432,4571
9022279,9022273,TXFE7,128,9951,9,8882,4433,4576
9022279,9022273,TXFE7,128,9951,1,8883,4434,4577
9022317,9022312,TXFE7,128,9951,1,8884,4435,4578
9022379,9022374,TXFE7,128,9950,1,8885,4436,4579
9022392,9022380,TXFE7,128,9951,1,8886,4437,4580
9022442,9022437,TXFE7,128,9950,2,8888,4438,4581
9022454,9022447,TXFE7,128,9950,1,8889,4439,4582
9022492,9022481,TXFE7,128,9950,2,8891,4441,4583
9022492,9022486,TXFE7,128,9951,1,8892,4442,4584
9022492,9022490,TXFE7,128,9951,1,8893,4443,4585
9022504,9022496,TXFE7,128,9951,1,8894,4444,4586
9022504,9022496,TXFE7,128,9951,1,8895,4445,4587
9022529,9022528,TXFE7,128,9951,1,8896,4446,4588
9022554,9022548,TXFE7,128,9950,2,8898,4448,4589
9022554,9022549,TXFE7,128,9951,1,8899,4449,4590
9022567,9022563,TXFE7,128,9950,1,8900,4450,4591
9022592,9022582,TXFE7,128,9950,2,8902,4452,4592
9022754,9022751,TXFE7,128,9951,1,8903,4453,4593
9022767,9022761,TXFE7,128,9951,1,8904,4454,4594
9022779,9022772,TXFE7,128,9951,9,8913,4455,4600
9022792,9022783,TXFE7,128,9951,1,8914,4456,4601
9022792,9022790,TXFE7,128,9950,1,8915,4457,4602
9022817,9022812,TXFE7,128,9951,1,8916,4458,4603
9022829,9022819,TXFE7,128,9952,1,8917,4459,4604
9022854,9022845,TXFE7,128,9951,1,8918,4460,4605
9022867,9022856,TXFE7,128,9952,1,8919,4461,4606
9022879,9022869,TXFE7,128,9951,5,8924,4463,4607
9022954,9022950,TXFE7,128,9951,3,8927,4464,4608
9022967,9022959,TXFE7,128,9952,3,8930,4465,4611
9022967,9022966,TXFE7,128,9952,3,8933,4466,4614
9022992,9022981,TXFE7,128,9951,1,8934,4467,4615
9023017,9023010,TXFE7,128,9952,1,8935,4468,4616
9023029,9023017,TXFE7,128,9952,1,8936,4469,4617
9023029,9023024,TXFE7,128,9952,1,8937,4470,4618
9023029,9023027,TXFE7,128,9952,4,8941,4471,4622
9023042,9023029,TXFE7,128,9952,1,8942,4472,4623
9023054,9023043,TXFE7,128,9952,1,8943,4473,4624
9023054,9023053,TXFE7,128,9952,2,8945,4474,4625
9023079,9023068,TXFE7,128,9951,2,8947,4476,4626
9023079,9023070,TXFE7,128,9952,1,8948,4477,4627
9023079,9023071,TXFE7,128,9951,1,8949,4478,4628
9023092,9023081,TXFE7,128,9952,1,8950,4479,4629
9023092,9023086,TXFE7,128,9952,1,8951,4480,4630
9023117,9023112,TXFE7,128,9952,1,8952,4481,4631
9023142,9023136,TXFE7,128,9951,2,8954,4482,4632
9023167,9023164,TXFE7,128,9951,1,8955,4483,4633
9023179,9023169,TXFE7,128,9952,2,8957,4484,4635
9023217,9023214,TXFE7,128,9952,2,8959,4485,4636
9023229,9023225,TXFE7,128,9952,2,8961,4486,4637
9023267,9023266,TXFE7,128,9951,22,8983,4495,4638
9023279,9023276,TXFE7,128,9952,6,8989,4496,4642
9023279,9023279,TXFE7,128,9951,1,8990,4497,4643
9023292,9023286,TXFE7,128,9952,2,8992,4498,4644
9023304,9023297,TXFE7,128,9952,1,8993,4499,4645
9023329,9023320,TXFE7,128,9952,4,8997,4500,4647
9023354,9023343,TXFE7,128,9951,1,8998,4501,4648
9023392,9023380,TXFE7,128,9952,6,9004,4503,4649
9023392,9023380,TXFE7,128,9953,3,9007,4504,4650
9023392,9023388,TXFE7,128,9953,5,9012,4505,4652
9023404,9023396,TXFE7,128,9953,2,9014,4506,4653
9023404,9023397,TXFE7,128,9953,1,9015,4507,4654
9023467,9023456,TXFE7,128,9952,5,9020,4509,4655
9023492,9023480,TXFE7,128,9953,5,9025,4510,4658
9023492,9023485,TXFE7,128,9953,1,9026,4511,4659
9023517,9023512,TXFE7,128,9953,1,9027,4512,4660
9023567,9023560,TXFE7,128,9953,1,9028,4513,4661
9023567,9023566,TXFE7,128,9953,1,9029,4514,4662
9023579,9023578,TXFE7,128,9952,2,9031,4516,4663
9023592,9023585,TXFE7,128,9953,3,9034,4517,4665
9023592,9023587,TXFE7,128,9953,2,9036,4518,4666
9023679,9023678,TXFE7,128,9953,3,9039,4519,4668
9023679,9023679,TXFE7,128,9953,1,9040,4520,4669
9023704,9023692,TXFE7,128,9952,2,9042,4522,4670
9023717,9023705,TXFE7,128,9953,3,9045,4523,4673
9023717,9023711,TXFE7,128,9953,3,9048,4524,4674
9023717,9023715,TXFE7,128,9953,1,9049,4525,4675
9023742,9023730,TXFE7,128,9952,1,9050,4526,4676
9023742,9023731,TXFE7,128,9952,2,9052,4527,4677
9023754,9023751,TXFE7,128,9953,2,9054,4528,4679
9023779,9023772,TXFE7,128,9952,1,9055,4529,4680
9023779,9023777,TXFE7,128,9953,1,9056,4530,4681
9023854,9023846,TXFE7,128,9953,1,9057,4531,4682
9023892,9023887,TXFE7,128,9953,1,9058,4532,4683
9023904,9023903,TXFE7,128,9952,1,9059,4533,4684
9024067,9024063,TXFE7,128,9953,1,9060,4534,4685
9024117,9024114,TXFE7,128,9952,1,9061,4535,4686
9024192,9024185,TXFE7,128,9952,5,9066,4537,4688
9024204,9024196,TXFE7,128,9952,1,9067,4538,4689
9024254,9024242,TXFE7,128,9952,5,9072,4543,4690
9024254,9024245,TXFE7,128,9952,2,9074,4545,4691
9024354,9024348,TXFE7,128,9953,1,9075,4546,4692
9024354,9024352,TXFE7,128,9953,2,9077,4547,4694
9024392,9024382,TXFE7,128,9952,1,9078,4548,4695
9024392,9024391,TXFE7,128,9953,5,9083,4549,4696
9024467,9024465,TXFE7,128,9952,1,9084,4550,4697
9024542,9024540,TXFE7,128,9952,1,9085,4551,4698
9024579,9024572,TXFE7,128,9953,2,9087,4552,4700
9024579,9024576,TXFE7,128,9952,2,9089,4553,4701
9024592,9024587,TXFE7,128,9952,1,9090,4554,4702
9024754,9024751,TXFE7,128,9953,5,9095,4555,4704
9024754,9024752,TXFE7,128,9952,1,9096,4556,4705
9024767,9024758,TXFE7,128,9952,1,9097,4557,4706
9024804,9024804,TXFE7,128,9952,1,9098,4558,4707
9025029,9025018,TXFE7,128,9953,5,9103,4559,4709
9025029,9025020,TXFE7,128,9952,1,9104,4560,4710
9025042,9025037,TXFE7,128,9952,1,9105,4561,4711
9025104,9025095,TXFE7,128,9952,1,9106,4562,4712
9025254,9025251,TXFE7,128,9952,1,9107,4563,4713
9025267,9025259,TXFE7,128,9952,19,9126,4576,4714
9025317,9025306,TXFE7,128,9952,1,9127,4577,4715
9025317,9025309,TXFE7,128,9952,5,9132,4578,4716
9025329,9025317,TXFE7,128,9952,3,9135,4579,4717
9025379,9025371,TXFE7,128,9952,1,9136,4580,4718
9025379,9025379,TXFE7,128,9951,2,9138,4582,4719
9025392,9025383,TXFE7,128,9952,2,9140,4583,4721
9025442,9025441,TXFE7,128,9951,1,9141,4584,4722
9025492,9025489,TXFE7,128,9952,1,9142,4585,4723
9025504,9025494,TXFE7,128,9951,2,9144,4587,4724
9025504,9025504,TXFE7,128,9951,1,9145,4588,4725
9025529,9025524,TXFE7,128,9951,8,9153,4594,4726
9025542,9025530,TXFE7,128,9951,14,9167,4605,4727
9025567,9025564,TXFE7,128,9951,1,9168,4606,4728
9025592,9025589,TXFE7,128,9951,6,9174,4607,4730
9025604,9025596,TXFE7,128,9951,2,9176,4608,4731
9025617,9025611,TXFE7,128,9951,1,9177,4609,4732
9025629,9025617,TXFE7,128,9951,2,9179,4610,4733
9025629,9025626,TXFE7,128,9951,1,9180,4611,4734
9025629,9025629,TXFE7,128,9951,3,9183,4612,4735
9025642,9025632,TXFE7,128,9951,2,9185,4613,4736
9025667,9025659,TXFE7,128,9951,2,9187,4614,4737
9025679,9025678,TXFE7,128,9950,10,9197,4621,4738
9025692,9025680,TXFE7,128,9950,5,9202,4622,4739
9025692,9025688,TXFE7,128,9951,1,9203,4623,4740
9025717,9025710,TXFE7,128,9950,4,9207,4625,4741
9025767,9025765,TXFE7,128,9951,1,9208,4626,4742
9025779,9025779,TXFE7,128,9951,1,9209,4627,4743
9025829,9025817,TXFE7,128,9951,1,9210,4628,4744
9025854,9025845,TXFE7,128,9950,1,9211,4629,4745
9025892,9025891,TXFE7,128,9950,1,9212,4630,4746
9025904,9025898,TXFE7,128,9950,1,9213,4631,4747
9025929,9025922,TXFE7,128,9950,66,9279,4671,4748
9025942,9025930,TXFE7,128,9950,3,9282,4672,4750
9025967,9025966,TXFE7,128,9950,1,9283,4673,4751
9025992,9025990,TXFE7,128,9949,2,9285,4675,4752
9030004,9025993,TXFE7,128,9949,5,9290,4678,4753
9030004,9025997,TXFE7,128,9950,1,9291,4679,4754
9030017,9030008,TXFE7,128,9950,3,9294,4680,4755
9030017,9030015,TXFE7,128,9949,1,9295,4681,4756
9030029,9030017,TXFE7,128,9949,2,9297,4683,4757
9030029,9030023,TXFE7,128,9950,3,9300,4684,4759
9030029,9030025,TXFE7,128,9950,1,9301,4685,4760
9030029,9030025,TXFE7,128,9949,1,9302,4686,4761
9030029,9030027,TXFE7,128,9949,1,9303,4687,4762
9030029,9030027,TXFE7,128,9949,1,9304,4688,4763
9030029,9030029,TXFE7,128,9949,1,9305,4689,4764
9030042,9030031,TXFE7,128,9949,2,9307,4691,4765
9030042,9030033,TXFE7,128,9949,5,9312,4692,4766
9030042,9030034,TXFE7,128,9949,1,9313,4693,4767
9030042,9030034,TXFE7,128,9949,1,9314,4694,4768
9030054,9030044,TXFE7,128,9949,5,9319,4695,4769
9030054,9030045,TXFE7,128,9949,5,9324,4696,4770
9030054,9030047,TXFE7,128,9949,1,9325,4697,4771
9030054,9030048,TXFE7,128,9949,1,9326,4698,4772
9030054,9030048,TXFE7,128,9949,1,9327,4699,4773
9030054,9030050,TXFE7,128,9949,1,9328,4700,4774
9030054,9030050,TXFE7,128,9949,1,9329,4701,4775
9030054,9030054,TXFE7,128,9949,1,9330,4702,4776
9030067,9030055,TXFE7,128,9949,1,9331,4703,4777
9030067,9030057,TXFE7,128,9949,1,9332,4704,4778
9030067,9030059,TXFE7,128,9949,2,9334,4706,4779
9030067,9030063,TXFE7,128,9948,1,9335,4707,4780
9030079,9030068,TXFE7,128,9949,2,9337,4708,4781
9030079,9030071,TXFE7,128,9948,10,9347,4712,4782
9030079,9030077,TXFE7,128,9948,1,9348,4713,4783
9030092,9030080,TXFE7,128,9948,8,9356,4717,4784
9030092,9030089,TXFE7,128,9949,1,9357,4718,4785
9030104,9030092,TXFE7,128,9948,10,9367,4726,4786
9030104,9030102,TXFE7,128,9948,4,9371,4730,4787
9030129,9030128,TXFE7,128,9948,1,9372,4731,4788
9030129,9030129,TXFE7,128,9948,1,9373,4732,4789
9030142,9030131,TXFE7,128,9948,2,9375,4734,4790
9030142,9030133,TXFE7,128,9948,1,9376,4735,4791
9030142,9030136,TXFE7,128,9949,1,9377,4736,4792
9030142,9030137,TXFE7,128,9948,5,9382,4741,4793
9030154,9030143,TXFE7,128,9948,1,9383,4742,4794
9030154,9030144,TXFE7,128,9948,1,9384,4743,4795
9030154,9030149,TXFE7,128,9948,1,9385,4744,4796
9030154,9030149,TXFE7,128,9948,1,9386,4745,4797
9030154,9030154,TXFE7,128,9948,1,9387,4746,4798
9030154,9030154,TXFE7,128,9948,2,9389,4748,4799
9030167,9030158,TXFE7,128,9948,1,9390,4749,4800
9030179,9030169,TXFE7,128,9948,2,9392,4750,4801
9030179,9030176,TXFE7,128,9949,1,9393,4751,4802
9030179,9030179,TXFE7,128,9948,2,9395,4753,4803
9030192,9030185,TXFE7,128,9948,1,9396,4754,4804
9030192,9030187,TXFE7,128,9948,2,9398,4756,4805
9030192,9030189,TXFE7,128,9948,2,9400,4757,4806
9030204,9030203,TXFE7,128,9948,2,9402,4758,4807
9030229,9030218,TXFE7,128,9948,1,9403,4759,4808
9030229,9030221,TXFE7,128,9948,2,9405,4761,4809
9030229,9030223,TXFE7,128,9949,1,9406,4762,4810
9030229,9030228,TXFE7,128,9948,1,9407,4763,4811
9030242,9030239,TXFE7,128,9948,2,9409,4765,4812
9030242,9030240,TXFE7,128,9949,2,9411,4766,4813
9030254,9030248,TXFE7,128,9948,1,9412,4767,4814
9030304,9030295,TXFE7,128,9948,1,9413,4768,4815
9030342,9030331,TXFE7,128,9948,4,9417,4772,4816
9030342,9030332,TXFE7,128,9948,1,9418,4773,4817
9030342,9030333,TXFE7,128,9949,1,9419,4774,4818
9030342,9030339,TXFE7,128,9948,2,9421,4775,4819
9030354,9030347,TXFE7,128,9949,1,9422,4776,4820
9030367,9030359,TXFE7,128,9948,2,9424,4778,4821
9030367,9030366,TXFE7,128,9949,9,9433,4779,4824
9030379,9030374,TXFE7,128,9948,2,9435,4781,4825
9030417,9030409,TXFE7,128,9949,1,9436,4782,4826
9030417,9030410,TXFE7,128,9948,1,9437,4783,4827
9030417,9030413,TXFE7,128,9949,1,9438,4784,4828
9030417,9030413,TXFE7,128,9949,6,9444,4785,4833
9030417,9030413,TXFE7,128,9949,4,9448,4786,4835
9030417,9030413,TXFE7,128,9949,2,9450,4787,4836
9030417,9030413,TXFE7,128,9949,3,9453,4788,4839
9030417,9030413,TXFE7,128,9949,1,9454,4789,4840
9030417,9030413,TXFE7,128,9949,1,9455,4790,4841
9030417,9030413,TXFE7,128,9949,1,9456,4791,4842
9030417,9030413,TXFE7,128,9949,2,9458,4792,4844
9030429,9030420,TXFE7,128,9949,1,9459,4793,4845
9030442,9030432,TXFE7,128,9950,3,9462,4794,4846
9030442,9030436,TXFE7,128,9950,2,9464,4795,4847
9030454,9030443,TXFE7,128,9949,1,9465,4796,4848
9030454,9030446,TXFE7,128,9950,1,9466,4797,4849
9030454,9030447,TXFE7,128,9950,4,9470,4798,4851
9030467,9030461,TXFE7,128,9949,1,9471,4799,4852
9030467,9030463,TXFE7,128,9949,1,9472,4800,4853
9030479,9030468,TXFE7,128,9950,6,9478,4801,4857
9030479,9030475,TXFE7,128,9949,1,9479,4802,4858
9030529,9030520,TXFE7,128,9949,1,9480,4803,4859
9030542,9030540,TXFE7,128,9950,6,9486,4804,4862
9030579,9030567,TXFE7,128,9950,1,9487,4805,4863
9030579,9030572,TXFE7,128,9950,1,9488,4806,4864
9030592,9030582,TXFE7,128,9950,1,9489,4807,4865
9030592,9030586,TXFE7,128,9951,2,9491,4808,4867
9030604,9030602,TXFE7,128,9951,1,9492,4809,4868
9030629,9030627,TXFE7,128,9950,2,9494,4810,4869
9030642,9030640,TXFE7,128,9950,1,9495,4811,4870
9030667,9030656,TXFE7,128,9951,1,9496,4812,4871
9030704,9030701,TXFE7,128,9951,1,9497,4813,4872
9030704,9030703,TXFE7,128,9950,1,9498,4814,4873
9030729,9030725,TXFE7,128,9951,1,9499,4815,4874
9030742,9030730,TXFE7,128,9950,1,9500,4816,4875
9030754,9030742,TXFE7,128,9950,1,9501,4817,4876
9030767,9030758,TXFE7,128,9950,1,9502,4818,4877
9030779,9030767,TXFE7,128,9950,1,9503,4819,4878
9030779,9030777,TXFE7,128,9950,1,9504,4820,4879
9030792,9030779,TXFE7,128,9950,2,9506,4821,4880
9030854,9030843,TXFE7,128,9950,1,9507,4822,4881
9030854,9030846,TXFE7,128,9951,1,9508,4823,4882
9030854,9030848,TXFE7,128,9950,1,9509,4824,4883
9030929,9030922,TXFE7,128,9950,1,9510,4825,4884
9030942,9030930,TXFE7,128,9950,3,9513,4827,4885
9030942,9030932,TXFE7,128,9950,1,9514,4828,4886
9030967,9030961,TXFE7,128,9951,1,9515,4829,4887
9030979,9030970,TXFE7,128,9950,2,9517,4831,4888
9030979,9030971,TXFE7,128,9950,2,9519,4832,4889
9030979,9030973,TXFE7,128,9950,2,9521,4833,4890
9030979,9030975,TXFE7,128,9950,2,9523,4835,4891
9030979,9030976,TXFE7,128,9950,2,9525,4836,4892
9030992,9030980,TXFE7,128,9950,4,9529,4839,4893
9030992,9030980,TXFE7,128,9951,2,9531,4840,4895
9031004,9030994,TXFE7,128,9950,1,9532,4841,4896
9031029,9031018,TXFE7,128,9949,1,9533,4842,4897
9031029,9031021,TXFE7,128,9950,3,9536,4843,4898
9031029,9031026,TXFE7,128,9949,1,9537,4844,4899
9031067,9031055,TXFE7,128,9950,1,9538,4845,4900
9031067,9031056,TXFE7,128,9949,1,9539,4846,4901
9031079,9031078,TXFE7,128,9950,1,9540,4847,4902
9031092,9031080,TXFE7,128,9950,1,9541,4848,4903
9031092,9031092,TXFE7,128,9950,1,9542,4849,4904
9031117,9031109,TXFE7,128,9950,3,9545,4850,4906
9031167,9031164,TXFE7,128,9949,3,9548,4852,4907
9031192,9031188,TXFE7,128,9949,3,9551,4853,4908
9031304,9031293,TXFE7,128,9950,1,9552,4854,4909
9031317,9031315,TXFE7,128,9950,3,9555,4855,4910
9031354,9031349,TXFE7,128,9949,1,9556,4856,4911
9031354,9031352,TXFE7,128,9949,3,9559,4859,4912
9031367,9031360,TXFE7,128,9950,1,9560,4860,4913
9031404,9031395,TXFE7,128,9949,1,9561,4861,4914
9031404,9031397,TXFE7,128,9949,1,9562,4862,4915
9031442,9031437,TXFE7,128,9949,1,9563,4863,4916
9031454,9031447,TXFE7,128,9950,2,9565,4864,4917
9031454,9031450,TXFE7,128,9949,1,9566,4865,4918
9031479,9031472,TXFE7,128,9949,1,9567,4866,4919
9031504,9031492,TXFE7,128,9949,1,9568,4867,4920
9031504,9031495,TXFE7,128,9949,1,9569,4868,4921
9031529,9031519,TXFE7,128,9950,1,9570,4869,4922
9031542,9031534,TXFE7,128,9950,1,9571,4870,4923
9031592,9031582,TXFE7,128,9950,4,9575,4871,4926
9031604,9031600,TXFE7,128,9949,1,9576,4872,4927
9031617,9031604,TXFE7,128,9950,1,9577,4873,4928
9031617,9031614,TXFE7,128,9949,1,9578,4874,4929
9031654,9031650,TXFE7,128,9949,1,9579,4875,4930
9031692,9031687,TXFE7,128,9950,1,9580,4876,4931
9031729,9031722,TXFE7,128,9950,1,9581,4877,4932
9031754,9031745,TXFE7,128,9950,1,9582,4878,4933
9031767,9031757,TXFE7,128,9950,1,9583,4879,4934
9031767,9031761,TXFE7,128,9949,1,9584,4880,4935
9031792,9031787,TXFE7,128,9950,1,9585,4881,4936
9031804,9031794,TXFE7,128,9950,1,9586,4882,4937
9031804,9031797,TXFE7,128,9950,11,9597,4883,4946
9031867,9031859,TXFE7,128,9950,1,9598,4884,4947
9031867,9031865,TXFE7,128,9951,2,9600,4885,4948
9031879,9031878,TXFE7,128,9950,1,9601,4886,4949
9031892,9031880,TXFE7,128,9950,8,9609,4889,4950
9031904,9031897,TXFE7,128,9950,1,9610,4890,4951
9031929,9031917,TXFE7,128,9950,1,9611,4891,4952
9032042,9032032,TXFE7,128,9950,1,9612,4892,4953
9032054,9032049,TXFE7,128,9951,1,9613,4893,4954
9032142,9032138,TXFE7,128,9951,1,9614,4894,4955
9032154,9032146,TXFE7,128,9950,8,9622,4896,4956
9032154,9032153,TXFE7,128,9951,1,9623,4897,4957
9032192,9032181,TXFE7,128,9951,2,9625,4898,4959
9032279,9032277,TXFE7,128,9951,1,9626,4899,4960
9032292,9032286,TXFE7,128,9951,2,9628,4900,4961
9032292,9032289,TXFE7,128,9950,1,9629,4901,4962
9032329,9032325,TXFE7,128,9950,1,9630,4902,4963
9032342,9032333,TXFE7,128,9951,1,9631,4903,4964
9032354,9032350,TXFE7,128,9951,2,9633,4904,4965
9032392,9032384,TXFE7,128,9951,1,9634,4905,4966
9032392,9032390,TXFE7,128,9951,1,9635,4906,4967
9032404,9032400,TXFE7,128,9951,1,9636,4907,4968
9032504,9032501,TXFE7,128,9951,1,9637,4908,4969
9032529,9032517,TXFE7,128,9951,8,9645,4909,4977
9032542,9032536,TXFE7,128,9950,1,9646,4910,4978
9032554,9032542,TXFE7,128,9951,1,9647,4911,4979
9032567,9032557,TXFE7,128,9951,1,9648,4912,4980
9032617,9032605,TXFE7,128,9951,1,9649,4913,4981
9032654,9032643,TXFE7,128,9951,1,9650,4914,4982
9032667,9032665,TXFE7,128,9952,1,9651,4915,4983
9032679,9032667,TXFE7,128,9951,1,9652,4916,4984
9032742,9032736,TXFE7,128,9952,1,9653,4917,4985
9032792,9032784,TXFE7,128,9951,1,9654,4918,4986
9032792,9032789,TXFE7,128,9951,5,9659,4921,4987
9032804,9032795,TXFE7,128,9951,4,9663,4924,4988
9032879,9032873,TXFE7,128,9952,2,9665,4925,4989
9033017,9033014,TXFE7,128,9951,2,9667,4927,4990
9033217,9033216,TXFE7,128,9951,1,9668,4928,4991
9033242,9033241,TXFE7,128,9952,1,9669,4929,4992
9033267,9033258,TXFE7,128,9952,1,9670,4930,4993
9033279,9033267,TXFE7,128,9952,4,9674,4931,4995
9033304,9033292,TXFE7,128,9952,34,9708,4932,5017
9033317,9033309,TXFE7,128,9953,1,9709,4933,5018
9033342,9033330,TXFE7,128,9953,1,9710,4934,5019
9033354,9033342,TXFE7,128,9953,3,9713,4935,5020
9033354,9033342,TXFE7,128,9953,2,9715,4936,5022
9033379,9033378,TXFE7,128,9952,10,9725,4940,5023
9033429,9033423,TXFE7,128,9952,1,9726,4941,5024
9033579,9033576,TXFE7,128,9953,1,9727,4942,5025
9033604,9033601,TXFE7,128,9953,1,9728,4943,5026
9033717,9033705,TXFE7,128,9953,3,9731,4944,5029
9033717,9033708,TXFE7,128,9953,4,9735,4945,5030
9033779,9033768,TXFE7,128,9952,1,9736,4946,5031
9033792,9033784,TXFE7,128,9952,1,9737,4947,5032
9033804,9033795,TXFE7,128,9952,1,9738,4948,5033
9033829,9033824,TXFE7,128,9953,1,9739,4949,5034
9033842,9033832,TXFE7,128,9953,1,9740,4950,5035
9033879,9033875,TXFE7,128,9953,2,9742,4951,5037
9033892,9033883,TXFE7,128,9953,1,9743,4952,5038
9033929,9033918,TXFE7,128,9953,1,9744,4953,5039
9033942,9033937,TXFE7,128,9952,5,9749,4954,5040
9033954,9033945,TXFE7,128,9953,2,9751,4955,5042
9033979,9033969,TXFE7,128,9952,1,9752,4956,5043
9034042,9034032,TXFE7,128,9952,1,9753,4957,5044
9034067,9034059,TXFE7,128,9953,2,9755,4958,5046
9034117,9034117,TXFE7,128,9953,2,9757,4959,5047
9034129,9034119,TXFE7,128,9953,1,9758,4960,5048
9034167,9034157,TXFE7,128,9953,1,9759,4961,5049
9034254,9034243,TXFE7,128,9953,27,9786,4962,5065
9034267,9034266,TXFE7,128,9953,3,9789,4963,5066
9034279,9034269,TXFE7,128,9953,2,9791,4964,5067
9034279,9034279,TXFE7,128,9954,2,9793,4965,5068
9034292,9034282,TXFE7,128,9953,1,9794,4966,5069
9034292,9034287,TXFE7,128,9954,1,9795,4967,5070
9034304,9034299,TXFE7,128,9953,1,9796,4968,5071
9034354,9034353,TXFE7,128,9954,1,9797,4969,5072
9034367,9034358,TXFE7,128,9954,10,9807,4970,5076
9034367,9034364,TXFE7,128,9953,1,9808,4971,5077
9034367,9034366,TXFE7,128,9953,1,9809,4972,5078
9034379,9034371,TXFE7,128,9954,10,9819,4973,5086
9034379,9034379,TXFE7,128,9953,1,9820,4974,5087
9034404,9034398,TXFE7,128,9953,1,9821,4975,5088
9034479,9034468,TXFE7,128,9953,1,9822,4976,5089
9034504,9034499,TXFE7,128,9954,1,9823,4977,5090
9034517,9034512,TXFE7,128,9953,1,9824,4978,5091
9034554,9034545,TXFE7,128,9953,1,9825,4979,5092
9034567,9034561,TXFE7,128,9953,2,9827,4980,5093
9034642,9034632,TXFE7,128,9953,1,9828,4981,5094
9034717,9034708,TXFE7,128,9953,5,9833,4982,5095
9034767,9034754,TXFE7,128,9953,1,9834,4983,5096
9034804,9034795,TXFE7,128,9954,1,9835,4984,5097
9034842,9034840,TXFE7,128,9953,1,9836,4985,5098
9034867,9034863,TXFE7,128,9953,11,9847,4994,5099
9035042,9035033,TXFE7,128,9953,2,9849,4995,5100
9035054,9035053,TXFE7,128,9952,4,9853,4997,5101
9035067,9035057,TXFE7,128,9953,10,9863,4998,5106
9035117,9035113,TXFE7,128,9952,1,9864,4999,5107
9035242,9035236,TXFE7,128,9953,1,9865,5000,5108
9035392,9035380,TXFE7,128,9952,1,9866,5001,5109
9035467,9035462,TXFE7,128,9953,2,9868,5002,5111
9035479,9035474,TXFE7,128,9952,21,9889,5003,5112
9035517,9035505,TXFE7,128,9952,20,9909,5011,5113
9035529,9035517,TXFE7,128,9952,45,9954,5028,5114
9035529,9035518,TXFE7,128,9952,1,9955,5029,5115
9035529,9035518,TXFE7,128,9952,1,9956,5030,5116
9035529,9035521,TXFE7,128,9952,1,9957,5031,5117
9035529,9035522,TXFE7,128,9952,1,9958,5032,5118
9035529,9035523,TXFE7,128,9952,1,9959,5033,5119
9035542,9035529,TXFE7,128,9952,1,9960,5034,5120
9035542,9035529,TXFE7,128,9952,1,9961,5035,5121
9035542,9035531,TXFE7,128,9952,1,9962,5036,5122
9035604,9035594,TXFE7,128,9951,1,9963,5037,5123
9035617,9035608,TXFE7,128,9952,10,9973,5038,5126
9035704,9035698,TXFE7,128,9952,1,9974,5039,5127
9035842,9035831,TXFE7,128,9951,1,9975,5040,5128
9040029,9040018,TXFE7,128,9951,1,9976,5041,5129
9040104,9040097,TXFE7,128,9951,5,9981,5045,5130
9040117,9040104,TXFE7,128,9951,4,9985,5048,5131
9040117,9040110,TXFE7,128,9951,1,9986,5049,5132
9040142,9040134,TXFE7,128,9951,5,9991,5053,5133
9040154,9040145,TXFE7,128,9951,3,9994,5056,5134
9040179,9040178,TXFE7,128,9951,6,10000,5059,5135
9040217,9040205,TXFE7,128,9951,1,10001,5060,5136
9040217,9040215,TXFE7,128,9952,1,10002,5061,5137
9040242,9040240,TXFE7,128,9951,1,10003,5062,5138
9040292,9040280,TXFE7,128,9952,14,10017,5063,5149
9040304,9040295,TXFE7,128,9953,1,10018,5064,5150
9040304,9040298,TXFE7,128,9953,1,10019,5065,5151
9040392,9040389,TXFE7,128,9953,1,10020,5066,5152
9040454,9040443,TXFE7,128,9953,3,10023,5067,5154
9040467,9040455,TXFE7,128,9953,32,10055,5068,5177
9040579,9040567,TXFE7,128,9953,1,10056,5069,5178
9040592,9040583,TXFE7,128,9954,1,10057,5070,5179
9040629,9040629,TXFE7,128,9953,1,10058,5071,5180
9040642,9040630,TXFE7,128,9953,1,10059,5072,5181
9040642,9040630,TXFE7,128,9953,2,10061,5073,5182
9040642,9040640,TXFE7,128,9953,1,10062,5074,5183
9040667,9040662,TXFE7,128,9953,1,10063,5075,5184
9040692,9040690,TXFE7,128,9954,1,10064,5076,5185
9040704,9040698,TXFE7,128,9954,2,10066,5077,5186
9040729,9040724,TXFE7,128,9953,1,10067,5078,5187
9040779,9040767,TXFE7,128,9954,5,10072,5079,5190
9040804,9040793,TXFE7,128,9954,9,10081,5080,5193
9040804,9040801,TXFE7,128,9953,1,10082,5081,5194
9040829,9040828,TXFE7,128,9953,1,10083,5082,5195
9040842,9040836,TXFE7,128,9953,1,10084,5083,5196
9040842,9040841,TXFE7,128,9953,1,10085,5084,5197
9040904,9040900,TXFE7,128,9953,1,10086,5085,5198
9040904,9040904,TXFE7,128,9954,1,10087,5086,5199
9040954,9040954,TXFE7,128,9953,1,10088,5087,5200
9040992,9040985,TXFE7,128,9954,1,10089,5088,5201
9041142,9041138,TXFE7,128,9953,30,10119,5101,5202
9041154,9041142,TXFE7,128,9953,14,10133,5102,5203
9041179,9041173,TXFE7,128,9954,1,10134,5103,5204
9041192,9041190,TXFE7,128,9953,1,10135,5104,5205
9041204,9041192,TXFE7,128,9953,1,10136,5105,5206
9041217,9041209,TXFE7,128,9953,1,10137,5106,5207
9041254,9041242,TXFE7,128,9953,1,10138,5107,5208
9041279,9041269,TXFE7,128,9953,1,10139,5108,5209
9041279,9041271,TXFE7,128,9953,1,10140,5109,5210
9041354,9041352,TXFE7,128,9953,1,10141,5110,5211
9041367,9041364,TXFE7,128,9954,1,10142,5111,5212
9041404,9041392,TXFE7,128,9953,1,10143,5112,5213
9041517,9041505,TXFE7,128,9953,3,10146,5113,5214
9041654,9041650,TXFE7,128,9953,1,10147,5114,5215
9041667,9041665,TXFE7,128,9952,1,10148,5115,5216
9041967,9041959,TXFE7,128,9952,1,10149,5116,5217
9042054,9042050,TXFE7,128,9952,1,10150,5117,5218
9042417,9042414,TXFE7,128,9952,1,10151,5118,5219
9042454,9042452,TXFE7,128,9952,3,10154,5119,5220
9042492,9042480,TXFE7,128,9952,1,10155,5120,5221
9042567,9042557,TXFE7,128,9952,2,10157,5122,5222
9042604,9042595,TXFE7,128,9952,1,10158,5123,5223
9042617,9042607,TXFE7,128,9953,1,10159,5124,5224
9042617,9042611,TXFE7,128,9952,1,10160,5125,5225
9042617,9042617,TXFE7,128,9953,1,10161,5126,5226
9042767,9042760,TXFE7,128,9952,1,10162,5127,5227
9043067,9043064,TXFE7,128,9953,1,10163,5128,5228
9043254,9043252,TXFE7,128,9952,2,10165,5130,5229
9043317,9043313,TXFE7,128,9952,1,10166,5131,5230
9043354,9043353,TXFE7,128,9952,2,10168,5132,5231
9043379,9043378,TXFE7,128,9952,1,10169,5133,5232
9043454,9043450,TXFE7,128,9952,1,10170,5134,5233
9043504,9043499,TXFE7,128,9952,1,10171,5135,5234
9043554,9043543,TXFE7,128,9952,3,10174,5137,5235
9043704,9043702,TXFE7,128,9952,1,10175,5138,5236
9043779,9043772,TXFE7,128,9953,1,10176,5139,5237
9043779,9043778,TXFE7,128,9952,1,10177,5140,5238
9043804,9043803,TXFE7,128,9953,1,10178,5141,5239
9043867,9043867,TXFE7,128,9953,2,10180,5142,5241
9043954,9043948,TXFE7,128,9952,1,10181,5143,5242
9043992,9043984,TXFE7,128,9952,4,10185,5147,5243
9043992,9043984,TXFE7,128,9952,1,10186,5148,5244
9044017,9044007,TXFE7,128,9952,5,10191,5153,5245
9044067,9044061,TXFE7,128,9952,2,10193,5154,5247
9044142,9044136,TXFE7,128,9951,2,10195,5156,5248
9044292,9044290,TXFE7,128,9951,1,10196,5157,5249
9044517,9044508,TXFE7,128,9952,1,10197,5158,5250
9044517,9044516,TXFE7,128,9951,1,10198,5159,5251
9044567,9044562,TXFE7,128,9951,2,10200,5160,5252
9044642,9044641,TXFE7,128,9951,1,10201,5161,5253
9044667,9044661,TXFE7,128,9951,1,10202,5162,5254
9044929,9044919,TXFE7,128,9952,2,10204,5163,5256
9045342,9045335,TXFE7,128,9952,2,10206,5164,5258
9045354,9045344,TXFE7,128,9951,5,10211,5168,5259
9045354,9045348,TXFE7,128,9952,3,10214,5169,5260
9045367,9045363,TXFE7,128,9951,5,10219,5173,5261
9045567,9045556,TXFE7,128,9951,2,10221,5175,5262
9045592,9045582,TXFE7,128,9952,9,10230,5176,5269
9045604,9045592,TXFE7,128,9952,1,10231,5177,5270
9045679,9045670,TXFE7,128,9951,5,10236,5179,5271
9045804,9045801,TXFE7,128,9952,1,10237,5180,5272
9045829,9045819,TXFE7,128,9952,1,10238,5181,5273
9045879,9045878,TXFE7,128,9952,1,10239,5182,5274
9045979,9045967,TXFE7,128,9951,1,10240,5183,5275
9045979,9045978,TXFE7,128,9951,10,10250,5193,5276
9050029,9050017,TXFE7,128,9951,1,10251,5194,5277
9050042,9050034,TXFE7,128,9951,1,10252,5195,5278
9050054,9050045,TXFE7,128,9950,5,10257,5200,5279
9050054,9050050,TXFE7,128,9952,2,10259,5201,5281
9050067,9050063,TXFE7,128,9951,1,10260,5202,5282
9050092,9050079,TXFE7,128,9951,1,10261,5203,5283
9050117,9050109,TXFE7,128,9951,1,10262,5204,5284
9050117,9050111,TXFE7,128,9951,1,10263,5205,5285
9050142,9050138,TXFE7,128,9950,1,10264,5206,5286
9050167,9050156,TXFE7,128,9951,1,10265,5207,5287
9050167,9050158,TXFE7,128,9950,3,10268,5210,5288
9050167,9050164,TXFE7,128,9950,31,10299,5229,5289
9050192,9050189,TXFE7,128,9951,30,10329,5230,5301
9050217,9050204,TXFE7,128,9951,4,10333,5231,5303
9050229,9050217,TXFE7,128,9951,1,10334,5232,5304
9050229,9050224,TXFE7,128,9950,5,10339,5237,5305
9050317,9050307,TXFE7,128,9950,1,10340,5238,5306
9050329,9050328,TXFE7,128,9950,3,10343,5240,5307
9050342,9050330,TXFE7,128,9950,1,10344,5241,5308
9050342,9050335,TXFE7,128,9950,5,10349,5246,5309
9050354,9050344,TXFE7,128,9950,1,10350,5247,5310
9050354,9050348,TXFE7,128,9951,1,10351,5248,5311
9050367,9050359,TXFE7,128,9950,1,10352,5249,5312
9050379,9050373,TXFE7,128,9950,1,10353,5250,5313
9050379,9050376,TXFE7,128,9950,1,10354,5251,5314
9050392,9050390,TXFE7,128,9950,1,10355,5252,5315
9050404,9050401,TXFE7,128,9950,1,10356,5253,5316
9050404,9050402,TXFE7,128,9951,1,10357,5254,5317
9050417,9050405,TXFE7,128,9950,1,10358,5255,5318
9050429,9050420,TXFE7,128,9950,1,10359,5256,5319
9050442,9050436,TXFE7,128,9950,1,10360,5257,5320
9050442,9050436,TXFE7,128,9950,5,10365,5261,5321
9050454,9050453,TXFE7,128,9950,1,10366,5262,5322
9050479,9050468,TXFE7,128,9951,5,10371,5263,5324
9050479,9050470,TXFE7,128,9950,1,10372,5264,5325
9050479,9050478,TXFE7,128,9950,1,10373,5265,5326
9050492,9050486,TXFE7,128,9950,1,10374,5266,5327
9050517,9050515,TXFE7,128,9950,2,10376,5268,5328
9050529,9050520,TXFE7,128,9950,1,10377,5269,5329
9050529,9050526,TXFE7,128,9950,1,10378,5270,5330
9050542,9050541,TXFE7,128,9950,2,10380,5272,5331
9050554,9050553,TXFE7,128,9950,2,10382,5274,5332
9050567,9050555,TXFE7,128,9950,2,10384,5275,5333
9050579,9050572,TXFE7,128,9950,2,10386,5277,5334
9050604,9050592,TXFE7,128,9950,2,10388,5279,5335
9050604,9050593,TXFE7,128,9950,2,10390,5280,5336
9050604,9050594,TXFE7,128,9950,1,10391,5281,5337
9050604,9050599,TXFE7,128,9951,1,10392,5282,5338
9050629,9050627,TXFE7,128,9950,2,10394,5283,5339
9050679,9050675,TXFE7,128,9950,3,10397,5284,5340
9050679,9050679,TXFE7,128,9950,1,10398,5285,5341
9050692,9050680,TXFE7,128,9950,1,10399,5286,5342
9050829,9050823,TXFE7,128,9950,1,10400,5287,5343
9050879,9050868,TXFE7,128,9950,1,10401,5288,5344
9050917,9050906,TXFE7,128,9950,2,10403,5290,5345
9050942,9050941,TXFE7,128,9950,1,10404,5291,5346
9050979,9050969,TXFE7,128,9950,1,10405,5292,5347
9051004,9050996,TXFE7,128,9950,2,10407,5293,5348
9051017,9051011,TXFE7,128,9950,1,10408,5294,5349
9051017,9051015,TXFE7,128,9950,6,10414,5298,5350
9051029,9051028,TXFE7,128,9950,1,10415,5299,5351
9051042,9051031,TXFE7,128,9950,1,10416,5300,5352
9051042,9051038,TXFE7,128,9949,1,10417,5301,5353
9051054,9051042,TXFE7,128,9950,1,10418,5302,5354
9051054,9051046,TXFE7,128,9949,3,10421,5304,5355
9051092,9051090,TXFE7,128,9950,1,10422,5305,5356
9051117,9051115,TXFE7,128,9950,1,10423,5306,5357
9051154,9051151,TXFE7,128,9950,4,10427,5307,5360
9051179,9051172,TXFE7,129,9950,1,10429,5309,5361
9051179,9051172,TXFE7,129,9949,1,10429,5309,5361
9051192,9051186,TXFE7,128,9950,1,10430,5310,5362
9051279,9051269,TXFE7,128,9949,2,10432,5311,5363
9051279,9051272,TXFE7,128,9949,1,10433,5312,5364
9051292,9051285,TXFE7,128,9950,1,10434,5313,5365
9051304,9051295,TXFE7,128,9949,1,10435,5314,5366
9051317,9051308,TXFE7,128,9949,1,10436,5315,5367
9051317,9051314,TXFE7,128,9950,1,10437,5316,5368
9051392,9051390,TXFE7,128,9949,2,10439,5318,5369
9051442,9051435,TXFE7,128,9950,1,10440,5319,5370
9051454,9051446,TXFE7,128,9949,2,10442,5320,5371
9051542,9051533,TXFE7,128,9949,4,10446,5322,5372
9051542,9051537,TXFE7,128,9950,1,10447,5323,5373
9051604,9051597,TXFE7,128,9949,2,10449,5324,5374
9051642,9051630,TXFE7,128,9950,1,10450,5325,5375
9051654,9051643,TXFE7,128,9949,1,10451,5326,5376
9051654,9051652,TXFE7,128,9950,1,10452,5327,5377
9051679,9051673,TXFE7,128,9949,1,10453,5328,5378
9051679,9051675,TXFE7,128,9950,1,10454,5329,5379
9051704,9051694,TXFE7,128,9949,3,10457,5332,5380
9051729,9051724,TXFE7,128,9949,1,10458,5333,5381
9051767,9051764,TXFE7,128,9949,25,10483,5337,5382
9051842,9051837,TXFE7,128,9949,1,10484,5338,5383
9051854,9051852,TXFE7,128,9949,2,10486,5340,5384
9051854,9051854,TXFE7,128,9949,1,10487,5341,5385
9051929,9051929,TXFE7,128,9949,2,10489,5343,5386
9051942,9051931,TXFE7,128,9950,1,10490,5344,5387
9051967,9051955,TXFE7,128,9949,1,10491,5345,5388
9051992,9051987,TXFE7,128,9949,1,10492,5346,5389
9052004,9052002,TXFE7,128,9949,1,10493,5347,5390
9052054,9052049,TXFE7,128,9949,2,10495,5348,5391
9052092,9052084,TXFE7,128,9949,2,10497,5349,5392
9052092,9052085,TXFE7,128,9949,4,10501,5350,5393
9052117,9052105,TXFE7,128,9949,4,10505,5351,5394
9052142,9052132,TXFE7,128,9949,1,10506,5352,5395
9052154,9052152,TXFE7,128,9949,1,10507,5353,5396
9052179,9052172,TXFE7,128,9950,3,10510,5354,5398
9052179,9052176,TXFE7,128,9950,1,10511,5355,5399
9052179,9052178,TXFE7,128,9949,2,10513,5356,5400
9052217,9052205,TXFE7,128,9949,1,10514,5357,5401
9052229,9052220,TXFE7,128,9949,3,10517,5358,5402
9052242,9052240,TXFE7,128,9949,1,10518,5359,5403
9052254,9052249,TXFE7,128,9950,1,10519,5360,5404
9052292,9052284,TXFE7,128,9949,2,10521,5361,5405
9052304,9052293,TXFE7,128,9949,1,10522,5362,5406
9052304,9052297,TXFE7,128,9949,1,10523,5363,5407
9052304,9052298,TXFE7,128,9950,1,10524,5364,5408
9052304,9052301,TXFE7,128,9949,1,10525,5365,5409
9052317,9052308,TXFE7,128,9949,1,10526,5366,5410
9052379,9052367,TXFE7,128,9949,1,10527,5367,5411
9052379,9052373,TXFE7,128,9949,5,10532,5368,5412
9052429,9052420,TXFE7,128,9949,1,10533,5369,5413
9052454,9052442,TXFE7,128,9950,35,10568,5370,5441
9052454,9052448,TXFE7,128,9949,1,10569,5371,5442
9052454,9052448,TXFE7,128,9950,1,10570,5372,5443
9052517,9052504,TXFE7,128,9950,1,10571,5373,5444
9052517,9052509,TXFE7,128,9950,1,10572,5374,5445
9052567,9052565,TXFE7,128,9950,1,10573,5375,5446
9052617,9052604,TXFE7,128,9950,1,10574,5376,5447
9052642,9052641,TXFE7,128,9950,1,10575,5377,5448
9052742,9052731,TXFE7,128,9950,2,10577,5378,5449
9052829,9052822,TXFE7,128,9950,2,10579,5380,5450
9052829,9052826,TXFE7,128,9950,1,10580,5381,5451
9052842,9052829,TXFE7,128,9950,1,10581,5382,5452
9052842,9052830,TXFE7,128,9950,2,10583,5383,5453
9052842,9052838,TXFE7,128,9949,1,10584,5384,5454
9052879,9052875,TXFE7,128,9949,1,10585,5385,5455
9052992,9052989,TXFE7,128,9949,1,10586,5386,5456
9053017,9053008,TXFE7,128,9950,9,10595,5387,5459
9053042,9053039,TXFE7,128,9949,1,10596,5388,5460
9053179,9053170,TXFE7,128,9949,1,10597,5389,5461
9053304,9053295,TXFE7,128,9949,2,10599,5390,5462
9053342,9053330,TXFE7,128,9950,1,10600,5391,5463
9053367,9053356,TXFE7,128,9949,3,10603,5393,5464
9053367,9053363,TXFE7,128,9950,1,10604,5394,5465
9053417,9053408,TXFE7,128,9949,1,10605,5395,5466
9053417,9053415,TXFE7,128,9949,1,10606,5396,5467
9053467,9053460,TXFE7,128,9950,1,10607,5397,5468
9053654,9053646,TXFE7,128,9950,1,10608,5398,5469
9053692,9053688,TXFE7,128,9949,3,10611,5401,5470
9053742,9053739,TXFE7,128,9949,28,10639,5423,5471
9053754,9053742,TXFE7,128,9949,2,10641,5424,5472
9053779,9053776,TXFE7,128,9949,1,10642,5425,5473
9053817,9053812,TXFE7,128,9948,5,10647,5428,5474
9053829,9053828,TXFE7,128,9949,2,10649,5429,5475
9053842,9053832,TXFE7,128,9948,2,10651,5431,5476
9053842,9053833,TXFE7,128,9948,1,10652,5432,5477
9053854,9053849,TXFE7,128,9948,2,10654,5434,5478
9053854,9053850,TXFE7,128,9948,2,10656,5435,5479
9053854,9053850,TXFE7,128,9948,1,10657,5436,5480
9053854,9053854,TXFE7,128,9948,1,10658,5437,5481
9053879,9053878,TXFE7,128,9948,1,10659,5438,5482
9053954,9053943,TXFE7,128,9948,2,10661,5440,5483
9053979,9053976,TXFE7,128,9948,1,10662,5441,5484
9053992,9053992,TXFE7,128,9948,25,10687,5455,5485
9054004,9053992,TXFE7,128,9948,1,10688,5456,5486
9054004,9054001,TXFE7,128,9949,1,10689,5457,5487
9054017,9054005,TXFE7,128,9949,1,10690,5458,5488
9054029,9054028,TXFE7,128,9948,6,10696,5462,5489
9054042,9054041,TXFE7,128,9948,3,10699,5463,5490
9054054,9054047,TXFE7,128,9948,1,10700,5464,5491
9054092,9054080,TXFE7,128,9949,1,10701,5465,5492
9054092,9054082,TXFE7,128,9948,1,10702,5466,5493
9054092,9054091,TXFE7,128,9948,1,10703,5467,5494
9054092,9054091,TXFE7,128,9948,1,10704,5468,5495
9054104,9054099,TXFE7,128,9948,1,10705,5469,5496
9054129,9054121,TXFE7,128,9948,11,10716,5477,5497
9054129,9054122,TXFE7,128,9949,1,10717,5478,5498
9054129,9054123,TXFE7,128,9948,5,10722,5482,5499
9054167,9054162,TXFE7,128,9948,2,10724,5484,5500
9054179,9054174,TXFE7,128,9948,1,10725,5485,5501
9054192,9054180,TXFE7,128,9948,1,10726,5486,5502
9054192,9054180,TXFE7,128,9948,1,10727,5487,5503
9054192,9054181,TXFE7,128,9948,1,10728,5488,5504
9054192,9054188,TXFE7,128,9948,1,10729,5489,5505
9054204,9054194,TXFE7,128,9948,1,10730,5490,5506
9054229,9054229,TXFE7,128,9948,1,10731,5491,5507
9054267,9054264,TXFE7,128,9948,3,10734,5493,5508
9054279,9054270,TXFE7,128,9949,1,10735,5494,5509
9054304,9054294,TXFE7,128,9948,1,10736,5495,5510
9054317,9054313,TXFE7,128,9948,1,10737,5496,5511
9054329,9054319,TXFE7,128,9948,1,10738,5497,5512
9054329,9054325,TXFE7,128,9948,1,10739,5498,5513
9054342,9054336,TXFE7,128,9948,1,10740,5499,5514
9054379,9054371,TXFE7,128,9948,1,10741,5500,5515
9054417,9054413,TXFE7,128,9948,1,10742,5501,5516
9054442,9054435,TXFE7,128,9948,4,10746,5504,5517
9054442,9054441,TXFE7,128,9948,1,10747,5505,5518
9054467,9054456,TXFE7,128,9948,1,10748,5506,5519
9054467,9054459,TXFE7,128,9948,1,10749,5507,5520
9054492,9054492,TXFE7,128,9948,1,10750,5508,5521
9054504,9054502,TXFE7,128,9948,1,10751,5509,5522
9054542,9054533,TXFE7,128,9948,3,10754,5512,5523
9054604,9054592,TXFE7,128,9949,4,10758,5513,5527
9054617,9054605,TXFE7,128,9949,17,10775,5514,5538
9054629,9054623,TXFE7,128,9949,1,10776,5515,5539
9054642,9054635,TXFE7,128,9949,27,10803,5523,5540
9054692,9054682,TXFE7,128,9949,1,10804,5524,5541
9054717,9054705,TXFE7,128,9949,1,10805,5525,5542
9054717,9054712,TXFE7,128,9949,1,10806,5526,5543
9054804,9054795,TXFE7,128,9949,3,10809,5529,5544
9054817,9054810,TXFE7,129,9949,23,10836,5539,5545
9054817,9054810,TXFE7,129,9948,4,10836,5539,5545
9054917,9054910,TXFE7,128,9948,1,10837,5540,5546
9054929,9054923,TXFE7,128,9948,27,10864,5545,5547
9054979,9054977,TXFE7,128,9949,3,10867,5546,5548
9055029,9055025,TXFE7,128,9949,2,10869,5547,5550
9055042,9055030,TXFE7,128,9949,2,10871,5548,5551
9055067,9055059,TXFE7,128,9949,1,10872,5549,5552
9055117,9055107,TXFE7,128,9949,1,10873,5550,5553
9055217,9055207,TXFE7,128,9949,1,10874,5551,5554
9055229,9055221,TXFE7,128,9949,1,10875,5552,5555
9055242,9055239,TXFE7,128,9949,1,10876,5553,5556
9055254,9055250,TXFE7,128,9950,1,10877,5554,5557
9055254,9055250,TXFE7,128,9949,5,10882,5556,5558
9055342,9055333,TXFE7,128,9949,2,10884,5557,5559
9055354,9055351,TXFE7,128,9950,1,10885,5558,5560
9055429,9055424,TXFE7,128,9950,1,10886,5559,5561
9055479,9055469,TXFE7,128,9949,1,10887,5560,5562
9055479,9055472,TXFE7,128,9949,1,10888,5561,5563
9055542,9055541,TXFE7,128,9949,11,10899,5562,5564
9055579,9055579,TXFE7,128,9949,2,10901,5563,5565
9055829,9055829,TXFE7,128,9949,1,10902,5564,5566
9055979,9055968,TXFE7,128,9950,1,10903,5565,5567
9055979,9055976,TXFE7,128,9949,1,10904,5566,5568
9055979,9055978,TXFE7,128,9949,1,10905,5567,5569
9060029,9060024,TXFE7,128,9949,1,10906,5568,5570
9060042,9060031,TXFE7,128,9950,2,10908,5569,5572
9060079,9060068,TXFE7,128,9950,1,10909,5570,5573
9060092,9060091,TXFE7,128,9949,1,10910,5571,5574
9060117,9060116,TXFE7,128,9949,1,10911,5572,5575
9060142,9060140,TXFE7,128,9949,1,10912,5573,5576
9060167,9060154,TXFE7,128,9949,3,10915,5575,5577
9060254,9060249,TXFE7,128,9949,1,10916,5576,5578
9060392,9060382,TXFE7,128,9949,1,10917,5577,5579
9060479,9060475,TXFE7,128,9950,9,10926,5578,5586
9060542,9060533,TXFE7,128,9950,9,10935,5579,5594
9060579,9060576,TXFE7,128,9949,1,10936,5580,5595
9060592,9060587,TXFE7,128,9950,9,10945,5581,5598
9060717,9060712,TXFE7,128,9949,1,10946,5582,5599
9060729,9060722,TXFE7,128,9949,1,10947,5583,5600
9060817,9060814,TXFE7,128,9950,9,10956,5584,5602
9060904,9060894,TXFE7,128,9949,1,10957,5585,5603
9060979,9060969,TXFE7,128,9949,2,10959,5587,5604
9061004,9060994,TXFE7,128,9949,5,10964,5591,5605
9061067,9061066,TXFE7,128,9949,4,10968,5595,5606
9061142,9061136,TXFE7,128,9950,2,10970,5596,5608
9061154,9061153,TXFE7,128,9949,1,10971,5597,5609
9061217,9061208,TXFE7,128,9949,2,10973,5599,5610
9061217,9061216,TXFE7,128,9949,3,10976,5601,5611
9061229,9061217,TXFE7,128,9949,1,10977,5602,5612
9061229,9061217,TXFE7,128,9949,2,10979,5604,5613
9061242,9061229,TXFE7,128,9949,1,10980,5605,5614
9061242,9061229,TXFE7,128,9949,6,10986,5607,5615
9061254,9061253,TXFE7,128,9948,1,10987,5608,5616
9061279,9061270,TXFE7,128,9948,2,10989,5610,5617
9061279,9061277,TXFE7,128,9948,1,10990,5611,5618
9061292,9061282,TXFE7,128,9948,3,10993,5614,5619
9061304,9061297,TXFE7,128,9948,1,10994,5615,5620
9061317,9061316,TXFE7,128,9948,2,10996,5617,5621
9061329,9061321,TXFE7,128,9948,3,10999,5619,5622
9061354,9061351,TXFE7,128,9948,10,11009,5626,5623
9061367,9061354,TXFE7,128,9948,8,11017,5631,5624
9061367,9061354,TXFE7,128,9948,4,11021,5632,5625
9061367,9061360,TXFE7,128,9948,5,11026,5633,5626
9061367,9061360,TXFE7,128,9948,1,11027,5634,5627
9061379,9061367,TXFE7,128,9948,3,11030,5636,5628
9061379,9061367,TXFE7,128,9948,2,11032,5638,5629
9061379,9061367,TXFE7,128,9948,1,11033,5639,5630
9061379,9061367,TXFE7,128,9948,2,11035,5641,5631
9061392,9061385,TXFE7,128,9947,8,11043,5648,5632
9061392,9061390,TXFE7,128,9947,1,11044,5649,5633
9061404,9061394,TXFE7,128,9947,1,11045,5650,5634
9061404,9061397,TXFE7,128,9947,2,11047,5651,5635
9061404,9061398,TXFE7,128,9947,1,11048,5652,5636
9061417,9061405,TXFE7,128,9947,1,11049,5653,5637
9061417,9061406,TXFE7,128,9947,1,11050,5654,5638
9061417,9061408,TXFE7,128,9947,2,11052,5656,5639
9061429,9061419,TXFE7,128,9947,6,11058,5662,5640
9061442,9061430,TXFE7,128,9947,3,11061,5664,5641
9061442,9061436,TXFE7,128,9948,1,11062,5665,5642
9061454,9061445,TXFE7,128,9947,1,11063,5666,5643
9061454,9061447,TXFE7,128,9947,1,11064,5667,5644
9061454,9061448,TXFE7,128,9948,1,11065,5668,5645
9061467,9061455,TXFE7,128,9947,3,11068,5671,5646
9061467,9061463,TXFE7,128,9948,1,11069,5672,5647
9061479,9061473,TXFE7,128,9948,1,11070,5673,5648
9061479,9061475,TXFE7,128,9947,1,11071,5674,5649
9061479,9061479,TXFE7,128,9947,3,11074,5676,5650
9061504,9061501,TXFE7,128,9947,3,11077,5679,5651
9061517,9061506,TXFE7,128,9947,1,11078,5680,5652
9061517,9061512,TXFE7,128,9947,1,11079,5681,5653
9061517,9061513,TXFE7,128,9947,1,11080,5682,5654
9061517,9061514,TXFE7,128,9947,1,11081,5683,5655
9061554,9061543,TXFE7,128,9947,1,11082,5684,5656
9061554,9061544,TXFE7,128,9947,2,11084,5685,5657
9061554,9061547,TXFE7,128,9947,1,11085,5686,5658
9061554,9061547,TXFE7,128,9947,1,11086,5687,5659
9061554,9061548,TXFE7,128,9947,2,11088,5688,5660
9061554,9061550,TXFE7,128,9947,2,11090,5690,5661
9061567,9061558,TXFE7,128,9947,3,11093,5692,5662
9061567,9061566,TXFE7,128,9947,5,11098,5696,5663
9061579,9061567,TXFE7,128,9947,7,11105,5703,5664
9061604,9061600,TXFE7,128,9948,1,11106,5704,5665
9061604,9061604,TXFE7,128,9947,5,11111,5709,5666
9061617,9061606,TXFE7,128,9948,1,11112,5710,5667
9061617,9061612,TXFE7,128,9947,2,11114,5711,5668
9061617,9061615,TXFE7,128,9947,1,11115,5712,5669
9061629,9061621,TXFE7,128,9947,1,11116,5713,5670
9061642,9061633,TXFE7,128,9946,3,11119,5715,5671
9061642,9061638,TXFE7,128,9947,1,11120,5716,5672
9061654,9061642,TXFE7,128,9947,2,11122,5717,5673
9061654,9061642,TXFE7,128,9946,1,11123,5718,5674
9061654,9061646,TXFE7,128,9946,5,11128,5721,5675
9061654,9061647,TXFE7,128,9946,3,11131,5724,5676
9061654,9061649,TXFE7,128,9946,1,11132,5725,5677
9061667,9061663,TXFE7,128,9946,1,11133,5726,5678
9061667,9061665,TXFE7,128,9946,1,11134,5727,5679
9061667,9061666,TXFE7,128,9946,1,11135,5728,5680
9061667,9061666,TXFE7,128,9946,2,11137,5730,5681
9061679,9061672,TXFE7,128,9947,13,11150,5731,5686
9061679,9061674,TXFE7,128,9946,1,11151,5732,5687
9061679,9061677,TXFE7,128,9947,5,11156,5733,5690
9061692,9061679,TXFE7,128,9947,1,11157,5734,5691
9061692,9061689,TXFE7,128,9946,1,11158,5735,5692
9061704,9061692,TXFE7,128,9947,1,11159,5736,5693
9061729,9061722,TXFE7,128,9947,1,11160,5737,5694
9061729,9061726,TXFE7,128,9946,5,11165,5742,5695
9061742,9061731,TXFE7,128,9946,1,11166,5743,5696
9061742,9061741,TXFE7,128,9947,1,11167,5744,5697
9061754,9061746,TXFE7,128,9947,1,11168,5745,5698
9061779,9061770,TXFE7,128,9947,1,11169,5746,5699
9061792,9061789,TXFE7,128,9947,3,11172,5747,5700
9061817,9061806,TXFE7,128,9947,2,11174,5749,5701
9061817,9061813,TXFE7,128,9947,1,11175,5750,5702
9061817,9061816,TXFE7,128,9947,1,11176,5751,5703
9061829,9061818,TXFE7,128,9947,1,11177,5752,5704
9061842,9061836,TXFE7,128,9948,2,11179,5753,5705
9061842,9061838,TXFE7,128,9947,1,11180,5754,5706
9061879,9061874,TXFE7,128,9947,1,11181,5755,5707
9061904,9061893,TXFE7,128,9947,1,11182,5756,5708
9061904,9061893,TXFE7,128,9947,1,11183,5757,5709
9061979,9061970,TXFE7,128,9947,1,11184,5758,5710
9061992,9061980,TXFE7,128,9947,1,11185,5759,5711
9062017,9062005,TXFE7,128,9947,1,11186,5760,5712
9062042,9062040,TXFE7,128,9947,1,11187,5761,5713
9062054,9062045,TXFE7,128,9947,2,11189,5763,5714
9062054,9062048,TXFE7,128,9948,6,11195,5764,5718
9062054,9062048,TXFE7,128,9947,2,11197,5765,5719
9062154,9062150,TXFE7,128,9947,1,11198,5766,5720
9062179,9062176,TXFE7,128,9947,6,11204,5770,5721
9062192,9062186,TXFE7,128,9947,1,11205,5771,5722
9062192,9062187,TXFE7,128,9947,3,11208,5772,5723
9062192,9062191,TXFE7,128,9947,1,11209,5773,5724
9062204,9062199,TXFE7,128,9947,1,11210,5774,5725
9062217,9062210,TXFE7,128,9947,12,11222,5782,5726
9062254,9062253,TXFE7,128,9947,1,11223,5783,5727
9062267,9062255,TXFE7,128,9947,1,11224,5784,5728
9062267,9062260,TXFE7,128,9946,2,11226,5786,5729
9062292,9062282,TXFE7,128,9946,1,11227,5787,5730
9062317,9062305,TXFE7,128,9946,1,11228,5788,5731
9062317,9062315,TXFE7,128,9946,1,11229,5789,5732
9062329,9062328,TXFE7,128,9946,1,11230,5790,5733
9062342,9062337,TXFE7,128,9946,1,11231,5791,5734
9062354,9062353,TXFE7,128,9946,1,11232,5792,5735
9062404,9062401,TXFE7,128,9946,2,11234,5793,5736
9062417,9062405,TXFE7,128,9946,1,11235,5794,5737
9062417,9062415,TXFE7,128,9946,1,11236,5795,5738
9062442,9062442,TXFE7,128,9946,15,11251,5798,5739
9062454,9062446,TXFE7,128,9946,2,11253,5799,5740
9062454,9062447,TXFE7,128,9946,10,11263,5800,5741
9062454,9062448,TXFE7,128,9947,46,11309,5801,5757
9062467,9062455,TXFE7,128,9946,3,11312,5804,5758
9062479,9062473,TXFE7,128,9946,1,11313,5805,5759
9062504,9062492,TXFE7,128,9946,5,11318,5809,5760
9062504,9062494,TXFE7,128,9946,2,11320,5811,5761
9062529,9062527,TXFE7,128,9946,24,11344,5827,5762
9062542,9062529,TXFE7,128,9946,1,11345,5828,5763
9062542,9062534,TXFE7,128,9946,1,11346,5829,5764
9062542,9062539,TXFE7,128,9945,24,11370,5845,5765
9062554,9062547,TXFE7,128,9945,1,11371,5846,5766
9062554,9062549,TXFE7,128,9945,2,11373,5847,5767
9062554,9062549,TXFE7,128,9945,24,11397,5862,5768
9062554,9062550,TXFE7,128,9945,2,11399,5863,5769
9062554,9062550,TXFE7,128,9945,1,11400,5864,5770
9062554,9062552,TXFE7,128,9945,1,11401,5865,5771
9062567,9062557,TXFE7,128,9945,1,11402,5866,5772
9062567,9062560,TXFE7,128,9946,2,11404,5867,5774
9062567,9062565,TXFE7,128,9945,1,11405,5868,5775
9062567,9062566,TXFE7,128,9946,1,11406,5869,5776
9062579,9062572,TXFE7,128,9945,1,11407,5870,5777
9062579,9062577,TXFE7,128,9945,1,11408,5871,5778
9062579,9062577,TXFE7,128,9945,2,11410,5873,5779
9062592,9062581,TXFE7,128,9946,1,11411,5874,5780
9062592,9062582,TXFE7,128,9945,1,11412,5875,5781
9062592,9062584,TXFE7,128,9945,1,11413,5876,5782
9062592,9062589,TXFE7,128,9945,1,11414,5877,5783
9062604,9062592,TXFE7,128,9945,1,11415,5878,5784
9062604,9062598,TXFE7,128,9945,1,11416,5879,5785
9062604,9062599,TXFE7,128,9945,1,11417,5880,5786
9062617,9062607,TXFE7,128,9945,2,11419,5882,5787
9062617,9062609,TXFE7,128,9945,1,11420,5883,5788
9062617,9062611,TXFE7,128,9945,10,11430,5888,5789
9062617,9062615,TXFE7,128,9945,6,11436,5893,5790
9062617,9062616,TXFE7,128,9945,6,11442,5894,5791
9062617,9062617,TXFE7,128,9945,1,11443,5895,5792
9062629,9062617,TXFE7,128,9945,5,11448,5898,5793
9062629,9062617,TXFE7,128,9945,6,11454,5903,5794
9062629,9062617,TXFE7,128,9945,4,11458,5906,5795
9062629,9062617,TXFE7,128,9945,2,11460,5908,5796
9062629,9062617,TXFE7,128,9945,8,11468,5914,5797
9062629,9062618,TXFE7,128,9944,1,11469,5915,5798
9062629,9062625,TXFE7,128,9944,2,11471,5917,5799
9062629,9062626,TXFE7,128,9944,1,11472,5918,5800
9062642,9062631,TXFE7,128,9944,1,11473,5919,5801
9062642,9062632,TXFE7,128,9944,2,11475,5921,5802
9062642,9062633,TXFE7,128,9944,10,11485,5929,5803
9062642,9062634,TXFE7,128,9945,2,11487,5930,5805
9062642,9062634,TXFE7,128,9944,2,11489,5931,5806
9062642,9062635,TXFE7,128,9944,4,11493,5932,5807
9062642,9062635,TXFE7,128,9944,2,11495,5933,5808
9062642,9062636,TXFE7,128,9944,2,11497,5935,5809
9062642,9062637,TXFE7,128,9944,1,11498,5936,5810
9062642,9062639,TXFE7,128,9944,2,11500,5938,5811
9062654,9062642,TXFE7,129,9944,6,11509,5944,5812
9062654,9062642,TXFE7,129,9943,3,11509,5944,5812
9062654,9062645,TXFE7,128,9944,2,11511,5945,5813
9062654,9062646,TXFE7,128,9944,5,11516,5946,5814
9062654,9062647,TXFE7,128,9944,5,11521,5947,5815
9062654,9062650,TXFE7,128,9944,1,11522,5948,5816
9062667,9062660,TXFE7,128,9944,1,11523,5949,5817
9062667,9062660,TXFE7,129,9944,3,11533,5956,5818
9062667,9062660,TXFE7,129,9943,7,11533,5956,5818
9062667,9062663,TXFE7,128,9944,1,11534,5957,5819
9062667,9062666,TXFE7,128,9944,1,11535,5958,5820
9062679,9062669,TXFE7,128,9944,1,11536,5959,5821
9062679,9062672,TXFE7,128,9945,1,11537,5960,5822
9062679,9062675,TXFE7,128,9944,2,11539,5961,5823
9062679,9062677,TXFE7,128,9944,2,11541,5962,5824
9062692,9062681,TXFE7,128,9944,1,11542,5963,5825
9062692,9062690,TXFE7,128,9945,1,11543,5964,5826
9062704,9062692,TXFE7,128,9945,38,11581,5965,5843
9062704,9062700,TXFE7,128,9945,2,11583,5966,5844
9062717,9062706,TXFE7,128,9945,12,11595,5971,5845
9062717,9062709,TXFE7,128,9945,2,11597,5973,5846
9062717,9062709,TXFE7,128,9945,2,11599,5974,5847
9062717,9062711,TXFE7,128,9945,1,11600,5975,5848
9062729,9062728,TXFE7,128,9945,1,11601,5976,5849
9062729,9062729,TXFE7,128,9946,5,11606,5977,5852
9062742,9062740,TXFE7,128,9945,1,11607,5978,5853
9062742,9062741,TXFE7,128,9945,1,11608,5979,5854
9062754,9062744,TXFE7,128,9945,1,11609,5980,5855
9062754,9062746,TXFE7,128,9945,2,11611,5981,5856
9062817,9062810,TXFE7,128,9945,1,11612,5982,5857
9062829,9062821,TXFE7,128,9945,1,11613,5983,5858
9062829,9062825,TXFE7,128,9945,1,11614,5984,5859
9062842,9062831,TXFE7,128,9945,2,11616,5985,5860
9062842,9062832,TXFE7,128,9945,2,11618,5986,5861
9062842,9062834,TXFE7,128,9945,1,11619,5987,5862
9062854,9062854,TXFE7,128,9945,1,11620,5988,5863
9062879,9062869,TXFE7,128,9945,1,11621,5989,5864
9062879,9062870,TXFE7,128,9946,1,11622,5990,5865
9062879,9062877,TXFE7,128,9945,2,11624,5991,5866
9062892,9062885,TXFE7,128,9945,1,11625,5992,5867
9062904,9062898,TXFE7,128,9945,2,11627,5993,5868
9062904,9062901,TXFE7,128,9946,25,11652,5994,5876
9062917,9062910,TXFE7,128,9945,1,11653,5995,5877
9062917,9062913,TXFE7,128,9945,1,11654,5996,5878
9062929,9062927,TXFE7,128,9945,1,11655,5997,5879
9062929,9062928,TXFE7,128,9945,1,11656,5998,5880
9062942,9062929,TXFE7,128,9945,1,11657,5999,5881
9062942,9062930,TXFE7,128,9945,9,11666,6004,5882
9062942,9062931,TXFE7,128,9945,1,11667,6005,5883
9062942,9062933,TXFE7,128,9945,1,11668,6006,5884
9062967,9062966,TXFE7,128,9946,5,11673,6007,5888
9062979,9062969,TXFE7,128,9945,2,11675,6009,5889
9063017,9063009,TXFE7,128,9946,2,11677,6010,5891
9063017,9063011,TXFE7,128,9946,10,11687,6011,5896
9063029,9063019,TXFE7,128,9946,1,11688,6012,5897
9063042,9063037,TXFE7,128,9946,2,11690,6013,5898
9063054,9063045,TXFE7,128,9946,1,11691,6014,5899
9063067,9063058,TXFE7,128,9947,24,11715,6015,5913
9063067,9063062,TXFE7,128,9947,2,11717,6016,5915
9063067,9063064,TXFE7,128,9947,2,11719,6017,5916
9063079,9063069,TXFE7,128,9946,1,11720,6018,5917
9063079,9063077,TXFE7,128,9946,1,11721,6019,5918
9063092,9063081,TXFE7,128,9947,1,11722,6020,5919
9063092,9063083,TXFE7,128,9946,1,11723,6021,5920
9063142,9063135,TXFE7,128,9947,2,11725,6022,5921
9063142,9063141,TXFE7,128,9946,1,11726,6023,5922
9063154,9063147,TXFE7,128,9946,3,11729,6024,5923
9063192,9063192,TXFE7,128,9946,9,11738,6026,5924
9063229,9063220,TXFE7,128,9946,2,11740,6028,5925
9063254,9063250,TXFE7,128,9946,1,11741,6029,5926
9063304,9063296,TXFE7,128,9946,1,11742,6030,5927
9063304,9063300,TXFE7,128,9946,2,11744,6032,5928
9063304,9063303,TXFE7,128,9946,1,11745,6033,5929
9063317,9063310,TXFE7,128,9946,1,11746,6034,5930
9063329,9063322,TXFE7,128,9946,1,11747,6035,5931
9063329,9063327,TXFE7,128,9946,1,11748,6036,5932
9063342,9063331,TXFE7,128,9946,1,11749,6037,5933
9063342,9063334,TXFE7,128,9946,1,11750,6038,5934
9063392,9063384,TXFE7,128,9945,4,11754,6039,5935
9063392,9063388,TXFE7,128,9945,6,11760,6041,5936
9063404,9063396,TXFE7,128,9945,2,11762,6043,5937
9063442,9063434,TXFE7,128,9945,1,11763,6044,5938
9063442,9063435,TXFE7,128,9945,1,11764,6045,5939
9063454,9063444,TXFE7,128,9945,1,11765,6046,5940
9063454,9063445,TXFE7,128,9945,1,11766,6047,5941
9063467,9063455,TXFE7,128,9946,1,11767,6048,5942
9063467,9063458,TXFE7,128,9946,1,11768,6049,5943
9063479,9063474,TXFE7,128,9946,1,11769,6050,5944
9063517,9063507,TXFE7,128,9946,1,11770,6051,5945
9063517,9063508,TXFE7,128,9946,2,11772,6052,5946
9063517,9063509,TXFE7,128,9946,1,11773,6053,5947
9063529,9063522,TXFE7,128,9946,1,11774,6054,5948
9063579,9063573,TXFE7,128,9946,1,11775,6055,5949
9063604,9063598,TXFE7,128,9946,1,11776,6056,5950
9063604,9063604,TXFE7,128,9946,6,11782,6057,5954
9063617,9063605,TXFE7,128,9946,1,11783,6058,5955
9063617,9063606,TXFE7,128,9946,1,11784,6059,5956
9063617,9063606,TXFE7,128,9947,1,11785,6060,5957
9063617,9063607,TXFE7,128,9946,1,11786,6061,5958
9063629,9063621,TXFE7,128,9946,1,11787,6062,5959
9063629,9063624,TXFE7,128,9945,3,11790,6064,5960
9063642,9063641,TXFE7,128,9946,1,11791,6065,5961
9063654,9063649,TXFE7,128,9946,5,11796,6066,5962
9063679,9063678,TXFE7,128,9945,2,11798,6068,5963
9063704,9063699,TXFE7,128,9946,1,11799,6069,5964
9063704,9063700,TXFE7,128,9945,2,11801,6071,5965
9063729,9063717,TXFE7,128,9946,1,11802,6072,5966
9063742,9063740,TXFE7,128,9945,2,11804,6073,5967
9063754,9063742,TXFE7,128,9945,1,11805,6074,5968
9063767,9063765,TXFE7,128,9945,1,11806,6075,5969
9063779,9063771,TXFE7,128,9945,1,11807,6076,5970
9063867,9063861,TXFE7,128,9946,2,11809,6077,5971
9063929,9063926,TXFE7,128,9945,1,11810,6078,5972
9063942,9063941,TXFE7,128,9946,2,11812,6079,5974
9063967,9063962,TXFE7,128,9945,1,11813,6080,5975
9063979,9063977,TXFE7,128,9945,1,11814,6081,5976
9064017,9064008,TXFE7,128,9946,5,11819,6082,5979
9064017,9064012,TXFE7,128,9945,1,11820,6083,5980
9064042,9064032,TXFE7,128,9946,2,11822,6084,5982
9064042,9064033,TXFE7,128,9946,3,11825,6085,5985
9064054,9064042,TXFE7,128,9946,2,11827,6086,5987
9064067,9064057,TXFE7,128,9946,1,11828,6087,5988
9064067,9064059,TXFE7,129,9946,1,11830,6088,5990
9064067,9064059,TXFE7,129,9947,1,11830,6088,5990
9064079,9064073,TXFE7,128,9946,1,11831,6089,5991
9064092,9064081,TXFE7,128,9946,1,11832,6090,5992
9064092,9064083,TXFE7,128,9947,1,11833,6091,5993
9064092,9064085,TXFE7,128,9946,5,11838,6093,5994
9064092,9064086,TXFE7,128,9947,1,11839,6094,5995
9064092,9064086,TXFE7,128,9947,3,11842,6095,5998
9064092,9064090,TXFE7,128,9947,3,11845,6096,5999
9064129,9064122,TXFE7,128,9947,1,11846,6097,6000
9064142,9064131,TXFE7,128,9947,1,11847,6098,6001
9064142,9064136,TXFE7,128,9946,1,11848,6099,6002
9064142,9064137,TXFE7,128,9946,1,11849,6100,6003
9064154,9064144,TXFE7,128,9947,1,11850,6101,6004
9064167,9064154,TXFE7,128,9947,1,11851,6102,6005
9064167,9064161,TXFE7,128,9946,1,11852,6103,6006
9064179,9064173,TXFE7,128,9947,9,11861,6104,6008
9064179,9064175,TXFE7,128,9947,1,11862,6105,6009
9064192,9064179,TXFE7,128,9947,6,11868,6106,6011
9064192,9064179,TXFE7,128,9947,4,11872,6107,6013
9064192,9064186,TXFE7,128,9947,5,11877,6108,6018
9064192,9064190,TXFE7,128,9946,1,11878,6109,6019
9064204,9064192,TXFE7,128,9947,4,11882,6110,6022
9064204,9064192,TXFE7,128,9947,1,11883,6111,6023
9064217,9064210,TXFE7,128,9947,1,11884,6112,6024
9064229,9064224,TXFE7,128,9947,1,11885,6113,6025
9064242,9064235,TXFE7,128,9947,1,11886,6114,6026
9064267,9064265,TXFE7,128,9948,1,11887,6115,6027
9064279,9064269,TXFE7,128,9948,2,11889,6116,6028
9064317,9064306,TXFE7,128,9948,5,11894,6117,6033
9064329,9064322,TXFE7,128,9948,2,11896,6118,6035
9064329,9064325,TXFE7,128,9947,1,11897,6119,6036
9064342,9064339,TXFE7,128,9947,1,11898,6120,6037
9064367,9064363,TXFE7,128,9947,8,11906,6124,6038
9064379,9064367,TXFE7,128,9947,1,11907,6125,6039
9064392,9064389,TXFE7,128,9947,5,11912,6127,6040
9064417,9064407,TXFE7,128,9947,1,11913,6128,6041
9064429,9064418,TXFE7,128,9947,2,11915,6129,6042
9064442,9064433,TXFE7,128,9947,4,11919,6131,6043
9064454,9064442,TXFE7,128,9947,1,11920,6132,6044
9064467,9064454,TXFE7,128,9947,1,11921,6133,6045
9064479,9064474,TXFE7,128,9947,4,11925,6135,6046
9064492,9064479,TXFE7,128,9947,1,11926,6136,6047
9064492,9064479,TXFE7,128,9947,1,11927,6137,6048
9064492,9064489,TXFE7,128,9947,1,11928,6138,6049
9064504,9064496,TXFE7,128,9947,1,11929,6139,6050
9064517,9064508,TXFE7,128,9946,3,11932,6140,6051
9064542,9064530,TXFE7,128,9946,2,11934,6142,6052
9064542,9064541,TXFE7,128,9947,1,11935,6143,6053
9064629,9064622,TXFE7,128,9947,5,11940,6144,6056
9064692,9064691,TXFE7,128,9947,1,11941,6145,6057
9064767,9064756,TXFE7,128,9946,1,11942,6146,6058
9064779,9064772,TXFE7,128,9946,3,11945,6148,6059
9064792,9064784,TXFE7,128,9947,1,11946,6149,6060
9064854,9064845,TXFE7,128,9946,1,11947,6150,6061
9064879,9064878,TXFE7,128,9947,2,11949,6151,6062
9064929,9064922,TXFE7,128,9946,1,11950,6152,6063
9064942,9064933,TXFE7,128,9946,3,11953,6153,6064
9064979,9064968,TXFE7,128,9946,1,11954,6154,6065
9065004,9064992,TXFE7,128,9946,3,11957,6155,6066
9065079,9065077,TXFE7,128,9946,2,11959,6156,6067
9065229,9065220,TXFE7,128,9947,1,11960,6157,6068
9065279,9065278,TXFE7,128,9946,2,11962,6158,6069
9065379,9065378,TXFE7,128,9946,2,11964,6159,6070
9065429,9065427,TXFE7,128,9947,5,11969,6160,6073
9065454,9065443,TXFE7,128,9946,1,11970,6161,6074
9065479,9065468,TXFE7,128,9946,1,11971,6162,6075
9065604,9065595,TXFE7,128,9947,1,11972,6163,6076
9065604,9065598,TXFE7,128,9946,5,11977,6166,6077
9065604,9065601,TXFE7,128,9946,1,11978,6167,6078
9065617,9065611,TXFE7,128,9946,1,11979,6168,6079
9065617,9065612,TXFE7,128,9946,5,11984,6173,6080
9065617,9065616,TXFE7,128,9946,4,11988,6175,6081
9065629,9065617,TXFE7,128,9946,1,11989,6176,6082
9065629,9065618,TXFE7,128,9946,2,11991,6177,6083
9065629,9065629,TXFE7,128,9946,2,11993,6178,6084
9065642,9065629,TXFE7,128,9946,2,11995,6179,6085
9065642,9065634,TXFE7,128,9946,2,11997,6180,6086
9065654,9065654,TXFE7,128,9946,1,11998,6181,6087
9065667,9065662,TXFE7,128,9946,1,11999,6182,6088
9065679,9065676,TXFE7,128,9947,1,12000,6183,6089
9065692,9065685,TXFE7,128,9946,1,12001,6184,6090
9065692,9065685,TXFE7,128,9946,1,12002,6185,6091
9065692,9065688,TXFE7,128,9946,10,12012,6189,6092
9065704,9065694,TXFE7,128,9945,1,12013,6190,6093
9065704,9065695,TXFE7,128,9946,1,12014,6191,6094
9065717,9065708,TXFE7,128,9946,1,12015,6192,6095
9065717,9065715,TXFE7,128,9945,1,12016,6193,6096
9065729,9065721,TXFE7,128,9946,5,12021,6194,6097
9065729,9065727,TXFE7,128,9945,3,12024,6196,6098
9065742,9065735,TXFE7,128,9946,1,12025,6197,6099
9065754,9065745,TXFE7,128,9945,1,12026,6198,6100
9065779,9065777,TXFE7,128,9945,2,12028,6200,6101
9065829,9065824,TXFE7,128,9945,1,12029,6201,6102
9065829,9065825,TXFE7,128,9946,1,12030,6202,6103
9065829,9065825,TXFE7,128,9945,1,12031,6203,6104
9065829,9065826,TXFE7,128,9946,1,12032,6204,6105
9065879,9065867,TXFE7,128,9946,10,12042,6205,6112
9065879,9065876,TXFE7,128,9945,1,12043,6206,6113
9065892,9065887,TXFE7,128,9946,1,12044,6207,6114
9065904,9065893,TXFE7,128,9946,1,12045,6208,6115
9065904,9065899,TXFE7,128,9946,3,12048,6209,6116
9065917,9065912,TXFE7,128,9946,1,12049,6210,6117
9065917,9065915,TXFE7,128,9946,4,12053,6212,6118
9065967,9065956,TXFE7,128,9946,1,12054,6213,6119
9065979,9065978,TXFE7,128,9945,4,12058,6216,6120
9065992,9065982,TXFE7,128,9946,3,12061,6217,6121
9070004,9070003,TXFE7,128,9945,9,12070,6219,6122
9070017,9070006,TXFE7,128,9946,2,12072,6220,6123
9070042,9070029,TXFE7,128,9945,1,12073,6221,6124
9070054,9070050,TXFE7,128,9946,4,12077,6222,6125
9070104,9070093,TXFE7,128,9945,10,12087,6231,6126
9070117,9070104,TXFE7,128,9945,4,12091,6235,6127
9070117,9070104,TXFE7,128,9945,4,12095,6239,6128
9070129,9070117,TXFE7,128,9945,1,12096,6240,6129
9070129,9070117,TXFE7,128,9945,1,12097,6241,6130
9070129,9070121,TXFE7,128,9945,1,12098,6242,6131
9070154,9070149,TXFE7,128,9945,5,12103,6245,6132
9070167,9070159,TXFE7,128,9945,6,12109,6247,6133
9070192,9070183,TXFE7,128,9945,1,12110,6248,6134
9070204,9070195,TXFE7,128,9945,4,12114,6251,6135
9070204,9070201,TXFE7,128,9945,2,12116,6253,6136
9070217,9070206,TXFE7,128,9945,14,12130,6256,6137
9070229,9070217,TXFE7,128,9945,2,12132,6258,6138
9070229,9070217,TXFE7,128,9945,4,12136,6261,6139
9070229,9070217,TXFE7,128,9945,1,12137,6262,6140
9070229,9070221,TXFE7,128,9945,1,12138,6263,6141
9070267,9070257,TXFE7,128,9945,1,12139,6264,6142
9070267,9070257,TXFE7,128,9944,1,12140,6265,6143
9070279,9070277,TXFE7,128,9945,1,12141,6266,6144
9070304,9070295,TXFE7,128,9944,2,12143,6267,6145
9070317,9070304,TXFE7,128,9944,1,12144,6268,6146
9070329,9070319,TXFE7,128,9945,5,12149,6269,6147
9070329,9070324,TXFE7,128,9944,2,12151,6271,6148
9070417,9070414,TXFE7,128,9944,1,12152,6272,6149
9070467,9070455,TXFE7,128,9944,1,12153,6273,6150
9070467,9070458,TXFE7,128,9944,1,12154,6274,6151
9070467,9070459,TXFE7,128,9944,1,12155,6275,6152
9070467,9070462,TXFE7,128,9944,1,12156,6276,6153
9070492,9070482,TXFE7,128,9944,17,12173,6282,6154
9070492,9070489,TXFE7,128,9944,1,12174,6283,6155
9070504,9070493,TXFE7,128,9945,2,12176,6284,6156
9070517,9070510,TXFE7,128,9945,1,12177,6285,6157
9070529,9070521,TXFE7,128,9945,1,12178,6286,6158
9070529,9070526,TXFE7,128,9944,4,12182,6289,6159
9070554,9070547,TXFE7,128,9944,2,12184,6291,6160
9070554,9070548,TXFE7,128,9944,2,12186,6292,6161
9070554,9070550,TXFE7,128,9944,1,12187,6293,6162
9070554,9070551,TXFE7,128,9944,2,12189,6294,6163
9070567,9070558,TXFE7,128,9945,1,12190,6295,6164
9070567,9070565,TXFE7,128,9944,1,12191,6296,6165
9070579,9070568,TXFE7,128,9945,1,12192,6297,6166
9070579,9070569,TXFE7,128,9944,15,12207,6302,6167
9070592,9070580,TXFE7,128,9945,1,12208,6303,6168
9070592,9070582,TXFE7,128,9944,3,12211,6304,6169
9070592,9070588,TXFE7,128,9945,1,12212,6305,6170
9070617,9070604,TXFE7,128,9944,2,12214,6307,6171
9070642,9070629,TXFE7,128,9944,2,12216,6308,6172
9070642,9070638,TXFE7,128,9943,3,12219,6311,6173
9070642,9070639,TXFE7,128,9943,10,12229,6318,6174
9070667,9070657,TXFE7,128,9943,1,12230,6319,6175
9070679,9070674,TXFE7,128,9944,1,12231,6320,6176
9070679,9070676,TXFE7,128,9943,3,12234,6321,6177
9070692,9070683,TXFE7,128,9943,1,12235,6322,6178
9070742,9070732,TXFE7,128,9943,2,12237,6324,6179
9070742,9070733,TXFE7,128,9943,1,12238,6325,6180
9070754,9070742,TXFE7,128,9944,9,12247,6326,6183
9070767,9070759,TXFE7,128,9944,1,12248,6327,6184
9070804,9070800,TXFE7,128,9943,1,12249,6328,6185
9070804,9070802,TXFE7,128,9943,1,12250,6329,6186
9070817,9070813,TXFE7,128,9943,1,12251,6330,6187
9070854,9070850,TXFE7,128,9943,2,12253,6332,6188
9070854,9070852,TXFE7,128,9943,1,12254,6333,6189
9070867,9070857,TXFE7,128,9943,1,12255,6334,6190
9070867,9070858,TXFE7,128,9943,1,12256,6335,6191
9070892,9070880,TXFE7,128,9943,20,12276,6344,6192
9070904,9070892,TXFE7,128,9943,26,12302,6363,6193
9070904,9070893,TXFE7,128,9942,1,12303,6364,6194
9070917,9070907,TXFE7,128,9942,5,12308,6365,6195
9070917,9070908,TXFE7,128,9942,1,12309,6366,6196
9070917,9070909,TXFE7,128,9942,1,12310,6367,6197
9070917,9070910,TXFE7,128,9942,2,12312,6368,6198
9070917,9070911,TXFE7,128,9942,2,12314,6369,6199
9070917,9070911,TXFE7,128,9942,2,12316,6370,6200
9070917,9070913,TXFE7,128,9943,1,12317,6371,6201
9070917,9070915,TXFE7,128,9943,1,12318,6372,6202
9070929,9070917,TXFE7,128,9943,3,12321,6373,6205
9070929,9070918,TXFE7,128,9942,1,12322,6374,6206
9070929,9070929,TXFE7,128,9942,3,12325,6375,6207
9070942,9070930,TXFE7,128,9942,9,12334,6376,6208
9070942,9070938,TXFE7,128,9942,2,12336,6377,6209
9070954,9070952,TXFE7,128,9942,5,12341,6380,6210
9070967,9070961,TXFE7,128,9942,1,12342,6381,6211
9070967,9070964,TXFE7,128,9942,2,12344,6383,6212
9070967,9070965,TXFE7,128,9942,2,12346,6384,6213
9070979,9070968,TXFE7,128,9942,2,12348,6385,6214
9070979,9070970,TXFE7,128,9942,1,12349,6386,6215
9070979,9070971,TXFE7,128,9942,6,12355,6392,6216
9070992,9070980,TXFE7,128,9942,2,12357,6394,6217
9070992,9070980,TXFE7,128,9942,1,12358,6395,6218
9070992,9070980,TXFE7,128,9942,1,12359,6396,6219
9070992,9070980,TXFE7,128,9942,1,12360,6397,6220
9070992,9070988,TXFE7,128,9942,3,12363,6400,6221
9070992,9070989,TXFE7,128,9943,2,12365,6401,6222
9070992,9070990,TXFE7,128,9942,1,12366,6402,6223
9071004,9070994,TXFE7,128,9942,2,12368,6404,6224
9071017,9071007,TXFE7,128,9942,2,12370,6406,6225
9071017,9071012,TXFE7,128,9942,2,12372,6407,6226
9071017,9071013,TXFE7,128,9942,2,12374,6409,6227
9071017,9071013,TXFE7,128,9942,1,12375,6410,6228
9071017,9071013,TXFE7,128,9942,1,12376,6411,6229
9071017,9071014,TXFE7,128,9942,1,12377,6412,6230
9071017,9071014,TXFE7,128,9942,1,12378,6413,6231
9071017,9071015,TXFE7,128,9942,1,12379,6414,6232
9071017,9071015,TXFE7,128,9942,1,12380,6415,6233
9071017,9071016,TXFE7,128,9942,1,12381,6416,6234
9071029,9071018,TXFE7,128,9942,1,12382,6417,6235
9071029,9071019,TXFE7,128,9943,2,12384,6418,6237
9071029,9071022,TXFE7,128,9942,2,12386,6419,6238
9071029,9071023,TXFE7,128,9942,2,12388,6420,6239
9071029,9071026,TXFE7,128,9943,1,12389,6421,6240
9071029,9071028,TXFE7,128,9942,1,12390,6422,6241
9071029,9071029,TXFE7,128,9942,1,12391,6423,6242
9071042,9071034,TXFE7,128,9942,1,12392,6424,6243
9071042,9071037,TXFE7,128,9942,1,12393,6425,6244
9071054,9071043,TXFE7,128,9943,2,12395,6426,6246
9071054,9071044,TXFE7,128,9942,1,12396,6427,6247
9071054,9071046,TXFE7,128,9942,2,12398,6429,6248
9071054,9071046,TXFE7,128,9942,2,12400,6431,6249
9071054,9071049,TXFE7,128,9942,1,12401,6432,6250
9071054,9071050,TXFE7,128,9942,2,12403,6434,6251
9071054,9071050,TXFE7,128,9942,1,12404,6435,6252
9071054,9071052,TXFE7,128,9942,1,12405,6436,6253
9071054,9071053,TXFE7,128,9942,2,12407,6437,6254
9071054,9071053,TXFE7,128,9942,2,12409,6439,6255
9071067,9071054,TXFE7,128,9942,1,12410,6440,6256
9071067,9071055,TXFE7,128,9942,1,12411,6441,6257
9071067,9071057,TXFE7,128,9942,1,12412,6442,6258
9071067,9071058,TXFE7,128,9942,2,12414,6443,6259
9071067,9071067,TXFE7,128,9942,5,12419,6444,6260
9071079,9071074,TXFE7,128,9942,3,12422,6445,6261
9071079,9071077,TXFE7,128,9942,1,12423,6446,6262
9071092,9071080,TXFE7,128,9942,9,12432,6448,6263
9071092,9071085,TXFE7,128,9943,23,12455,6449,6275
9071092,9071085,TXFE7,128,9943,2,12457,6450,6277
9071092,9071089,TXFE7,128,9943,2,12459,6451,6278
9071104,9071092,TXFE7,128,9943,1,12460,6452,6279
9071117,9071105,TXFE7,128,9943,1,12461,6453,6280
9071117,9071109,TXFE7,128,9942,2,12463,6454,6281
9071117,9071116,TXFE7,128,9943,1,12464,6455,6282
9071129,9071125,TXFE7,128,9943,5,12469,6457,6283
9071129,9071125,TXFE7,128,9943,2,12471,6458,6284
9071129,9071128,TXFE7,128,9943,1,12472,6459,6285
9071142,9071131,TXFE7,129,9943,1,12475,6461,6286
9071142,9071131,TXFE7,129,9942,2,12475,6461,6286
9071154,9071148,TXFE7,129,9943,2,12483,6466,6287
9071154,9071148,TXFE7,129,9942,6,12483,6466,6287
9071167,9071160,TXFE7,128,9943,3,12486,6467,6288
9071167,9071165,TXFE7,128,9943,2,12488,6468,6290
9071179,9071168,TXFE7,128,9943,2,12490,6469,6291
9071179,9071172,TXFE7,128,9944,7,12497,6470,6296
9071179,9071176,TXFE7,128,9943,1,12498,6471,6297
9071179,9071179,TXFE7,128,9943,1,12499,6472,6298
9071204,9071192,TXFE7,128,9944,1,12500,6473,6299
9071204,9071193,TXFE7,128,9943,1,12501,6474,6300
9071204,9071196,TXFE7,128,9943,1,12502,6475,6301
9071204,9071199,TXFE7,128,9943,1,12503,6476,6302
9071204,9071199,TXFE7,128,9943,1,12504,6477,6303
9071204,9071200,TXFE7,128,9943,1,12505,6478,6304
9071204,9071202,TXFE7,128,9943,2,12507,6479,6305
9071204,9071203,TXFE7,128,9943,3,12510,6480,6306
9071217,9071207,TXFE7,128,9943,1,12511,6481,6307
9071229,9071221,TXFE7,128,9943,1,12512,6482,6308
9071292,9071285,TXFE7,128,9943,1,12513,6483,6309
9071304,9071301,TXFE7,128,9944,1,12514,6484,6310
9071329,9071321,TXFE7,128,9944,4,12518,6485,6314
9071329,9071321,TXFE7,128,9944,1,12519,6486,6315
9071329,9071321,TXFE7,128,9944,4,12523,6487,6319
9071329,9071321,TXFE7,128,9944,2,12525,6488,6321
9071329,9071322,TXFE7,128,9944,4,12529,6489,6325
9071329,9071322,TXFE7,128,9944,1,12530,6490,6326
9071342,9071336,TXFE7,128,9944,1,12531,6491,6327
9071354,9071344,TXFE7,128,9944,1,12532,6492,6328
9071392,9071384,TXFE7,128,9945,1,12533,6493,6329
9071404,9071398,TXFE7,128,9944,1,12534,6494,6330
9071417,9071407,TXFE7,128,9944,1,12535,6495,6331
9071442,9071439,TXFE7,128,9945,1,12536,6496,6332
9071454,9071442,TXFE7,128,9945,1,12537,6497,6333
9071454,9071445,TXFE7,128,9945,1,12538,6498,6334
9071454,9071447,TXFE7,128,9944,2,12540,6500,6335
9071454,9071448,TXFE7,128,9944,2,12542,6502,6336
9071454,9071449,TXFE7,128,9944,2,12544,6504,6337
9071454,9071451,TXFE7,128,9945,7,12551,6505,6343
9071479,9071472,TXFE7,128,9945,1,12552,6506,6344
9071492,9071482,TXFE7,128,9944,2,12554,6507,6345
9071492,9071483,TXFE7,128,9944,1,12555,6508,6346
9071517,9071506,TXFE7,128,9945,1,12556,6509,6347
9071517,9071508,TXFE7,128,9944,1,12557,6510,6348
9071517,9071513,TXFE7,128,9944,1,12558,6511,6349
9071529,9071518,TXFE7,128,9945,1,12559,6512,6350
9071529,9071523,TXFE7,128,9945,5,12564,6513,6353
9071529,9071527,TXFE7,128,9944,12,12576,6517,6354
9071542,9071533,TXFE7,128,9944,9,12585,6522,6355
9071542,9071535,TXFE7,128,9944,3,12588,6523,6356
9071542,9071541,TXFE7,128,9944,1,12589,6524,6357
9071604,9071595,TXFE7,128,9944,2,12591,6526,6358
9071604,9071601,TXFE7,128,9944,1,12592,6527,6359
9071629,9071625,TXFE7,128,9945,2,12594,6528,6360
9071667,9071664,TXFE7,128,9944,1,12595,6529,6361
9071667,9071667,TXFE7,128,9944,1,12596,6530,6362
9071679,9071670,TXFE7,128,9944,1,12597,6531,6363
9071692,9071683,TXFE7,129,9944,3,12601,6534,6364
9071692,9071683,TXFE7,129,9943,1,12601,6534,6364
9071704,9071692,TXFE7,128,9944,1,12602,6535,6365
9071729,9071722,TXFE7,128,9944,1,12603,6536,6366
9071767,9071765,TXFE7,128,9944,1,12604,6537,6367
9071779,9071768,TXFE7,128,9944,1,12605,6538,6368
9071792,9071785,TXFE7,128,9945,2,12607,6539,6370
9071804,9071802,TXFE7,128,9945,1,12608,6540,6371
9071817,9071812,TXFE7,128,9944,4,12612,6542,6372
9071842,9071833,TXFE7,128,9945,1,12613,6543,6373
9071854,9071844,TXFE7,128,9944,1,12614,6544,6374
9071867,9071864,TXFE7,128,9944,5,12619,6547,6375
9071867,9071866,TXFE7,128,9944,1,12620,6548,6376
9071879,9071868,TXFE7,128,9945,1,12621,6549,6377
9071879,9071871,TXFE7,128,9945,1,12622,6550,6378
9071892,9071881,TXFE7,128,9944,10,12632,6555,6379
9071929,9071925,TXFE7,128,9945,1,12633,6556,6380
9071929,9071925,TXFE7,128,9944,5,12638,6558,6381
9072079,9072073,TXFE7,128,9945,2,12640,6559,6383
9072092,9072091,TXFE7,128,9944,1,12641,6560,6384
9072117,9072108,TXFE7,128,9944,1,12642,6561,6385
9072129,9072120,TXFE7,128,9944,2,12644,6563,6386
9072142,9072138,TXFE7,128,9944,2,12646,6565,6387
9072167,9072166,TXFE7,128,9943,1,12647,6566,6388
9072179,9072169,TXFE7,128,9943,1,12648,6567,6389
9072179,9072171,TXFE7,128,9943,2,12650,6568,6390
9072217,9072209,TXFE7,128,9944,2,12652,6569,6392
9072217,9072211,TXFE7,128,9944,1,12653,6570,6393
9072217,9072212,TXFE7,128,9944,5,12658,6571,6395
9072242,9072231,TXFE7,128,9943,2,12660,6573,6396
9072242,9072232,TXFE7,128,9944,1,12661,6574,6397
9072242,9072239,TXFE7,128,9943,1,12662,6575,6398
9072242,9072239,TXFE7,128,9944,2,12664,6576,6399
9072254,9072249,TXFE7,128,9944,1,12665,6577,6400
9072254,9072251,TXFE7,128,9944,1,12666,6578,6401
9072254,9072251,TXFE7,128,9943,1,12667,6579,6402
9072267,9072255,TXFE7,128,9944,2,12669,6580,6403
9072267,9072260,TXFE7,128,9944,1,12670,6581,6404
9072267,9072263,TXFE7,128,9944,2,12672,6582,6405
9072267,9072266,TXFE7,128,9943,1,12673,6583,6406
9072304,9072303,TXFE7,128,9944,1,12674,6584,6407
9072379,9072372,TXFE7,128,9944,1,12675,6585,6408
9072404,9072393,TXFE7,128,9944,1,12676,6586,6409
9072404,9072401,TXFE7,128,9944,5,12681,6587,6412
9072404,9072401,TXFE7,128,9943,3,12684,6589,6413
9072417,9072407,TXFE7,128,9943,2,12686,6590,6414
9072479,9072470,TXFE7,128,9943,1,12687,6591,6415
9072479,9072471,TXFE7,128,9944,2,12689,6592,6417
9072479,9072476,TXFE7,128,9944,1,12690,6593,6418
9072504,9072497,TXFE7,128,9943,1,12691,6594,6419
9072504,9072498,TXFE7,128,9943,1,12692,6595,6420
9072504,9072501,TXFE7,128,9943,1,12693,6596,6421
9072504,9072504,TXFE7,128,9943,1,12694,6597,6422
9072517,9072504,TXFE7,128,9943,1,12695,6598,6423
9072517,9072505,TXFE7,128,9943,1,12696,6599,6424
9072517,9072507,TXFE7,128,9943,1,12697,6600,6425
9072517,9072508,TXFE7,128,9943,1,12698,6601,6426
9072517,9072511,TXFE7,128,9943,1,12699,6602,6427
9072592,9072582,TXFE7,128,9944,1,12700,6603,6428
9072617,9072615,TXFE7,128,9943,2,12702,6604,6429
9072629,9072617,TXFE7,128,9943,1,12703,6605,6430
9072642,9072634,TXFE7,128,9943,3,12706,6608,6431
9072667,9072663,TXFE7,129,9943,4,12711,6609,6434
9072667,9072663,TXFE7,129,9944,1,12711,6609,6434
9072692,9072683,TXFE7,128,9944,1,12712,6610,6435
9072692,9072691,TXFE7,128,9942,1,12713,6611,6436
9072717,9072713,TXFE7,128,9943,2,12715,6612,6437
9072767,9072764,TXFE7,128,9944,1,12716,6613,6438
9072804,9072794,TXFE7,128,9943,2,12718,6614,6439
9072804,9072795,TXFE7,128,9944,1,12719,6615,6440
9072842,9072838,TXFE7,128,9943,8,12727,6618,6441
9072867,9072857,TXFE7,128,9944,2,12729,6619,6443
9072879,9072877,TXFE7,128,9943,3,12732,6622,6444
9072892,9072885,TXFE7,128,9943,1,12733,6623,6445
9072904,9072892,TXFE7,128,9943,2,12735,6625,6446
9072929,9072927,TXFE7,128,9943,3,12738,6627,6447
9072942,9072931,TXFE7,128,9942,2,12740,6628,6448
9072954,9072944,TXFE7,128,9942,1,12741,6629,6449
9072954,9072949,TXFE7,128,9942,1,12742,6630,6450
9072979,9072971,TXFE7,128,9943,2,12744,6631,6451
9072992,9072981,TXFE7,128,9943,1,12745,6632,6452
9072992,9072988,TXFE7,128,9942,1,12746,6633,6453
9073017,9073010,TXFE7,128,9942,1,12747,6634,6454
9073017,9073012,TXFE7,128,9942,1,12748,6635,6455
9073054,9073045,TXFE7,129,9943,1,12750,6637,6456
9073054,9073045,TXFE7,129,9942,1,12750,6637,6456
9073054,9073047,TXFE7,128,9942,2,12752,6639,6457
9073054,9073049,TXFE7,128,9942,2,12754,6641,6458
9073079,9073078,TXFE7,128,9942,1,12755,6642,6459
9073129,9073119,TXFE7,128,9942,4,12759,6643,6460
9073179,9073172,TXFE7,128,9943,1,12760,6644,6461
9073179,9073174,TXFE7,128,9942,1,12761,6645,6462
9073192,9073186,TXFE7,128,9942,2,12763,6647,6463
9073192,9073190,TXFE7,128,9943,1,12764,6648,6464
9073204,9073200,TXFE7,128,9942,3,12767,6649,6465
9073204,9073202,TXFE7,128,9942,2,12769,6650,6466
9073242,9073235,TXFE7,128,9943,2,12771,6651,6467
9073254,9073253,TXFE7,128,9943,1,12772,6652,6468
9073292,9073285,TXFE7,128,9942,1,12773,6653,6469
9073317,9073305,TXFE7,128,9943,1,12774,6654,6470
9073317,9073310,TXFE7,128,9942,2,12776,6656,6471
9073342,9073341,TXFE7,128,9942,1,12777,6657,6472
9073354,9073346,TXFE7,128,9942,1,12778,6658,6473
9073367,9073365,TXFE7,128,9942,1,12779,6659,6474
9073379,9073374,TXFE7,128,9942,1,12780,6660,6475
9073392,9073385,TXFE7,128,9942,10,12790,6661,6476
9073392,9073388,TXFE7,128,9942,1,12791,6662,6477
9073392,9073392,TXFE7,128,9942,1,12792,6663,6478
9073404,9073393,TXFE7,128,9942,1,12793,6664,6479
9073417,9073408,TXFE7,128,9942,1,12794,6665,6480
9073417,9073410,TXFE7,128,9943,6,12800,6666,6482
9073429,9073417,TXFE7,128,9942,1,12801,6667,6483
9073442,9073433,TXFE7,128,9942,1,12802,6668,6484
9073442,9073435,TXFE7,128,9942,1,12803,6669,6485
9073467,9073459,TXFE7,128,9943,1,12804,6670,6486
9073492,9073480,TXFE7,128,9942,13,12817,6682,6487
9073492,9073482,TXFE7,128,9942,1,12818,6683,6488
9073492,9073487,TXFE7,128,9943,22,12840,6684,6500
9073517,9073507,TXFE7,128,9943,6,12846,6685,6505
9073529,9073518,TXFE7,128,9943,1,12847,6686,6506
9073529,9073520,TXFE7,128,9942,1,12848,6687,6507
9073529,9073521,TXFE7,128,9942,1,12849,6688,6508
9073529,9073523,TXFE7,128,9942,1,12850,6689,6509
9073529,9073523,TXFE7,128,9942,1,12851,6690,6510
9073529,9073524,TXFE7,128,9942,1,12852,6691,6511
9073542,9073533,TXFE7,128,9942,5,12857,6695,6512
9073567,9073561,TXFE7,128,9942,1,12858,6696,6513
9073592,9073585,TXFE7,128,9943,1,12859,6697,6514
9073592,9073586,TXFE7,128,9943,1,12860,6698,6515
9073642,9073630,TXFE7,128,9942,1,12861,6699,6516
9073642,9073637,TXFE7,128,9942,1,12862,6700,6517
9073654,9073650,TXFE7,128,9943,1,12863,6701,6518
9073654,9073653,TXFE7,128,9943,4,12867,6702,6519
9073654,9073654,TXFE7,128,9942,2,12869,6704,6520
9073692,9073685,TXFE7,128,9942,14,12883,6713,6521
9073704,9073695,TXFE7,128,9942,40,12923,6728,6522
9073704,9073695,TXFE7,128,9942,5,12928,6729,6523
9073704,9073695,TXFE7,128,9941,1,12929,6730,6524
9073717,9073710,TXFE7,128,9942,3,12932,6731,6525
9073717,9073711,TXFE7,128,9941,1,12933,6732,6526
9073717,9073713,TXFE7,128,9941,2,12935,6733,6527
9073717,9073715,TXFE7,128,9941,1,12936,6734,6528
9073729,9073718,TXFE7,128,9941,2,12938,6736,6529
9073729,9073719,TXFE7,128,9941,1,12939,6737,6530
9073729,9073723,TXFE7,128,9942,1,12940,6738,6531
9073729,9073727,TXFE7,128,9941,1,12941,6739,6532
9073742,9073735,TXFE7,128,9941,1,12942,6740,6533
9073742,9073736,TXFE7,128,9941,1,12943,6741,6534
9073742,9073739,TXFE7,128,9942,1,12944,6742,6535
9073742,9073739,TXFE7,128,9941,1,12945,6743,6536
9073754,9073749,TXFE7,128,9941,1,12946,6744,6537
9073754,9073751,TXFE7,128,9941,1,12947,6745,6538
9073792,9073785,TXFE7,128,9942,1,12948,6746,6539
9073792,9073791,TXFE7,128,9941,1,12949,6747,6540
9073804,9073799,TXFE7,128,9941,1,12950,6748,6541
9073804,9073801,TXFE7,128,9942,1,12951,6749,6542
9073817,9073806,TXFE7,128,9941,2,12953,6751,6543
9073817,9073810,TXFE7,128,9941,1,12954,6752,6544
9073817,9073812,TXFE7,128,9941,1,12955,6753,6545
9073829,9073817,TXFE7,128,9942,2,12957,6754,6546
9073829,9073818,TXFE7,128,9942,1,12958,6755,6547
9073829,9073826,TXFE7,128,9941,1,12959,6756,6548
9073829,9073827,TXFE7,128,9941,1,12960,6757,6549
9073829,9073829,TXFE7,128,9941,6,12966,6761,6550
9073879,9073868,TXFE7,128,9941,1,12967,6762,6551
9073892,9073882,TXFE7,128,9941,3,12970,6765,6552
9073892,9073890,TXFE7,128,9941,6,12976,6767,6553
9073929,9073917,TXFE7,128,9941,1,12977,6768,6554
9073929,9073918,TXFE7,128,9942,2,12979,6769,6556
9073929,9073919,TXFE7,128,9942,1,12980,6770,6557
9073929,9073919,TXFE7,128,9941,1,12981,6771,6558
9073929,9073921,TXFE7,128,9941,2,12983,6772,6559
9073929,9073925,TXFE7,128,9942,22,13005,6773,6568
9073929,9073927,TXFE7,128,9941,1,13006,6774,6569
9073979,9073972,TXFE7,128,9942,1,13007,6775,6570
9073979,9073974,TXFE7,128,9942,3,13010,6776,6571
9074017,9074008,TXFE7,128,9941,4,13014,6780,6572
9074017,9074010,TXFE7,128,9942,1,13015,6781,6573
9074029,9074020,TXFE7,128,9942,2,13017,6782,6574
9074029,9074025,TXFE7,128,9941,1,13018,6783,6575
9074029,9074028,TXFE7,128,9941,1,13019,6784,6576
9074042,9074031,TXFE7,128,9941,4,13023,6787,6577
9074054,9074047,TXFE7,128,9941,1,13024,6788,6578
9074054,9074048,TXFE7,128,9941,5,13029,6791,6579
9074054,9074049,TXFE7,128,9942,5,13034,6792,6581
9074054,9074050,TXFE7,128,9941,1,13035,6793,6582
9074054,9074050,TXFE7,128,9942,1,13036,6794,6583
9074054,9074052,TXFE7,128,9941,1,13037,6795,6584
9074054,9074053,TXFE7,128,9941,1,13038,6796,6585
9074079,9074075,TXFE7,128,9942,1,13039,6797,6586
9074092,9074082,TXFE7,128,9942,1,13040,6798,6587
9074104,9074102,TXFE7,128,9941,1,13041,6799,6588
9074117,9074110,TXFE7,128,9941,2,13043,6800,6589
9074117,9074115,TXFE7,128,9942,1,13044,6801,6590
9074129,9074123,TXFE7,128,9941,1,13045,6802,6591
9074142,9074140,TXFE7,128,9941,1,13046,6803,6592
9074142,9074141,TXFE7,128,9941,1,13047,6804,6593
9074154,9074145,TXFE7,128,9941,1,13048,6805,6594
9074154,9074151,TXFE7,128,9942,38,13086,6806,6609
9074167,9074164,TXFE7,128,9942,2,13088,6808,6610
9074204,9074195,TXFE7,128,9942,5,13093,6811,6611
9074204,9074197,TXFE7,128,9942,2,13095,6813,6612
9074217,9074206,TXFE7,128,9942,1,13096,6814,6613
9074242,9074232,TXFE7,128,9942,1,13097,6815,6614
9074267,9074262,TXFE7,128,9942,1,13098,6816,6615
9074267,9074265,TXFE7,128,9943,3,13101,6817,6617
9074279,9074271,TXFE7,128,9942,6,13107,6819,6618
9074279,9074272,TXFE7,128,9942,6,13113,6822,6619
9074292,9074287,TXFE7,128,9942,2,13115,6824,6620
9074304,9074294,TXFE7,128,9942,1,13116,6825,6621
9074304,9074298,TXFE7,128,9942,4,13120,6828,6622
9074304,9074303,TXFE7,128,9943,5,13125,6829,6623
9074329,9074319,TXFE7,128,9942,1,13126,6830,6624
9074342,9074332,TXFE7,128,9943,1,13127,6831,6625
9074342,9074340,TXFE7,128,9943,1,13128,6832,6626
9074379,9074374,TXFE7,128,9942,1,13129,6833,6627
9074417,9074405,TXFE7,128,9942,1,13130,6834,6628
9074429,9074423,TXFE7,128,9943,1,13131,6835,6629
9074442,9074439,TXFE7,128,9943,2,13133,6836,6631
9074454,9074442,TXFE7,128,9943,1,13134,6837,6632
9074454,9074447,TXFE7,128,9942,1,13135,6838,6633
9074454,9074450,TXFE7,128,9942,1,13136,6839,6634
9074504,9074497,TXFE7,128,9942,1,13137,6840,6635
9074517,9074507,TXFE7,128,9942,1,13138,6841,6636
9074529,9074520,TXFE7,128,9942,8,13146,6843,6637
9074529,9074528,TXFE7,128,9943,1,13147,6844,6638
9074542,9074537,TXFE7,128,9943,1,13148,6845,6639
9074542,9074540,TXFE7,128,9942,3,13151,6846,6640
9074554,9074544,TXFE7,128,9942,1,13152,6847,6641
9074579,9074571,TXFE7,128,9942,1,13153,6848,6642
9074592,9074579,TXFE7,128,9942,6,13159,6852,6643
9074592,9074586,TXFE7,128,9942,5,13164,6855,6644
9074617,9074615,TXFE7,128,9942,1,13165,6856,6645
9074617,9074616,TXFE7,128,9943,3,13168,6857,6647
9074642,9074630,TXFE7,128,9942,9,13177,6865,6648
9074642,9074634,TXFE7,128,9941,3,13180,6866,6649
9074654,9074645,TXFE7,128,9942,1,13181,6867,6650
9074654,9074651,TXFE7,128,9942,1,13182,6868,6651
9074692,9074679,TXFE7,128,9941,2,13184,6869,6652
9074704,9074704,TXFE7,128,9941,2,13186,6871,6653
9074804,9074799,TXFE7,128,9942,1,13187,6872,6654
9074842,9074834,TXFE7,128,9943,1,13188,6873,6655
9074867,9074862,TXFE7,128,9942,1,13189,6874,6656
9074879,9074871,TXFE7,128,9942,2,13191,6875,6657
9074892,9074885,TXFE7,128,9943,2,13193,6876,6659
9074892,9074888,TXFE7,128,9942,1,13194,6877,6660
9074917,9074907,TXFE7,128,9942,1,13195,6878,6661
9074929,9074920,TXFE7,128,9942,5,13200,6881,6662
9074954,9074948,TXFE7,128,9942,1,13201,6882,6663
9074954,9074949,TXFE7,128,9942,1,13202,6883,6664
9074954,9074953,TXFE7,128,9942,1,13203,6884,6665
9074954,9074953,TXFE7,128,9942,2,13205,6886,6666
9075017,9075007,TXFE7,128,9941,6,13211,6892,6667
9075017,9075007,TXFE7,128,9942,1,13212,6893,6668
9075017,9075008,TXFE7,128,9941,1,13213,6894,6669
9075042,9075030,TXFE7,128,9942,1,13214,6895,6670
9075042,9075039,TXFE7,128,9942,1,13215,6896,6671
9075054,9075045,TXFE7,128,9941,3,13218,6897,6672
9075092,9075082,TXFE7,128,9943,1,13219,6898,6673
9075092,9075086,TXFE7,128,9942,1,13220,6899,6674
9075092,9075087,TXFE7,128,9941,1,13221,6900,6675
9075142,9075139,TXFE7,128,9941,1,13222,6901,6676
9075154,9075149,TXFE7,128,9942,1,13223,6902,6677
9075192,9075186,TXFE7,128,9942,1,13224,6903,6678
9075192,9075187,TXFE7,128,9941,1,13225,6904,6679
9075204,9075195,TXFE7,128,9942,1,13226,6905,6680
9075217,9075205,TXFE7,128,9942,3,13229,6906,6682
9075217,9075211,TXFE7,128,9943,1,13230,6907,6683
9075242,9075229,TXFE7,128,9942,1,13231,6908,6684
9075292,9075285,TXFE7,128,9942,1,13232,6909,6685
9075304,9075295,TXFE7,128,9942,1,13233,6910,6686
9075329,9075320,TXFE7,128,9942,6,13239,6913,6687
9075329,9075329,TXFE7,129,9942,14,13259,6921,6688
9075329,9075329,TXFE7,129,9941,6,13259,6921,6688
9075354,9075342,TXFE7,128,9942,2,13261,6922,6689
9075354,9075342,TXFE7,128,9943,1,13262,6923,6690
9075367,9075366,TXFE7,129,9942,3,13273,6925,6691
9075367,9075366,TXFE7,129,9941,8,13273,6925,6691
9075379,9075372,TXFE7,128,9941,2,13275,6927,6692
9075442,9075431,TXFE7,128,9942,1,13276,6928,6693
9075517,9075507,TXFE7,128,9942,1,13277,6929,6694
9075529,9075521,TXFE7,128,9943,1,13278,6930,6695
9075542,9075533,TXFE7,128,9942,1,13279,6931,6696
9075579,9075573,TXFE7,129,9942,6,13299,6937,6697
9075579,9075573,TXFE7,129,9941,14,13299,6937,6697
9075592,9075584,TXFE7,128,9941,1,13300,6938,6698
9075642,9075641,TXFE7,128,9942,1,13301,6939,6699
9075679,9075676,TXFE7,128,9941,1,13302,6940,6700
9075692,9075690,TXFE7,128,9941,1,13303,6941,6701
9075717,9075705,TXFE7,128,9942,1,13304,6942,6702
9075792,9075783,TXFE7,128,9941,1,13305,6943,6703
9075804,9075797,TXFE7,128,9942,1,13306,6944,6704
9075804,9075803,TXFE7,128,9942,1,13307,6945,6705
9075829,9075826,TXFE7,128,9941,5,13312,6946,6706
9075854,9075846,TXFE7,128,9941,3,13315,6949,6707
9075854,9075847,TXFE7,128,9941,1,13316,6950,6708
9075879,9075874,TXFE7,128,9942,1,13317,6951,6709
9075967,9075958,TXFE7,128,9942,5,13322,6952,6710
9075967,9075960,TXFE7,128,9942,1,13323,6953,6711
9075967,9075963,TXFE7,128,9942,2,13325,6954,6712
9080054,9080050,TXFE7,128,9941,1,13326,6955,6713
9080054,9080051,TXFE7,128,9941,1,13327,6956,6714
9080054,9080053,TXFE7,128,9942,1,13328,6957,6715
9080067,9080060,TXFE7,129,9942,3,13338,6958,6724
9080067,9080060,TXFE7,129,9943,7,13338,6958,6724
9080092,9080086,TXFE7,129,9942,1,13344,6960,6725
9080092,9080086,TXFE7,129,9941,5,13344,6960,6725
9080092,9080092,TXFE7,128,9943,2,13346,6961,6726
9080104,9080092,TXFE7,128,9941,2,13348,6963,6727
9080142,9080133,TXFE7,128,9941,2,13350,6965,6728
9080192,9080187,TXFE7,128,9941,37,13387,6982,6729
9080204,9080192,TXFE7,128,9941,1,13388,6983,6730
9080217,9080207,TXFE7,128,9942,1,13389,6984,6731
9080229,9080225,TXFE7,128,9941,2,13391,6985,6732
9080242,9080230,TXFE7,128,9942,1,13392,6986,6733
9080242,9080234,TXFE7,128,9941,5,13397,6988,6734
9080242,9080238,TXFE7,128,9941,5,13402,6993,6735
9080254,9080243,TXFE7,128,9941,4,13406,6996,6736
9080267,9080254,TXFE7,128,9941,1,13407,6997,6737
9080342,9080340,TXFE7,128,9941,1,13408,6998,6738
9080354,9080350,TXFE7,128,9942,2,13410,6999,6740
9080367,9080358,TXFE7,128,9942,1,13411,7000,6741
9080379,9080375,TXFE7,128,9941,2,13413,7001,6742
9080392,9080390,TXFE7,128,9941,1,13414,7002,6743
9080404,9080393,TXFE7,128,9941,2,13416,7003,6744
9080417,9080414,TXFE7,128,9941,1,13417,7004,6745
9080442,9080430,TXFE7,128,9941,1,13418,7005,6746
9080479,9080475,TXFE7,128,9942,1,13419,7006,6747
9080492,9080489,TXFE7,128,9941,1,13420,7007,6748
9080529,9080518,TXFE7,128,9941,1,13421,7008,6749
9080529,9080526,TXFE7,128,9941,2,13423,7009,6750
9080542,9080533,TXFE7,128,9942,1,13424,7010,6751
9080567,9080562,TXFE7,128,9942,1,13425,7011,6752
9080604,9080600,TXFE7,128,9942,1,13426,7012,6753
9080642,9080634,TXFE7,128,9941,1,13427,7013,6754
9080654,9080650,TXFE7,128,9942,1,13428,7014,6755
9080679,9080673,TXFE7,128,9942,1,13429,7015,6756
9080704,9080692,TXFE7,128,9942,1,13430,7016,6757
9080704,9080699,TXFE7,128,9941,1,13431,7017,6758
9080717,9080714,TXFE7,128,9942,1,13432,7018,6759
9080729,9080723,TXFE7,128,9942,10,13442,7019,6766
9080729,9080728,TXFE7,128,9941,1,13443,7020,6767
9080742,9080734,TXFE7,128,9941,1,13444,7021,6768
9080742,9080741,TXFE7,128,9941,1,13445,7022,6769
9080754,9080745,TXFE7,128,9941,1,13446,7023,6770
9080754,9080753,TXFE7,128,9941,2,13448,7025,6771
9080767,9080757,TXFE7,128,9941,1,13449,7026,6772
9080779,9080767,TXFE7,128,9941,1,13450,7027,6773
9080779,9080779,TXFE7,128,9941,1,13451,7028,6774
9080804,9080800,TXFE7,128,9941,1,13452,7029,6775
9080829,9080820,TXFE7,128,9941,1,13453,7030,6776
9080867,9080855,TXFE7,128,9941,1,13454,7031,6777
9080879,9080874,TXFE7,128,9941,1,13455,7032,6778
9080892,9080883,TXFE7,128,9941,1,13456,7033,6779
9080904,9080894,TXFE7,128,9941,1,13457,7034,6780
9080904,9080899,TXFE7,128,9941,1,13458,7035,6781
9080917,9080913,TXFE7,128,9941,1,13459,7036,6782
9080929,9080923,TXFE7,128,9941,1,13460,7037,6783
9080942,9080936,TXFE7,128,9941,1,13461,7038,6784
9080967,9080957,TXFE7,128,9941,1,13462,7039,6785
9080992,9080983,TXFE7,128,9942,1,13463,7040,6786
9080992,9080987,TXFE7,128,9942,1,13464,7041,6787
9081054,9081054,TXFE7,128,9941,1,13465,7042,6788
9081079,9081069,TXFE7,128,9941,1,13466,7043,6789
9081142,9081134,TXFE7,128,9941,1,13467,7044,6790
9081229,9081225,TXFE7,128,9942,1,13468,7045,6791
9081292,9081287,TXFE7,128,9942,1,13469,7046,6792
9081304,9081293,TXFE7,128,9941,1,13470,7047,6793
9081367,9081364,TXFE7,128,9941,4,13474,7051,6794
9081379,9081370,TXFE7,128,9941,1,13475,7052,6795
9081392,9081380,TXFE7,128,9942,20,13495,7053,6813
9081442,9081433,TXFE7,128,9941,1,13496,7054,6814
9081442,9081435,TXFE7,128,9942,1,13497,7055,6815
9081442,9081438,TXFE7,128,9941,1,13498,7056,6816
9081454,9081444,TXFE7,128,9941,1,13499,7057,6817
9081467,9081460,TXFE7,128,9942,1,13500,7058,6818
9081504,9081499,TXFE7,128,9942,1,13501,7059,6819
9081504,9081503,TXFE7,128,9941,3,13504,7062,6820
9081517,9081514,TXFE7,128,9942,15,13519,7063,6828
9081529,9081518,TXFE7,128,9942,1,13520,7064,6829
9081542,9081531,TXFE7,128,9942,1,13521,7065,6830
9081567,9081562,TXFE7,128,9942,10,13531,7066,6831
9081592,9081581,TXFE7,128,9942,1,13532,7067,6832
9081629,9081618,TXFE7,128,9942,1,13533,7068,6833
9081642,9081630,TXFE7,128,9942,2,13535,7069,6835
9081642,9081636,TXFE7,128,9942,1,13536,7070,6836
9081667,9081661,TXFE7,128,9942,2,13538,7071,6838
9081692,9081690,TXFE7,128,9941,1,13539,7072,6839
9081692,9081690,TXFE7,128,9943,5,13544,7073,6842
9081704,9081692,TXFE7,128,9942,1,13545,7074,6843
9081704,9081696,TXFE7,128,9941,1,13546,7075,6844
9081729,9081719,TXFE7,128,9943,1,13547,7076,6845
9081729,9081727,TXFE7,128,9943,1,13548,7077,6846
9081792,9081792,TXFE7,128,9942,5,13553,7082,6847
9081804,9081801,TXFE7,129,9942,2,13556,7083,6849
9081804,9081801,TXFE7,129,9943,1,13556,7083,6849
9081842,9081829,TXFE7,128,9942,1,13557,7084,6850
9081842,9081835,TXFE7,128,9943,1,13558,7085,6851
9081867,9081866,TXFE7,128,9942,1,13559,7086,6852
9081879,9081879,TXFE7,128,9942,1,13560,7087,6853
9081904,9081894,TXFE7,128,9942,1,13561,7088,6854
9081942,9081937,TXFE7,128,9942,1,13562,7089,6855
9081954,9081948,TXFE7,128,9941,1,13563,7090,6856
9081967,9081957,TXFE7,128,9942,1,13564,7091,6857
9081967,9081961,TXFE7,128,9941,1,13565,7092,6858
9081967,9081965,TXFE7,128,9942,1,13566,7093,6859
9081979,9081969,TXFE7,128,9942,2,13568,7094,6860
9082029,9082023,TXFE7,128,9942,1,13569,7095,6861
9082042,9082035,TXFE7,128,9942,1,13570,7096,6862
9082067,9082057,TXFE7,128,9942,1,13571,7097,6863
9082067,9082066,TXFE7,128,9942,1,13572,7098,6864
9082079,9082069,TXFE7,128,9942,1,13573,7099,6865
9082104,9082092,TXFE7,128,9942,1,13574,7100,6866
9082104,9082096,TXFE7,128,9942,1,13575,7101,6867
9082229,9082217,TXFE7,128,9941,1,13576,7102,6868
9082267,9082255,TXFE7,128,9942,1,13577,7103,6869
9082267,9082260,TXFE7,128,9942,1,13578,7104,6870
9082292,9082288,TXFE7,128,9941,1,13579,7105,6871
9082304,9082297,TXFE7,128,9942,2,13581,7106,6872
9082317,9082314,TXFE7,128,9941,1,13582,7107,6873
9082329,9082326,TXFE7,128,9942,1,13583,7108,6874
9082342,9082331,TXFE7,128,9941,1,13584,7109,6875
9082354,9082352,TXFE7,128,9941,1,13585,7110,6876
9082392,9082390,TXFE7,128,9941,2,13587,7112,6877
9082404,9082392,TXFE7,128,9941,5,13592,7117,6878
9082429,9082424,TXFE7,128,9942,1,13593,7118,6879
9082467,9082454,TXFE7,128,9941,1,13594,7119,6880
9082492,9082491,TXFE7,128,9941,2,13596,7121,6881
9082517,9082509,TXFE7,128,9942,1,13597,7122,6882
9082529,9082521,TXFE7,128,9942,1,13598,7123,6883
9082554,9082552,TXFE7,128,9942,1,13599,7124,6884
9082592,9082581,TXFE7,128,9941,4,13603,7126,6885
9082629,9082624,TXFE7,128,9941,1,13604,7127,6886
9082679,9082676,TXFE7,128,9941,1,13605,7128,6887
9082704,9082703,TXFE7,128,9942,1,13606,7129,6888
9082742,9082739,TXFE7,128,9942,1,13607,7130,6889
9082754,9082753,TXFE7,128,9942,1,13608,7131,6890
9082842,9082839,TXFE7,128,9941,1,13609,7132,6891
9082867,9082857,TXFE7,128,9941,1,13610,7133,6892
9082892,9082885,TXFE7,128,9941,1,13611,7134,6893
9082942,9082938,TXFE7,128,9942,21,13632,7135,6904
9083004,9082993,TXFE7,128,9941,1,13633,7136,6905
9083017,9083006,TXFE7,128,9942,5,13638,7137,6909
9083029,9083025,TXFE7,128,9942,5,13643,7138,6912
9083042,9083034,TXFE7,128,9942,1,13644,7139,6913
9083079,9083069,TXFE7,128,9941,2,13646,7140,6914
9083079,9083069,TXFE7,128,9942,1,13647,7141,6915
9083092,9083084,TXFE7,128,9942,5,13652,7142,6920
9083104,9083094,TXFE7,128,9941,1,13653,7143,6921
9083104,9083096,TXFE7,128,9942,1,13654,7144,6922
9083117,9083105,TXFE7,128,9942,1,13655,7145,6923
9083142,9083129,TXFE7,128,9942,1,13656,7146,6924
9083179,9083179,TXFE7,128,9942,1,13657,7147,6925
9083204,9083193,TXFE7,128,9942,1,13658,7148,6926
9083204,9083195,TXFE7,128,9942,1,13659,7149,6927
9083217,9083209,TXFE7,128,9942,1,13660,7150,6928
9083229,9083221,TXFE7,128,9942,3,13663,7151,6929
9083267,9083258,TXFE7,128,9942,5,13668,7152,6931
9083279,9083268,TXFE7,128,9942,1,13669,7153,6932
9083279,9083278,TXFE7,128,9942,5,13674,7154,6934
9083279,9083279,TXFE7,128,9942,2,13676,7155,6935
9083342,9083342,TXFE7,128,9942,1,13677,7156,6936
9083404,9083398,TXFE7,128,9943,1,13678,7157,6937
9083417,9083411,TXFE7,128,9942,1,13679,7158,6938
9083492,9083485,TXFE7,128,9942,1,13680,7159,6939
9083492,9083485,TXFE7,128,9942,6,13686,7160,6940
9083529,9083522,TXFE7,128,9942,1,13687,7161,6941
9083642,9083631,TXFE7,128,9943,2,13689,7162,6942
9083642,9083633,TXFE7,128,9943,1,13690,7163,6943
9083642,9083633,TXFE7,128,9943,1,13691,7164,6944
9083642,9083639,TXFE7,128,9942,1,13692,7165,6945
9083654,9083652,TXFE7,128,9942,1,13693,7166,6946
9083792,9083787,TXFE7,128,9942,1,13694,7167,6947
9083804,9083793,TXFE7,128,9942,1,13695,7168,6948
9083992,9083983,TXFE7,128,9943,1,13696,7169,6949
9083992,9083987,TXFE7,128,9943,1,13697,7170,6950
9084017,9084009,TXFE7,128,9943,14,13711,7171,6958
9084029,9084021,TXFE7,128,9942,1,13712,7172,6959
9084129,9084118,TXFE7,128,9942,1,13713,7173,6960
9084154,9084148,TXFE7,128,9942,1,13714,7174,6961
9084167,9084160,TXFE7,128,9942,1,13715,7175,6962
9084167,9084164,TXFE7,128,9943,1,13716,7176,6963
9084179,9084173,TXFE7,128,9943,1,13717,7177,6964
9084204,9084199,TXFE7,128,9942,1,13718,7178,6965
9084367,9084361,TXFE7,128,9943,2,13720,7179,6967
9084379,9084368,TXFE7,128,9942,1,13721,7180,6968
9084454,9084444,TXFE7,128,9942,1,13722,7181,6969
9084529,9084524,TXFE7,128,9943,1,13723,7182,6970
9084567,9084565,TXFE7,128,9942,2,13725,7184,6971
9084604,9084599,TXFE7,128,9942,2,13727,7185,6972
9084604,9084603,TXFE7,128,9942,1,13728,7186,6973
9084617,9084614,TXFE7,128,9942,1,13729,7187,6974
9084654,9084645,TXFE7,128,9942,1,13730,7188,6975
9084692,9084690,TXFE7,128,9942,1,13731,7189,6976
9084717,9084711,TXFE7,128,9942,3,13734,7192,6977
9084729,9084723,TXFE7,128,9942,1,13735,7193,6978
9084754,9084746,TXFE7,128,9942,8,13743,7200,6979
9084779,9084775,TXFE7,128,9943,1,13744,7201,6980
9084792,9084786,TXFE7,128,9942,4,13748,7205,6981
9084792,9084791,TXFE7,128,9942,4,13752,7208,6982
9084892,9084886,TXFE7,128,9942,2,13754,7209,6983
9084892,9084889,TXFE7,128,9942,1,13755,7210,6984
9084979,9084969,TXFE7,128,9942,1,13756,7211,6985
9084992,9084984,TXFE7,128,9942,3,13759,7214,6986
9085004,9084995,TXFE7,128,9942,1,13760,7215,6987
9085004,9084997,TXFE7,128,9942,1,13761,7216,6988
9085042,9085041,TXFE7,128,9942,1,13762,7217,6989
9085067,9085062,TXFE7,128,9942,1,13763,7218,6990
9085104,9085098,TXFE7,128,9943,1,13764,7219,6991
9085192,9085185,TXFE7,128,9943,1,13765,7220,6992
9085192,9085186,TXFE7,128,9942,1,13766,7221,6993
9085242,9085233,TXFE7,128,9942,1,13767,7222,6994
9085279,9085274,TXFE7,128,9942,1,13768,7223,6995
9085304,9085293,TXFE7,128,9942,1,13769,7224,6996
9085304,9085304,TXFE7,128,9943,1,13770,7225,6997
9085379,9085377,TXFE7,128,9943,1,13771,7226,6998
9085417,9085413,TXFE7,128,9942,1,13772,7227,6999
9085454,9085451,TXFE7,128,9943,1,13773,7228,7000
9085467,9085462,TXFE7,128,9943,5,13778,7229,7005
9085479,9085475,TXFE7,128,9943,2,13780,7230,7007
9085492,9085483,TXFE7,128,9942,1,13781,7231,7008
9085492,9085486,TXFE7,128,9942,1,13782,7232,7009
9085504,9085503,TXFE7,128,9942,1,13783,7233,7010
9085529,9085519,TXFE7,128,9943,1,13784,7234,7011
9085742,9085735,TXFE7,128,9943,1,13785,7235,7012
9085754,9085749,TXFE7,128,9942,1,13786,7236,7013
9085754,9085751,TXFE7,128,9943,4,13790,7237,7015
9085842,9085836,TXFE7,128,9943,1,13791,7238,7016
9085854,9085852,TXFE7,128,9942,1,13792,7239,7017
9085929,9085922,TXFE7,128,9943,1,13793,7240,7018
9085954,9085946,TXFE7,128,9942,1,13794,7241,7019
9085954,9085949,TXFE7,128,9942,1,13795,7242,7020
9085967,9085955,TXFE7,128,9942,21,13816,7258,7021
9085979,9085967,TXFE7,128,9942,5,13821,7263,7022
9085979,9085967,TXFE7,128,9942,1,13822,7264,7023
9085979,9085967,TXFE7,128,9942,1,13823,7265,7024
9085979,9085970,TXFE7,128,9943,5,13828,7266,7029
9090004,9085995,TXFE7,128,9942,1,13829,7267,7030
9090017,9090012,TXFE7,128,9942,2,13831,7268,7031
9090054,9090049,TXFE7,128,9941,2,13833,7270,7032
9090079,9090078,TXFE7,128,9942,1,13834,7271,7033
9090092,9090082,TXFE7,128,9941,5,13839,7274,7034
9090104,9090094,TXFE7,128,9941,1,13840,7275,7035
9090104,9090095,TXFE7,128,9941,1,13841,7276,7036
9090117,9090106,TXFE7,128,9941,1,13842,7277,7037
9090142,9090131,TXFE7,128,9942,1,13843,7278,7038
9090142,9090137,TXFE7,128,9941,3,13846,7281,7039
9090142,9090140,TXFE7,128,9942,1,13847,7282,7040
9090154,9090144,TXFE7,128,9941,1,13848,7283,7041
9090154,9090146,TXFE7,128,9941,2,13850,7284,7042
9090154,9090150,TXFE7,128,9942,1,13851,7285,7043
9090167,9090160,TXFE7,128,9941,1,13852,7286,7044
9090179,9090169,TXFE7,128,9941,3,13855,7287,7045
9090179,9090175,TXFE7,128,9941,2,13857,7288,7046
9090192,9090180,TXFE7,128,9941,1,13858,7289,7047
9090192,9090186,TXFE7,128,9942,1,13859,7290,7048
9090192,9090189,TXFE7,128,9941,1,13860,7291,7049
9090192,9090190,TXFE7,128,9941,1,13861,7292,7050
9090204,9090193,TXFE7,128,9942,1,13862,7293,7051
9090267,9090257,TXFE7,128,9941,1,13863,7294,7052
9090267,9090258,TXFE7,128,9941,1,13864,7295,7053
9090267,9090265,TXFE7,128,9942,2,13866,7296,7054
9090429,9090419,TXFE7,128,9942,2,13868,7297,7056
9090504,9090503,TXFE7,128,9941,1,13869,7298,7057
9090592,9090582,TXFE7,128,9941,1,13870,7299,7058
9090592,9090585,TXFE7,128,9941,5,13875,7301,7059
9090592,9090587,TXFE7,128,9942,1,13876,7302,7060
9090604,9090592,TXFE7,128,9941,1,13877,7303,7061
9090629,9090620,TXFE7,128,9942,1,13878,7304,7062
9090642,9090637,TXFE7,128,9941,6,13884,7309,7063
9090667,9090663,TXFE7,128,9942,5,13889,7310,7066
9090667,9090667,TXFE7,128,9941,1,13890,7311,7067
9090679,9090676,TXFE7,128,9941,20,13910,7320,7068
9090692,9090686,TXFE7,128,9942,1,13911,7321,7069
9090717,9090708,TXFE7,128,9941,5,13916,7322,7070
9090717,9090710,TXFE7,128,9941,1,13917,7323,7071
9090729,9090718,TXFE7,128,9941,5,13922,7326,7072
9090729,9090726,TXFE7,128,9941,1,13923,7327,7073
9090742,9090733,TXFE7,128,9941,5,13928,7328,7074
9090754,9090751,TXFE7,128,9941,1,13929,7329,7075
9090792,9090786,TXFE7,128,9941,4,13933,7331,7076
9090792,9090790,TXFE7,128,9942,2,13935,7332,7077
9090804,9090795,TXFE7,128,9942,1,13936,7333,7078
9090804,9090797,TXFE7,128,9941,2,13938,7334,7079
9090804,9090798,TXFE7,128,9941,1,13939,7335,7080
9090817,9090815,TXFE7,128,9941,5,13944,7339,7081
9090867,9090858,TXFE7,128,9941,5,13949,7341,7082
9090867,9090862,TXFE7,128,9941,1,13950,7342,7083
9090867,9090863,TXFE7,128,9941,1,13951,7343,7084
9090879,9090877,TXFE7,128,9941,5,13956,7347,7085
9090904,9090894,TXFE7,128,9941,1,13957,7348,7086
9090904,9090895,TXFE7,128,9941,2,13959,7350,7087
9090904,9090896,TXFE7,128,9940,2,13961,7352,7088
9090917,9090908,TXFE7,128,9940,1,13962,7353,7089
9090917,9090908,TXFE7,128,9940,1,13963,7354,7090
9090917,9090910,TXFE7,128,9940,1,13964,7355,7091
9090917,9090912,TXFE7,128,9941,2,13966,7356,7092
9090917,9090913,TXFE7,128,9940,1,13967,7357,7093
9090929,9090918,TXFE7,128,9940,2,13969,7359,7094
9090929,9090918,TXFE7,128,9940,14,13983,7367,7095
9090929,9090925,TXFE7,128,9940,6,13989,7369,7096
9090942,9090930,TXFE7,128,9940,1,13990,7370,7097
9090942,9090931,TXFE7,128,9940,1,13991,7371,7098
9090942,9090934,TXFE7,128,9940,1,13992,7372,7099
9090942,9090938,TXFE7,128,9940,1,13993,7373,7100
9090942,9090940,TXFE7,128,9940,2,13995,7374,7101
9090942,9090942,TXFE7,128,9940,1,13996,7375,7102
9090954,9090946,TXFE7,128,9940,3,13999,7376,7103
9090967,9090959,TXFE7,128,9940,5,14004,7379,7104
9090967,9090959,TXFE7,128,9940,1,14005,7380,7105
9090967,9090960,TXFE7,128,9940,1,14006,7381,7106
9090967,9090961,TXFE7,128,9940,1,14007,7382,7107
9090967,9090964,TXFE7,128,9940,1,14008,7383,7108
9091004,9091002,TXFE7,128,9940,2,14010,7385,7109
9091004,9091004,TXFE7,128,9940,1,14011,7386,7110
9091017,9091016,TXFE7,128,9941,1,14012,7387,7111
9091054,9091050,TXFE7,128,9940,2,14014,7389,7112
9091079,9091070,TXFE7,128,9940,2,14016,7391,7113
9091092,9091085,TXFE7,128,9941,9,14025,7392,7117
9091104,9091101,TXFE7,128,9940,1,14026,7393,7118
9091154,9091145,TXFE7,128,9940,1,14027,7394,7119
9091167,9091157,TXFE7,128,9941,1,14028,7395,7120
9091204,9091199,TXFE7,128,9940,1,14029,7396,7121
9091217,9091216,TXFE7,128,9941,1,14030,7397,7122
9091229,9091225,TXFE7,128,9940,1,14031,7398,7123
9091242,9091237,TXFE7,128,9940,5,14036,7402,7124
9091242,9091238,TXFE7,128,9941,1,14037,7403,7125
9091254,9091244,TXFE7,128,9940,4,14041,7407,7126
9091342,9091335,TXFE7,128,9940,1,14042,7408,7127
9091367,9091367,TXFE7,128,9940,1,14043,7409,7128
9091379,9091370,TXFE7,128,9940,1,14044,7410,7129
9091379,9091375,TXFE7,128,9940,1,14045,7411,7130
9091417,9091409,TXFE7,128,9940,1,14046,7412,7131
9091417,9091415,TXFE7,128,9940,10,14056,7419,7132
9091429,9091417,TXFE7,128,9940,1,14057,7420,7133
9091429,9091424,TXFE7,128,9940,1,14058,7421,7134
9091454,9091446,TXFE7,128,9940,5,14063,7424,7135
9091467,9091458,TXFE7,128,9940,1,14064,7425,7136
9091492,9091480,TXFE7,128,9940,1,14065,7426,7137
9091504,9091495,TXFE7,128,9940,2,14067,7428,7138
9091529,9091520,TXFE7,128,9941,1,14068,7429,7139
9091529,9091520,TXFE7,128,9940,3,14071,7430,7140
9091554,9091542,TXFE7,128,9941,1,14072,7431,7141
9091554,9091550,TXFE7,128,9940,1,14073,7432,7142
9091567,9091560,TXFE7,128,9940,5,14078,7433,7143
9091579,9091570,TXFE7,128,9940,1,14079,7434,7144
9091592,9091588,TXFE7,128,9940,3,14082,7435,7145
9091592,9091590,TXFE7,128,9940,1,14083,7436,7146
9091617,9091606,TXFE7,128,9941,1,14084,7437,7147
9091629,9091618,TXFE7,128,9940,2,14086,7438,7148
9091629,9091619,TXFE7,128,9940,1,14087,7439,7149
9091629,9091620,TXFE7,128,9940,1,14088,7440,7150
9091629,9091624,TXFE7,128,9940,10,14098,7441,7151
9091654,9091642,TXFE7,128,9940,5,14103,7445,7152
9091654,9091642,TXFE7,128,9940,1,14104,7446,7153
9091654,9091646,TXFE7,128,9940,1,14105,7447,7154
9091667,9091660,TXFE7,128,9940,1,14106,7448,7155
9091679,9091671,TXFE7,128,9940,1,14107,7449,7156
9091679,9091676,TXFE7,128,9940,1,14108,7450,7157
9091692,9091682,TXFE7,128,9940,1,14109,7451,7158
9091704,9091694,TXFE7,128,9940,2,14111,7452,7159
9091704,9091697,TXFE7,128,9940,1,14112,7453,7160
9091717,9091705,TXFE7,128,9940,1,14113,7454,7161
9091717,9091710,TXFE7,128,9940,5,14118,7455,7162
9091717,9091714,TXFE7,128,9940,1,14119,7456,7163
9091717,9091715,TXFE7,128,9940,1,14120,7457,7164
9091729,9091719,TXFE7,128,9940,1,14121,7458,7165
9091729,9091723,TXFE7,128,9940,3,14124,7460,7166
9091742,9091735,TXFE7,128,9940,3,14127,7463,7167
9091742,9091737,TXFE7,128,9940,1,14128,7464,7168
9091754,9091745,TXFE7,128,9940,1,14129,7465,7169
9091754,9091749,TXFE7,128,9940,5,14134,7468,7170
9091754,9091749,TXFE7,128,9940,1,14135,7469,7171
9091767,9091765,TXFE7,128,9940,1,14136,7470,7172
9091767,9091767,TXFE7,128,9940,1,14137,7471,7173
9091779,9091770,TXFE7,128,9940,2,14139,7472,7174
9091779,9091776,TXFE7,128,9940,1,14140,7473,7175
9091792,9091781,TXFE7,128,9940,5,14145,7474,7176
9091804,9091796,TXFE7,128,9940,1,14146,7475,7177
9091817,9091814,TXFE7,128,9940,3,14149,7476,7178
9091829,9091820,TXFE7,128,9940,25,14174,7495,7179
9091829,9091822,TXFE7,128,9939,1,14175,7496,7180
9091829,9091823,TXFE7,128,9939,1,14176,7497,7181
9091842,9091830,TXFE7,128,9939,1,14177,7498,7182
9091842,9091830,TXFE7,128,9939,2,14179,7499,7183
9091842,9091830,TXFE7,128,9939,5,14184,7503,7184
9091842,9091832,TXFE7,128,9939,1,14185,7504,7185
9091842,9091839,TXFE7,128,9939,14,14199,7508,7186
9091842,9091840,TXFE7,128,9939,4,14203,7509,7187
9091854,9091842,TXFE7,128,9939,12,14215,7511,7188
9091867,9091857,TXFE7,128,9939,2,14217,7512,7189
9091867,9091860,TXFE7,128,9939,4,14221,7513,7190
9091867,9091864,TXFE7,128,9939,1,14222,7514,7191
9091867,9091866,TXFE7,128,9939,1,14223,7515,7192
9091879,9091867,TXFE7,128,9939,1,14224,7516,7193
9091879,9091868,TXFE7,128,9939,1,14225,7517,7194
9091879,9091869,TXFE7,128,9940,1,14226,7518,7195
9091879,9091873,TXFE7,128,9939,1,14227,7519,7196
9091892,9091880,TXFE7,128,9939,5,14232,7524,7197
9091892,9091884,TXFE7,128,9939,1,14233,7525,7198
9091892,9091888,TXFE7,128,9939,1,14234,7526,7199
9091892,9091890,TXFE7,128,9939,1,14235,7527,7200
9091892,9091892,TXFE7,128,9939,1,14236,7528,7201
9091904,9091894,TXFE7,128,9939,1,14237,7529,7202
9091904,9091896,TXFE7,128,9939,6,14243,7531,7203
9091917,9091915,TXFE7,128,9939,1,14244,7532,7204
9091917,9091916,TXFE7,128,9939,1,14245,7533,7205
9091929,9091924,TXFE7,128,9939,1,14246,7534,7206
9091954,9091943,TXFE7,128,9939,1,14247,7535,7207
9091992,9091982,TXFE7,128,9939,1,14248,7536,7208
9092004,9091996,TXFE7,128,9939,1,14249,7537,7209
9092042,9092042,TXFE7,128,9939,1,14250,7538,7210
9092079,9092073,TXFE7,128,9939,1,14251,7539,7211
9092092,9092083,TXFE7,128,9939,2,14253,7540,7212
9092092,9092087,TXFE7,128,9939,1,14254,7541,7213
9092104,9092099,TXFE7,128,9939,1,14255,7542,7214
9092117,9092108,TXFE7,128,9939,1,14256,7543,7215
9092117,9092113,TXFE7,128,9939,1,14257,7544,7216
9092142,9092132,TXFE7,128,9940,1,14258,7545,7217
9092167,9092164,TXFE7,128,9939,1,14259,7546,7218
9092192,9092179,TXFE7,128,9940,4,14263,7547,7220
9092192,9092185,TXFE7,128,9939,2,14265,7549,7221
9092217,9092212,TXFE7,128,9940,1,14266,7550,7222
9092217,9092214,TXFE7,128,9939,2,14268,7551,7223
9092254,9092247,TXFE7,128,9940,1,14269,7552,7224
9092254,9092249,TXFE7,128,9940,1,14270,7553,7225
9092267,9092262,TXFE7,128,9939,1,14271,7554,7226
9092342,9092330,TXFE7,128,9939,5,14276,7556,7227
9092342,9092336,TXFE7,128,9939,1,14277,7557,7228
9092354,9092347,TXFE7,128,9939,1,14278,7558,7229
9092354,9092351,TXFE7,128,9939,1,14279,7559,7230
9092454,9092444,TXFE7,128,9939,1,14280,7560,7231
9092467,9092455,TXFE7,128,9939,1,14281,7561,7232
9092479,9092471,TXFE7,128,9939,2,14283,7562,7233
9092479,9092475,TXFE7,128,9939,2,14285,7564,7234
9092492,9092484,TXFE7,128,9939,1,14286,7565,7235
9092517,9092516,TXFE7,128,9940,3,14289,7566,7238
9092542,9092530,TXFE7,128,9939,2,14291,7567,7239
9092567,9092558,TXFE7,128,9939,4,14295,7569,7240
9092567,9092564,TXFE7,128,9939,1,14296,7570,7241
9092592,9092587,TXFE7,128,9940,1,14297,7571,7242
9092592,9092590,TXFE7,128,9939,1,14298,7572,7243
9092592,9092590,TXFE7,128,9939,1,14299,7573,7244
9092617,9092608,TXFE7,128,9939,1,14300,7574,7245
9092654,9092651,TXFE7,128,9939,1,14301,7575,7246
9092729,9092729,TXFE7,128,9940,2,14303,7576,7248
9092767,9092763,TXFE7,128,9939,2,14305,7577,7249
9092792,9092789,TXFE7,128,9940,1,14306,7578,7250
9092792,9092791,TXFE7,128,9939,2,14308,7579,7251
9092817,9092809,TXFE7,128,9939,1,14309,7580,7252
9092829,9092825,TXFE7,128,9939,1,14310,7581,7253
9092854,9092851,TXFE7,128,9940,1,14311,7582,7254
9092917,9092917,TXFE7,128,9939,10,14321,7591,7255
9092929,9092926,TXFE7,128,9939,1,14322,7592,7256
9092979,9092978,TXFE7,128,9939,3,14325,7594,7257
9092992,9092980,TXFE7,128,9939,2,14327,7596,7258
9092992,9092982,TXFE7,128,9939,2,14329,7597,7259
9092992,9092983,TXFE7,128,9939,2,14331,7599,7260
9093042,9093038,TXFE7,128,9939,1,14332,7600,7261
9093067,9093055,TXFE7,128,9939,2,14334,7601,7262
9093079,9093073,TXFE7,128,9939,1,14335,7602,7263
9093092,9093082,TXFE7,128,9939,2,14337,7604,7264
9093117,9093116,TXFE7,128,9939,1,14338,7605,7265
9093129,9093119,TXFE7,128,9939,2,14340,7607,7266
9093229,9093225,TXFE7,128,9938,1,14341,7608,7267
9093242,9093230,TXFE7,128,9939,1,14342,7609,7268
9093242,9093231,TXFE7,128,9938,1,14343,7610,7269
9093242,9093236,TXFE7,128,9938,1,14344,7611,7270
9093242,9093237,TXFE7,128,9938,1,14345,7612,7271
9093242,9093237,TXFE7,128,9938,1,14346,7613,7272
9093254,9093247,TXFE7,128,9938,6,14352,7617,7273
9093254,9093249,TXFE7,128,9938,6,14358,7623,7274
9093254,9093250,TXFE7,128,9938,2,14360,7625,7275
9093254,9093251,TXFE7,128,9938,2,14362,7627,7276
9093267,9093255,TXFE7,128,9938,2,14364,7629,7277
9093267,9093258,TXFE7,128,9938,1,14365,7630,7278
9093267,9093264,TXFE7,128,9938,1,14366,7631,7279
9093267,9093266,TXFE7,128,9938,2,14368,7633,7280
9093279,9093268,TXFE7,128,9939,1,14369,7634,7281
9093279,9093277,TXFE7,128,9938,1,14370,7635,7282
9093279,9093277,TXFE7,128,9938,1,14371,7636,7283
9093279,9093277,TXFE7,128,9938,1,14372,7637,7284
9093279,9093278,TXFE7,128,9938,1,14373,7638,7285
9093292,9093282,TXFE7,128,9938,2,14375,7639,7286
9093292,9093283,TXFE7,128,9938,1,14376,7640,7287
9093304,9093297,TXFE7,128,9938,1,14377,7641,7288
9093304,9093304,TXFE7,128,9939,1,14378,7642,7289
9093317,9093314,TXFE7,128,9938,4,14382,7643,7290
9093342,9093336,TXFE7,128,9939,1,14383,7644,7291
9093342,9093337,TXFE7,128,9938,1,14384,7645,7292
9093342,9093342,TXFE7,128,9939,1,14385,7646,7293
9093354,9093347,TXFE7,128,9938,1,14386,7647,7294
9093367,9093356,TXFE7,128,9938,1,14387,7648,7295
9093367,9093360,TXFE7,128,9938,1,14388,7649,7296
9093367,9093360,TXFE7,128,9938,1,14389,7650,7297
9093367,9093362,TXFE7,128,9939,1,14390,7651,7298
9093379,9093372,TXFE7,128,9938,1,14391,7652,7299
9093392,9093391,TXFE7,128,9938,3,14394,7653,7300
9093492,9093481,TXFE7,128,9938,1,14395,7654,7301
9093492,9093485,TXFE7,128,9939,4,14399,7655,7305
9093492,9093489,TXFE7,128,9938,3,14402,7656,7306
9093517,9093513,TXFE7,128,9939,3,14405,7657,7309
9093554,9093546,TXFE7,128,9938,1,14406,7658,7310
9093554,9093547,TXFE7,128,9938,1,14407,7659,7311
9093554,9093548,TXFE7,128,9938,1,14408,7660,7312
9093554,9093550,TXFE7,128,9938,1,14409,7661,7313
9093554,9093551,TXFE7,128,9938,1,14410,7662,7314
9093554,9093553,TXFE7,128,9938,1,14411,7663,7315
9093567,9093555,TXFE7,128,9938,1,14412,7664,7316
9093567,9093556,TXFE7,128,9938,1,14413,7665,7317
9093592,9093586,TXFE7,128,9938,1,14414,7666,7318
9093604,9093599,TXFE7,128,9938,1,14415,7667,7319
9093629,9093617,TXFE7,128,9938,1,14416,7668,7320
9093642,9093638,TXFE7,128,9938,1,14417,7669,7321
9093642,9093642,TXFE7,128,9939,3,14420,7670,7323
9093654,9093649,TXFE7,128,9938,1,14421,7671,7324
9093654,9093654,TXFE7,128,9938,5,14426,7672,7325
9093679,9093674,TXFE7,128,9938,1,14427,7673,7326
9093679,9093678,TXFE7,128,9938,5,14432,7674,7327
9093692,9093679,TXFE7,128,9938,4,14436,7676,7328
9093704,9093694,TXFE7,128,9938,1,14437,7677,7329
9093704,9093696,TXFE7,128,9938,1,14438,7678,7330
9093704,9093703,TXFE7,128,9938,5,14443,7679,7331
9093717,9093710,TXFE7,128,9938,1,14444,7680,7332
9093729,9093719,TXFE7,128,9938,1,14445,7681,7333
9093729,9093722,TXFE7,128,9938,5,14450,7683,7334
9093742,9093734,TXFE7,128,9938,1,14451,7684,7335
9093767,9093761,TXFE7,128,9938,1,14452,7685,7336
9093779,9093768,TXFE7,128,9938,1,14453,7686,7337
9093779,9093769,TXFE7,128,9938,1,14454,7687,7338
9093779,9093777,TXFE7,128,9938,1,14455,7688,7339
9093804,9093802,TXFE7,128,9938,1,14456,7689,7340
9093817,9093812,TXFE7,128,9938,5,14461,7693,7341
9093817,9093815,TXFE7,128,9939,1,14462,7694,7342
9093817,9093816,TXFE7,128,9938,5,14467,7696,7343
9093842,9093831,TXFE7,128,9938,1,14468,7697,7344
9093842,9093831,TXFE7,128,9938,1,14469,7698,7345
9093842,9093841,TXFE7,128,9939,1,14470,7699,7346
9093854,9093854,TXFE7,128,9938,1,14471,7700,7347
9094217,9094205,TXFE7,128,9939,1,14582,7751,7402
9094254,9094247,TXFE7,128,9939,1,14583,7752,7403
9094267,9094262,TXFE7,128,9939,1,14584,7753,7404
9094292,9094288,TXFE7,128,9939,1,14585,7754,7405
9094304,9094295,TXFE7,128,9939,6,14591,7758,7406
9094304,9094300,TXFE7,128,9940,1,14592,7759,7407
9094317,9094311,TXFE7,128,9939,1,14593,7760,7408
9094317,9094314,TXFE7,128,9939,2,14595,7761,7409
9094329,9094322,TXFE7,128,9939,1,14596,7762,7410
9094342,9094330,TXFE7,128,9940,2,14598,7763,7412
9094342,9094332,TXFE7,128,9939,6,14604,7765,7413
9094354,9094342,TXFE7,128,9939,1,14605,7766,7414
9094354,9094349,TXFE7,128,9939,1,14606,7767,7415
9094479,9094469,TXFE7,128,9939,5,14630,7780,7425
9094504,9094496,TXFE7,128,9939,1,14631,7781,7426
9094554,9094551,TXFE7,128,9938,1,14632,7782,7427
9094567,9094559,TXFE7,128,9939,1,14633,7783,7428
9094579,9094571,TXFE7,128,9938,6,14639,7786,7429
9094604,9094599,TXFE7,128,9938,1,14640,7787,7430
9094629,9094625,TXFE7,128,9939,1,14641,7788,7431
9094642,9094638,TXFE7,128,9938,5,14646,7790,7432
9094654,9094642,TXFE7,128,9938,1,14647,7791,7433
9094779,9094773,TXFE7,128,9939,2,14653,7795,7437
9094804,9094802,TXFE7,128,9939,2,14655,7796,7439
9094817,9094809,TXFE7,128,9938,1,14656,7797,7440
9094842,9094837,TXFE7,128,9939,2,14658,7798,7441
9094854,9094849,TXFE7,128,9938,1,14659,7799,7442
9094867,9094861,TXFE7,128,9939,1,14660,7800,7443
9094867,9094862,TXFE7,128,9938,2,14662,7801,7444
9094892,9094887,TXFE7,128,9938,1,14663,7802,7445
9094892,9094891,TXFE7,128,9938,1,14664,7803,7446
9094979,9094969,TXFE7,128,9939,1,14665,7804,7447
9094992,9094982,TXFE7,128,9938,1,14666,7805,7448
9095142,9095135,TXFE7,128,9938,2,14695,7812,7460
9095167,9095165,TXFE7,128,9939,1,14696,7813,7461
9095192,9095190,TXFE7,128,9938,1,14697,7814,7462
9095217,9095210,TXFE7,128,9938,1,14698,7815,7463
9095292,9095287,TXFE7,128,9938,5,14703,7816,7464
9095317,9095310,TXFE7,128,9938,4,14707,7820,7465
9095329,9095317,TXFE7,128,9938,1,14708,7821,7466
9095329,9095329,TXFE7,128,9939,1,14709,7822,7467
9095342,9095341,TXFE7,128,9939,1,14710,7823,7468
9095404,9095392,TXFE7,128,9938,4,14714,7825,7469
9095404,9095394,TXFE7,128,9938,1,14715,7826,7470
9095442,9095429,TXFE7,128,9938,2,14717,7828,7471
9095442,9095440,TXFE7,128,9938,1,14718,7829,7472
9095467,9095465,TXFE7,128,9939,1,14719,7830,7473
9095504,9095493,TXFE7,128,9938,2,14721,7831,7474
9095504,9095497,TXFE7,128,9938,2,14723,7833,7475
9095504,9095502,TXFE7,128,9939,1,14724,7834,7476
9095517,9095513,TXFE7,128,9938,2,14726,7836,7477
9095579,9095578,TXFE7,128,9938,1,14727,7837,7478
9095679,9095676,TXFE7,128,9938,1,14728,7838,7479
9095692,9095681,TXFE7,128,9938,4,14732,7840,7480
9095692,9095682,TXFE7,128,9938,2,14734,7842,7481
9095742,9095740,TXFE7,128,9938,2,14736,7844,7482
9095767,9095764,TXFE7,128,9938,2,14738,7845,7483
9095842,9095838,TXFE7,128,9938,1,14739,7846,7484
9095867,9095859,TXFE7,128,9938,2,14741,7848,7485
9095879,9095874,TXFE7,128,9938,1,14742,7849,7486
9095879,9095878,TXFE7,128,9938,1,14743,7850,7487
9095904,9095899,TXFE7,128,9938,1,14744,7851,7488
9095929,9095920,TXFE7,128,9939,1,14745,7852,7489
9095942,9095935,TXFE7,128,9938,1,14746,7853,7490
9095967,9095959,TXFE7,128,9938,1,14747,7854,7491
9100079,9100079,TXFE7,128,9938,2,14749,7856,7492
9100092,9100086,TXFE7,128,9939,1,14750,7857,7493
9100104,9100094,TXFE7,128,9938,4,14754,7861,7494
9100104,9100098,TXFE7,128,9938,4,14758,7864,7495
9100117,9100110,TXFE7,128,9938,8,14766,7871,7496
9100129,9100117,TXFE7,128,9938,6,14772,7874,7497
9100129,9100120,TXFE7,128,9938,1,14773,7875,7498
9100129,9100122,TXFE7,128,9938,2,14775,7876,7499
9100129,9100126,TXFE7,128,9938,1,14776,7877,7500
9100142,9100133,TXFE7,128,9938,1,14777,7878,7501
9100142,9100135,TXFE7,128,9938,1,14778,7879,7502
9100142,9100136,TXFE7,128,9938,1,14779,7880,7503
9100154,9100144,TXFE7,128,9938,1,14780,7881,7504
9100154,9100153,TXFE7,128,9938,1,14781,7882,7505
9100167,9100154,TXFE7,128,9938,1,14782,7883,7506
9100167,9100155,TXFE7,128,9937,1,14783,7884,7507
9100167,9100157,TXFE7,128,9937,1,14784,7885,7508
9100167,9100160,TXFE7,128,9937,4,14788,7887,7509
9100179,9100169,TXFE7,128,9937,1,14789,7888,7510
9100179,9100170,TXFE7,129,9938,3,14794,7889,7514
9100179,9100170,TXFE7,129,9939,2,14794,7889,7514
9100179,9100172,TXFE7,128,9937,1,14795,7890,7515
9100179,9100172,TXFE7,128,9937,1,14796,7891,7516
9100179,9100172,TXFE7,128,9937,2,14798,7892,7517
9100179,9100173,TXFE7,128,9937,1,14799,7893,7518
9100179,9100174,TXFE7,128,9937,1,14800,7894,7519
9100179,9100175,TXFE7,128,9937,1,14801,7895,7520
9100179,9100176,TXFE7,128,9937,1,14802,7896,7521
9100179,9100178,TXFE7,128,9937,1,14803,7897,7522
9100179,9100178,TXFE7,128,9937,2,14805,7899,7523
9100179,9100179,TXFE7,128,9937,1,14806,7900,7524
9100192,9100181,TXFE7,128,9937,1,14807,7901,7525
9100192,9100187,TXFE7,128,9938,1,14808,7902,7526
9100192,9100188,TXFE7,128,9937,3,14811,7905,7527
9100192,9100191,TXFE7,128,9937,2,14813,7906,7528
9100204,9100192,TXFE7,128,9937,1,14814,7907,7529
9100204,9100197,TXFE7,128,9937,1,14815,7908,7530
9100217,9100209,TXFE7,128,9938,1,14816,7909,7531
9100229,9100220,TXFE7,128,9937,1,14817,7910,7532
9100229,9100222,TXFE7,128,9937,1,14818,7911,7533
9100229,9100224,TXFE7,128,9938,1,14819,7912,7534
9100242,9100234,TXFE7,128,9937,1,14820,7913,7535
9100242,9100234,TXFE7,128,9938,1,14821,7914,7536
9100254,9100244,TXFE7,128,9938,1,14822,7915,7537
9100254,9100246,TXFE7,128,9937,1,14823,7916,7538
9100254,9100252,TXFE7,128,9937,1,14824,7917,7539
9100254,9100253,TXFE7,128,9937,3,14827,7918,7540
9100267,9100255,TXFE7,128,9938,1,14828,7919,7541
9100267,9100256,TXFE7,128,9937,1,14829,7920,7542
9100267,9100256,TXFE7,128,9937,1,14830,7921,7543
9100267,9100257,TXFE7,128,9937,1,14831,7922,7544
9100279,9100269,TXFE7,128,9937,1,14832,7923,7545
9100279,9100279,TXFE7,128,9938,1,14833,7924,7546
9100292,9100286,TXFE7,128,9938,1,14834,7925,7547
9100304,9100297,TXFE7,128,9937,1,14835,7926,7548
9100304,9100300,TXFE7,128,9937,2,14837,7928,7549
9100304,9100302,TXFE7,128,9937,3,14840,7930,7550
9100317,9100308,TXFE7,128,9938,1,14841,7931,7551
9100329,9100326,TXFE7,128,9938,1,14842,7932,7552
9100342,9100339,TXFE7,128,9938,2,14844,7933,7553
9100367,9100355,TXFE7,128,9938,5,14849,7934,7557
9100379,9100373,TXFE7,128,9938,1,14850,7935,7558
9100392,9100387,TXFE7,128,9938,1,14851,7936,7559
9100392,9100387,TXFE7,128,9938,1,14852,7937,7560
9100404,9100392,TXFE7,128,9938,1,14853,7938,7561
9100404,9100393,TXFE7,128,9939,4,14857,7939,7563
9100404,9100395,TXFE7,128,9938,2,14859,7940,7564
9100454,9100452,TXFE7,128,9939,1,14860,7941,7565
9100467,9100463,TXFE7,128,9939,5,14865,7942,7566
9100479,9100479,TXFE7,128,9939,5,14870,7943,7568
9100492,9100483,TXFE7,128,9939,2,14872,7944,7569
9100492,9100486,TXFE7,128,9939,37,14909,7945,7587
9100492,9100489,TXFE7,128,9939,5,14914,7946,7590
9100504,9100492,TXFE7,128,9939,1,14915,7947,7591
9100504,9100492,TXFE7,128,9939,2,14917,7948,7592
9100504,9100492,TXFE7,128,9939,4,14921,7949,7593
9100504,9100492,TXFE7,128,9939,2,14923,7950,7594
9100504,9100492,TXFE7,128,9939,6,14929,7951,7598
9100504,9100492,TXFE7,128,9939,1,14930,7952,7599
9100504,9100492,TXFE7,128,9939,1,14931,7953,7600
9100504,9100492,TXFE7,128,9939,2,14933,7954,7602
9100504,9100496,TXFE7,128,9940,1,14934,7955,7603
9100554,9100542,TXFE7,128,9939,1,14935,7956,7604
9100554,9100546,TXFE7,128,9940,2,14937,7957,7605
9100567,9100559,TXFE7,128,9940,5,14942,7958,7609
9100567,9100559,TXFE7,128,9940,1,14943,7959,7610
9100567,9100566,TXFE7,128,9940,9,14952,7960,7616
9100579,9100574,TXFE7,128,9939,1,14953,7961,7617
9100579,9100576,TXFE7,128,9940,5,14958,7962,7620
9100579,9100576,TXFE7,128,9940,5,14963,7963,7624
9100592,9100579,TXFE7,128,9940,5,14968,7964,7625
9100592,9100587,TXFE7,128,9940,1,14969,7965,7626
9100592,9100590,TXFE7,128,9940,5,14974,7966,7628
9100604,9100602,TXFE7,128,9940,1,14975,7967,7629
9100617,9100604,TXFE7,128,9940,2,14977,7968,7630
9100617,9100605,TXFE7,128,9940,5,14982,7969,7633
9100617,9100609,TXFE7,128,9940,1,14983,7970,7634
9100617,9100610,TXFE7,128,9940,5,14988,7971,7637
9100629,9100617,TXFE7,128,9940,6,14994,7972,7640
9100629,9100617,TXFE7,128,9940,8,15002,7973,7646
9100629,9100617,TXFE7,128,9940,7,15009,7974,7649
9100629,9100620,TXFE7,128,9940,5,15014,7975,7653
9100629,9100621,TXFE7,128,9940,1,15015,7976,7654
9100629,9100626,TXFE7,128,9940,1,15016,7977,7655
9100642,9100629,TXFE7,128,9940,2,15018,7978,7656
9100642,9100629,TXFE7,128,9940,3,15021,7979,7659
9100642,9100629,TXFE7,128,9940,4,15025,7980,7660
9100654,9100647,TXFE7,128,9940,1,15026,7981,7661
9100654,9100654,TXFE7,128,9941,4,15030,7982,7662
9100667,9100655,TXFE7,128,9941,5,15035,7983,7666
9100679,9100668,TXFE7,128,9940,1,15036,7984,7667
9100679,9100673,TXFE7,128,9941,6,15042,7985,7671
9100679,9100674,TXFE7,128,9941,6,15048,7986,7673
9100679,9100676,TXFE7,128,9941,2,15050,7987,7674
9100679,9100677,TXFE7,129,9941,5,15056,7988,7680
9100679,9100677,TXFE7,129,9942,1,15056,7988,7680
9100679,9100677,TXFE7,128,9942,1,15057,7989,7681
9100679,9100679,TXFE7,128,9942,1,15058,7990,7682
9100692,9100679,TXFE7,128,9941,1,15059,7991,7683
9100692,9100688,TXFE7,128,9942,2,15061,7992,7684
9100704,9100698,TXFE7,128,9941,1,15062,7993,7685
9100704,9100703,TXFE7,128,9941,2,15064,7994,7686
9100704,9100703,TXFE7,128,9941,8,15072,7999,7687
9100717,9100708,TXFE7,128,9942,1,15073,8000,7688
9100717,9100710,TXFE7,128,9942,1,15074,8001,7689
9100717,9100711,TXFE7,128,9942,2,15076,8002,7691
9100717,9100714,TXFE7,128,9942,1,15077,8003,7692
9100717,9100714,TXFE7,128,9942,1,15078,8004,7693
9100729,9100717,TXFE7,128,9942,2,15080,8005,7694
9100742,9100737,TXFE7,128,9942,1,15081,8006,7695
9100767,9100755,TXFE7,128,9941,3,15084,8008,7696
9100767,9100759,TXFE7,128,9942,1,15085,8009,7697
9100767,9100762,TXFE7,128,9942,1,15086,8010,7698
9100779,9100768,TXFE7,128,9942,1,15087,8011,7699
9100804,9100794,TXFE7,128,9942,1,15088,8012,7700
9100804,9100796,TXFE7,128,9941,1,15089,8013,7701
9100804,9100799,TXFE7,128,9942,1,15090,8014,7702
9100817,9100810,TXFE7,128,9941,2,15092,8016,7703
9100842,9100835,TXFE7,128,9941,1,15093,8017,7704
9100842,9100836,TXFE7,128,9942,1,15094,8018,7705
9100867,9100861,TXFE7,128,9942,1,15095,8019,7706
9100879,9100873,TXFE7,128,9942,1,15096,8020,7707
9100892,9100879,TXFE7,128,9942,3,15099,8021,7709
9100904,9100893,TXFE7,128,9941,2,15101,8022,7710
9100904,9100899,TXFE7,128,9941,1,15102,8023,7711
9100917,9100914,TXFE7,128,9942,1,15103,8024,7712
9100942,9100938,TXFE7,128,9941,1,15104,8025,7713
9100954,9100947,TXFE7,128,9942,1,15105,8026,7714
9100967,9100964,TXFE7,128,9942,1,15106,8027,7715
9100992,9100982,TXFE7,128,9941,4,15110,8028,7716
9100992,9100984,TXFE7,128,9942,1,15111,8029,7717
9100992,9100985,TXFE7,128,9942,1,15112,8030,7718
9101004,9101000,TXFE7,128,9942,1,15113,8031,7719
9101017,9101011,TXFE7,128,9942,1,15114,8032,7720
9101042,9101034,TXFE7,128,9942,1,15115,8033,7721
9101054,9101054,TXFE7,128,9941,1,15116,8034,7722
9101067,9101060,TXFE7,128,9942,2,15118,8035,7724
9101092,9101085,TXFE7,128,9942,1,15119,8036,7725
9101092,9101090,TXFE7,128,9942,1,15120,8037,7726
9101129,9101123,TXFE7,128,9942,2,15122,8038,7728
9101167,9101159,TXFE7,128,9941,1,15123,8039,7729
9101192,9101180,TXFE7,128,9942,1,15124,8040,7730
9101192,9101185,TXFE7,128,9941,1,15125,8041,7731
9101217,9101215,TXFE7,128,9941,1,15126,8042,7732
9101254,9101242,TXFE7,128,9941,2,15128,8044,7733
9101254,9101242,TXFE7,128,9941,1,15129,8045,7734
9101267,9101257,TXFE7,128,9942,1,15130,8046,7735
9101279,9101279,TXFE7,128,9942,1,15131,8047,7736
9101317,9101310,TXFE7,128,9941,2,15133,8048,7737
9101329,9101328,TXFE7,128,9942,1,15134,8049,7738
9101342,9101334,TXFE7,128,9942,1,15135,8050,7739
9101342,9101337,TXFE7,128,9941,1,15136,8051,7740
9101367,9101355,TXFE7,128,9941,2,15138,8052,7741
9101417,9101411,TXFE7,128,9941,1,15139,8053,7742
9101442,9101431,TXFE7,128,9941,1,15140,8054,7743
9101442,9101442,TXFE7,128,9941,1,15141,8055,7744
9101454,9101449,TXFE7,128,9941,9,15150,8061,7745
9101454,9101449,TXFE7,128,9941,2,15152,8062,7746
9101467,9101455,TXFE7,128,9942,2,15154,8063,7747
9101467,9101459,TXFE7,128,9941,1,15155,8064,7748
9101467,9101459,TXFE7,128,9941,1,15156,8065,7749
9101467,9101459,TXFE7,128,9941,1,15157,8066,7750
9101467,9101459,TXFE7,128,9941,2,15159,8068,7751
9101467,9101459,TXFE7,128,9941,1,15160,8069,7752
9101479,9101468,TXFE7,128,9941,1,15161,8070,7753
9101504,9101493,TXFE7,128,9940,1,15162,8071,7754
9101529,9101518,TXFE7,128,9941,1,15163,8072,7755
9101529,9101526,TXFE7,128,9941,1,15164,8073,7756
9101579,9101572,TXFE7,128,9941,1,15165,8074,7757
9101654,9101642,TXFE7,128,9940,3,15168,8077,7758
9101654,9101647,TXFE7,128,9941,1,15169,8078,7759
9101742,9101737,TXFE7,128,9940,1,15170,8079,7760
9101754,9101745,TXFE7,128,9941,1,15171,8080,7761
9101754,9101750,TXFE7,128,9940,1,15172,8081,7762
9101792,9101785,TXFE7,128,9940,3,15175,8083,7763
9101804,9101804,TXFE7,128,9940,1,15176,8084,7764
9101892,9101889,TXFE7,128,9941,1,15177,8085,7765
9101892,9101889,TXFE7,128,9940,1,15178,8086,7766
9101917,9101914,TXFE7,128,9941,1,15179,8087,7767
9101954,9101947,TXFE7,128,9941,1,15180,8088,7768
9101967,9101955,TXFE7,128,9941,1,15181,8089,7769
9101967,9101956,TXFE7,128,9940,2,15183,8090,7770
9101967,9101961,TXFE7,128,9940,5,15188,8095,7771
9101992,9101986,TXFE7,128,9940,2,15190,8096,7772
9102004,9101997,TXFE7,128,9940,1,15191,8097,7773
9102092,9102081,TXFE7,129,9940,1,15196,8098,7777
9102092,9102081,TXFE7,129,9941,4,15196,8098,7777
9102117,9102107,TXFE7,128,9940,1,15197,8099,7778
9102129,9102124,TXFE7,128,9940,1,15198,8100,7779
9102154,9102147,TXFE7,128,9940,1,15199,8101,7780
9102229,9102221,TXFE7,128,9939,1,15200,8102,7781
9102242,9102235,TXFE7,128,9940,1,15201,8103,7782
9102242,9102240,TXFE7,128,9940,1,15202,8104,7783
9102242,9102242,TXFE7,128,9940,1,15203,8105,7784
9102254,9102253,TXFE7,128,9940,2,15205,8106,7786
9102267,9102262,TXFE7,128,9940,1,15206,8107,7787
9102304,9102303,TXFE7,128,9939,2,15208,8109,7788
9102342,9102331,TXFE7,128,9940,1,15209,8110,7789
9102417,9102407,TXFE7,128,9939,1,15210,8111,7790
9102479,9102476,TXFE7,128,9939,2,15212,8113,7791
9102517,9102516,TXFE7,128,9939,1,15213,8114,7792
9102529,9102526,TXFE7,128,9940,1,15214,8115,7793
9102567,9102559,TXFE7,128,9939,1,15215,8116,7794
9102579,9102573,TXFE7,128,9939,1,15216,8117,7795
9102604,9102595,TXFE7,128,9940,1,15217,8118,7796
9102617,9102605,TXFE7,128,9939,1,15218,8119,7797
9102642,9102637,TXFE7,128,9940,1,15219,8120,7798
9102654,9102654,TXFE7,128,9939,1,15220,8121,7799
9102742,9102741,TXFE7,128,9939,1,15221,8122,7800
9102792,9102783,TXFE7,128,9939,14,15235,8127,7801
9102804,9102803,TXFE7,128,9939,1,15236,8128,7802
9102817,9102811,TXFE7,128,9939,1,15237,8129,7803
9102842,9102830,TXFE7,128,9938,6,15243,8134,7804
9102842,9102833,TXFE7,128,9939,2,15245,8135,7805
9102854,9102842,TXFE7,128,9938,4,15249,8139,7806
9102929,9102928,TXFE7,128,9938,1,15250,8140,7807
9102942,9102930,TXFE7,128,9938,1,15251,8141,7808
9102992,9102982,TXFE7,128,9939,5,15256,8142,7809
9103004,9102992,TXFE7,128,9939,1,15257,8143,7810
9103004,9103004,TXFE7,128,9938,1,15258,8144,7811
9103092,9103083,TXFE7,128,9938,2,15260,8145,7812
9103104,9103095,TXFE7,128,9938,1,15261,8146,7813
9103104,9103095,TXFE7,128,9939,1,15262,8147,7814
9103154,9103147,TXFE7,128,9939,1,15263,8148,7815
9103154,9103148,TXFE7,128,9938,1,15264,8149,7816
9103204,9103200,TXFE7,128,9939,1,15265,8150,7817
9103292,9103287,TXFE7,128,9938,3,15268,8151,7818
9103304,9103302,TXFE7,128,9939,1,15269,8152,7819
9103329,9103322,TXFE7,128,9938,3,15272,8153,7820
9103392,9103387,TXFE7,128,9938,1,15273,8154,7821
9103417,9103416,TXFE7,128,9939,1,15274,8155,7822
9103542,9103538,TXFE7,128,9939,1,15275,8156,7823
9103542,9103542,TXFE7,128,9938,1,15276,8157,7824
9103554,9103543,TXFE7,128,9939,2,15278,8158,7825
9103654,9103652,TXFE7,128,9938,1,15279,8159,7826
9103829,9103825,TXFE7,128,9938,8,15287,8166,7827
9103904,9103904,TXFE7,128,9939,1,15288,8167,7828
9103929,9103921,TXFE7,128,9939,1,15289,8168,7829
9104054,9104042,TXFE7,128,9939,2,15291,8169,7830
9104254,9104253,TXFE7,128,9938,2,15293,8170,7831
9104267,9104256,TXFE7,128,9939,2,15295,8171,7832
9104304,9104294,TXFE7,128,9939,1,15296,8172,7833
9104329,9104320,TXFE7,128,9938,1,15297,8173,7834
9104367,9104355,TXFE7,128,9939,5,15302,8174,7835
9104442,9104432,TXFE7,128,9938,3,15305,8176,7836
9104467,9104463,TXFE7,128,9939,1,15306,8177,7837
9104492,9104481,TXFE7,128,9939,1,15307,8178,7838
9104492,9104487,TXFE7,128,9939,1,15308,8179,7839
9104567,9104558,TXFE7,128,9939,2,15310,8180,7840
9104592,9104589,TXFE7,128,9939,1,15311,8181,7841
9104604,9104593,TXFE7,128,9939,1,15312,8182,7842
9104604,9104597,TXFE7,128,9939,1,15313,8183,7843
9104642,9104630,TXFE7,128,9939,1,15314,8184,7844
9104654,9104646,TXFE7,128,9939,1,15315,8185,7845
9104679,9104670,TXFE7,128,9939,1,15316,8186,7846
9104679,9104676,TXFE7,128,9938,2,15318,8187,7847
9104692,9104682,TXFE7,128,9939,1,15319,8188,7848
9104717,9104709,TXFE7,128,9939,1,15320,8189,7849
9104767,9104757,TXFE7,128,9939,1,15321,8190,7850
9104779,9104778,TXFE7,128,9939,1,15322,8191,7851
9104792,9104790,TXFE7,128,9938,2,15324,8193,7852
9105054,9105044,TXFE7,128,9938,1,15325,8194,7853
9105129,9105120,TXFE7,128,9939,1,15326,8195,7854
9105367,9105367,TXFE7,128,9938,1,15327,8196,7855
9105429,9105417,TXFE7,128,9939,5,15332,8197,7859
9105429,9105426,TXFE7,128,9939,1,15333,8198,7860
9105467,9105465,TXFE7,128,9938,1,15334,8199,7861
9105504,9105496,TXFE7,128,9938,1,15335,8200,7862
9105567,9105556,TXFE7,128,9938,1,15336,8201,7863
9105579,9105571,TXFE7,128,9939,1,15337,8202,7864
9105592,9105590,TXFE7,128,9938,1,15338,8203,7865
9105629,9105624,TXFE7,128,9938,2,15340,8204,7866
9105679,9105676,TXFE7,128,9939,1,15341,8205,7867
9105692,9105682,TXFE7,128,9939,16,15357,8206,7879
9105692,9105686,TXFE7,128,9939,1,15358,8207,7880
9105854,9105851,TXFE7,128,9939,1,15359,8208,7881
9105879,9105869,TXFE7,128,9940,6,15365,8209,7887
9105979,9105975,TXFE7,128,9940,1,15366,8210,7888
9105992,9105983,TXFE7,128,9940,1,15367,8211,7889
9105992,9105986,TXFE7,128,9939,14,15381,8216,7890
9110017,9110007,TXFE7,128,9940,6,15387,8217,7893
9110029,9110028,TXFE7,128,9939,1,15388,8218,7894
9110079,9110073,TXFE7,128,9940,2,15390,8219,7895
9110117,9110115,TXFE7,128,9940,1,15391,8220,7896
9110154,9110144,TXFE7,128,9939,1,15392,8221,7897
9110179,9110172,TXFE7,128,9940,2,15394,8222,7899
9110204,9110196,TXFE7,128,9939,1,15395,8223,7900
9110354,9110349,TXFE7,128,9940,1,15396,8224,7901
9110367,9110356,TXFE7,128,9939,1,15397,8225,7902
9110404,9110396,TXFE7,128,9940,5,15402,8226,7906
9110454,9110448,TXFE7,128,9939,1,15403,8227,7907
9110479,9110475,TXFE7,128,9939,1,15404,8228,7908
9110492,9110490,TXFE7,128,9939,4,15408,8232,7909
9110529,9110522,TXFE7,128,9940,1,15409,8233,7910
9110554,9110548,TXFE7,128,9940,5,15414,8234,7912
9110592,9110582,TXFE7,128,9939,1,15415,8235,7913
9110617,9110605,TXFE7,128,9940,1,15416,8236,7914
9110617,9110617,TXFE7,128,9940,1,15417,8237,7915
9110642,9110631,TXFE7,128,9939,2,15419,8239,7916
9110717,9110715,TXFE7,128,9940,5,15424,8240,7918
9110792,9110784,TXFE7,128,9940,1,15425,8241,7919
9110792,9110788,TXFE7,128,9940,1,15426,8242,7920
9110829,9110827,TXFE7,128,9940,5,15431,8243,7925
9110879,9110874,TXFE7,128,9939,1,15432,8244,7926
9110892,9110884,TXFE7,128,9940,1,15433,8245,7927
9110979,9110968,TXFE7,128,9940,1,15434,8246,7928
9110979,9110971,TXFE7,128,9940,9,15443,8247,7935
9110979,9110974,TXFE7,128,9939,10,15453,8253,7936
9111017,9111012,TXFE7,128,9940,1,15454,8254,7937
9111067,9111058,TXFE7,128,9940,8,15462,8255,7944
9111242,9111231,TXFE7,128,9939,1,15463,8256,7945
9111404,9111403,TXFE7,128,9940,1,15464,8257,7946
9111417,9111412,TXFE7,128,9940,1,15465,8258,7947
9111454,9111446,TXFE7,128,9940,4,15469,8259,7949
9111529,9111527,TXFE7,128,9940,1,15470,8260,7950
9111654,9111645,TXFE7,128,9940,3,15473,8261,7953
9111892,9111881,TXFE7,128,9939,1,15474,8262,7954
9112054,9112050,TXFE7,128,9939,3,15477,8264,7955
9112104,9112103,TXFE7,128,9940,1,15478,8265,7956
9112179,9112171,TXFE7,128,9940,1,15479,8266,7957
9112179,9112176,TXFE7,128,9940,2,15481,8267,7959
9112204,9112199,TXFE7,128,9940,1,15482,8268,7960
9112217,9112208,TXFE7,128,9939,1,15483,8269,7961
9112217,9112208,TXFE7,128,9940,1,15484,8270,7962
9112217,9112209,TXFE7,128,9940,1,15485,8271,7963
9112229,9112225,TXFE7,128,9940,1,15486,8272,7964
9112229,9112226,TXFE7,128,9939,1,15487,8273,7965
9112254,9112243,TXFE7,128,9940,2,15489,8274,7967
9112254,9112252,TXFE7,128,9940,2,15491,8275,7968
9112354,9112345,TXFE7,128,9939,1,15492,8276,7969
9112367,9112363,TXFE7,128,9940,1,15493,8277,7970
9112379,9112375,TXFE7,128,9940,1,15494,8278,7971
9112517,9112505,TXFE7,128,9940,10,15504,8279,7976
9112542,9112535,TXFE7,128,9940,1,15505,8280,7977
9112592,9112588,TXFE7,128,9940,1,15506,8281,7978
9112604,9112600,TXFE7,128,9940,10,15516,8282,7979
9112629,9112622,TXFE7,128,9940,1,15517,8283,7980
9112704,9112693,TXFE7,128,9940,4,15521,8284,7981
9112704,9112698,TXFE7,128,9939,1,15522,8285,7982
9112717,9112711,TXFE7,128,9940,5,15527,8286,7983
9112742,9112731,TXFE7,128,9940,1,15528,8287,7984
9112792,9112783,TXFE7,128,9940,1,15529,8288,7985
9112829,9112829,TXFE7,128,9940,7,15536,8289,7986
9112842,9112835,TXFE7,128,9940,5,15541,8290,7990
9112854,9112842,TXFE7,128,9940,4,15545,8291,7994
9112867,9112865,TXFE7,128,9940,1,15546,8292,7995
9112892,9112886,TXFE7,128,9940,1,15547,8293,7996
9112904,9112901,TXFE7,128,9940,1,15548,8294,7997
9112929,9112929,TXFE7,128,9939,1,15549,8295,7998
9112967,9112959,TXFE7,128,9940,1,15550,8296,7999
9113017,9113009,TXFE7,128,9940,2,15552,8297,8000
9113092,9113087,TXFE7,128,9939,3,15555,8300,8001
9113104,9113102,TXFE7,128,9940,1,15556,8301,8002
9113142,9113134,TXFE7,128,9939,1,15557,8302,8003
9113192,9113189,TXFE7,128,9940,1,15558,8303,8004
9113267,9113262,TXFE7,128,9940,5,15563,8304,8008
9113392,9113385,TXFE7,128,9940,1,15564,8305,8009
9113392,9113385,TXFE7,128,9940,1,15565,8306,8010
9113429,9113419,TXFE7,128,9939,4,15569,8309,8011
9113442,9113432,TXFE7,128,9939,2,15571,8310,8012
9113504,9113494,TXFE7,128,9939,37,15608,8333,8013
9113517,9113504,TXFE7,128,9939,4,15612,8334,8014
9113517,9113504,TXFE7,128,9939,23,15635,8354,8015
9113517,9113506,TXFE7,128,9939,1,15636,8355,8016
9113517,9113512,TXFE7,128,9939,4,15640,8356,8019
9113529,9113520,TXFE7,128,9938,1,15641,8357,8020
9113542,9113535,TXFE7,128,9939,1,15642,8358,8021
9113554,9113548,TXFE7,128,9938,1,15643,8359,8022
9113579,9113568,TXFE7,128,9938,3,15646,8361,8023
9113604,9113597,TXFE7,128,9938,100,15746,8410,8024
9113617,9113604,TXFE7,128,9938,4,15750,8411,8025
9113617,9113604,TXFE7,128,9938,2,15752,8412,8026
9113617,9113604,TXFE7,128,9938,1,15753,8413,8027
9113617,9113604,TXFE7,128,9938,8,15761,8419,8028
9113617,9113604,TXFE7,128,9937,5,15766,8424,8029
9113617,9113605,TXFE7,128,9937,14,15780,8434,8030
9113617,9113605,TXFE7,128,9937,10,15790,8439,8031
9113617,9113606,TXFE7,128,9937,10,15800,8443,8032
9113617,9113606,TXFE7,128,9937,1,15801,8444,8033
9113629,9113617,TXFE7,128,9937,3,15804,8447,8034
9113629,9113617,TXFE7,128,9937,8,15812,8452,8035
9113629,9113617,TXFE7,128,9937,8,15820,8459,8036
9113629,9113617,TXFE7,128,9937,1,15821,8460,8037
9113629,9113617,TXFE7,128,9937,1,15822,8461,8038
9113629,9113617,TXFE7,128,9937,6,15828,8464,8039
9113629,9113617,TXFE7,128,9937,2,15830,8466,8040
9113629,9113617,TXFE7,128,9937,1,15831,8467,8041
9113629,9113617,TXFE7,128,9936,5,15836,8471,8042
9113629,9113619,TXFE7,128,9937,5,15841,8472,8044
9113629,9113621,TXFE7,128,9936,5,15846,8476,8045
9113629,9113625,TXFE7,128,9936,5,15851,8477,8046
9113629,9113627,TXFE7,128,9937,1,15852,8478,8047
9113642,9113629,TXFE7,128,9936,2,15854,8479,8048
9113642,9113631,TXFE7,128,9936,1,15855,8480,8049
9113642,9113634,TXFE7,128,9936,2,15857,8481,8050
9113642,9113634,TXFE7,128,9936,1,15858,8482,8051
9113642,9113635,TXFE7,128,9936,2,15860,8483,8052
9113642,9113636,TXFE7,128,9936,1,15861,8484,8053
9113642,9113638,TXFE7,128,9936,1,15862,8485,8054
9113642,9113640,TXFE7,128,9936,1,15863,8486,8055
9113642,9113640,TXFE7,128,9936,40,15903,8501,8056
9113642,9113642,TXFE7,128,9936,7,15910,8508,8057
9113654,9113642,TXFE7,128,9936,2,15912,8509,8058
9113654,9113642,TXFE7,128,9936,1,15913,8510,8059
9113654,9113642,TXFE7,128,9936,1,15914,8511,8060
9113654,9113646,TXFE7,128,9936,4,15918,8514,8061
9113654,9113646,TXFE7,128,9936,1,15919,8515,8062
9113654,9113648,TXFE7,128,9936,3,15922,8518,8063
9113654,9113650,TXFE7,128,9937,4,15926,8519,8067
9113654,9113650,TXFE7,128,9936,1,15927,8520,8068
9113654,9113651,TXFE7,128,9936,1,15928,8521,8069
9113654,9113651,TXFE7,128,9936,3,15931,8523,8070
9113667,9113655,TXFE7,128,9936,22,15953,8528,8071
9113667,9113656,TXFE7,128,9936,1,15954,8529,8072
9113667,9113660,TXFE7,128,9936,3,15957,8530,8073
9113667,9113661,TXFE7,128,9937,1,15958,8531,8074
9113667,9113664,TXFE7,128,9937,1,15959,8532,8075
9113667,9113665,TXFE7,128,9936,1,15960,8533,8076
9113679,9113667,TXFE7,128,9936,2,15962,8535,8077
9113679,9113667,TXFE7,128,9936,4,15966,8538,8078
9113679,9113667,TXFE7,128,9936,2,15968,8540,8079
9113679,9113667,TXFE7,128,9936,29,15997,8558,8080
9113679,9113669,TXFE7,128,9935,1,15998,8559,8081
9113679,9113673,TXFE7,128,9935,5,16003,8560,8082
9113679,9113679,TXFE7,128,9935,1,16004,8561,8083
9113692,9113680,TXFE7,128,9935,1,16005,8562,8084
9113692,9113683,TXFE7,128,9935,1,16006,8563,8085
9113692,9113684,TXFE7,128,9935,2,16008,8565,8086
9113692,9113684,TXFE7,128,9935,2,16010,8567,8087
9113692,9113684,TXFE7,128,9936,2,16012,8568,8088
9113692,9113684,TXFE7,128,9935,2,16014,8570,8089
9113692,9113684,TXFE7,128,9935,1,16015,8571,8090
9113692,9113685,TXFE7,128,9935,2,16017,8572,8091
9113692,9113685,TXFE7,128,9935,2,16019,8573,8092
9113692,9113688,TXFE7,128,9935,2,16021,8575,8093
9113692,9113689,TXFE7,128,9935,4,16025,8579,8094
9113692,9113689,TXFE7,128,9935,1,16026,8580,8095
9113692,9113692,TXFE7,128,9935,10,16036,8588,8096
9113704,9113692,TXFE7,128,9936,1,16037,8589,8097
9113704,9113693,TXFE7,128,9935,1,16038,8590,8098
9113704,9113693,TXFE7,128,9935,1,16039,8591,8099
9113704,9113694,TXFE7,128,9935,1,16040,8592,8100
9113704,9113695,TXFE7,128,9935,5,16045,8593,8101
9113704,9113696,TXFE7,128,9935,2,16047,8595,8102
9113704,9113701,TXFE7,128,9935,7,16054,8602,8103
9113704,9113702,TXFE7,128,9935,4,16058,8605,8104
9113704,9113703,TXFE7,128,9935,2,16060,8606,8105
9113704,9113703,TXFE7,128,9935,1,16061,8607,8106
9113704,9113704,TXFE7,128,9935,3,16064,8610,8107
9113717,9113705,TXFE7,128,9935,14,16078,8618,8108
9113717,9113705,TXFE7,128,9934,6,16084,8623,8109
9113717,9113705,TXFE7,128,9935,1,16085,8624,8110
9113717,9113706,TXFE7,128,9935,2,16087,8625,8111
9113717,9113707,TXFE7,129,9935,2,16091,8629,8112
9113717,9113707,TXFE7,129,9934,2,16091,8629,8112
9113717,9113708,TXFE7,128,9935,2,16093,8630,8113
9113717,9113709,TXFE7,129,9935,2,16105,8639,8114
9113717,9113709,TXFE7,129,9934,10,16105,8639,8114
9113717,9113709,TXFE7,128,9934,2,16107,8640,8115
9113717,9113711,TXFE7,128,9934,1,16108,8641,8116
9113717,9113712,TXFE7,128,9934,4,16112,8642,8117
9113729,9113717,TXFE7,128,9935,2,16114,8643,8118
9113729,9113719,TXFE7,128,9934,2,16116,8645,8119
9113729,9113719,TXFE7,128,9935,1,16117,8646,8120
9113729,9113720,TXFE7,128,9935,2,16119,8647,8121
9113729,9113720,TXFE7,128,9934,4,16123,8651,8122
9113729,9113720,TXFE7,128,9934,1,16124,8652,8123
9113729,9113721,TXFE7,128,9934,16,16140,8661,8124
9113729,9113722,TXFE7,128,9934,10,16150,8670,8125
9113729,9113724,TXFE7,128,9934,1,16151,8671,8126
9113729,9113725,TXFE7,128,9934,2,16153,8673,8127
9113729,9113725,TXFE7,128,9934,4,16157,8674,8128
9113729,9113726,TXFE7,128,9935,1,16158,8675,8129
9113729,9113726,TXFE7,128,9934,2,16160,8677,8130
9113729,9113726,TXFE7,128,9934,3,16163,8680,8131
9113729,9113727,TXFE7,128,9934,2,16165,8682,8132
9113729,9113727,TXFE7,128,9934,3,16168,8683,8133
9113729,9113728,TXFE7,128,9935,2,16170,8684,8135
9113742,9113729,TXFE7,128,9935,2,16172,8685,8136
9113742,9113729,TXFE7,128,9935,1,16173,8686,8137
9113742,9113729,TXFE7,128,9935,1,16174,8687,8138
9113742,9113730,TXFE7,128,9934,2,16176,8689,8139
9113742,9113730,TXFE7,128,9934,1,16177,8690,8140
9113742,9113733,TXFE7,128,9933,1,16178,8691,8141
9113742,9113733,TXFE7,128,9933,2,16180,8693,8142
9113742,9113735,TXFE7,128,9933,8,16188,8695,8143
9113742,9113735,TXFE7,128,9934,4,16192,8696,8144
9113742,9113736,TXFE7,128,9933,2,16194,8697,8145
9113742,9113737,TXFE7,128,9933,2,16196,8698,8146
9113742,9113739,TXFE7,129,9934,8,16214,8699,8154
9113742,9113739,TXFE7,129,9935,10,16214,8699,8154
9113742,9113741,TXFE7,128,9933,2,16216,8700,8155
9113742,9113741,TXFE7,128,9933,1,16217,8701,8156
9113754,9113743,TXFE7,128,9934,10,16227,8703,8157
9113754,9113743,TXFE7,128,9934,1,16228,8704,8158
9113754,9113744,TXFE7,129,9934,9,16239,8707,8159
9113754,9113744,TXFE7,129,9933,2,16239,8707,8159
9113754,9113745,TXFE7,128,9933,2,16241,8708,8160
9113754,9113747,TXFE7,128,9933,7,16248,8709,8161
9113754,9113748,TXFE7,128,9933,10,16258,8712,8162
9113754,9113750,TXFE7,129,9934,1,16262,8716,8163
9113754,9113750,TXFE7,129,9933,3,16262,8716,8163
9113754,9113751,TXFE7,128,9933,1,16263,8717,8164
9113754,9113752,TXFE7,129,9934,1,16265,8719,8165
9113754,9113752,TXFE7,129,9933,1,16265,8719,8165
9113754,9113753,TXFE7,128,9934,1,16266,8720,8166
9113754,9113754,TXFE7,128,9933,1,16267,8721,8167
9113767,9113754,TXFE7,128,9934,1,16268,8722,8168
9113767,9113755,TXFE7,128,9933,10,16278,8730,8169
9113767,9113755,TXFE7,128,9933,1,16279,8731,8170
9113767,9113756,TXFE7,128,9933,1,16280,8732,8171
9113767,9113758,TXFE7,128,9933,1,16281,8733,8172
9113767,9113758,TXFE7,128,9933,1,16282,8734,8173
9113767,9113760,TXFE7,128,9933,9,16291,8738,8174
9113767,9113760,TXFE7,128,9933,3,16294,8741,8175
9113767,9113762,TXFE7,128,9933,1,16295,8742,8176
9113779,9113769,TXFE7,128,9933,1,16296,8743,8177
9113779,9113769,TXFE7,128,9935,4,16300,8744,8178
9113779,9113770,TXFE7,128,9933,18,16318,8756,8179
9113779,9113771,TXFE7,128,9933,6,16324,8762,8180
9113779,9113772,TXFE7,128,9933,4,16328,8765,8181
9113779,9113772,TXFE7,128,9933,1,16329,8766,8182
9113779,9113772,TXFE7,128,9933,2,16331,8767,8183
9113779,9113773,TXFE7,129,9933,2,16339,8773,8184
9113779,9113773,TXFE7,129,9932,6,16339,8773,8184
9113779,9113774,TXFE7,128,9932,1,16340,8774,8185
9113779,9113775,TXFE7,129,9933,5,16347,8775,8189
9113779,9113775,TXFE7,129,9934,2,16347,8775,8189
9113779,9113775,TXFE7,128,9932,1,16348,8776,8190
9113779,9113777,TXFE7,129,9933,1,16350,8778,8191
9113779,9113777,TXFE7,129,9932,1,16350,8778,8191
9113792,9113779,TXFE7,128,9932,2,16352,8779,8192
9113792,9113779,TXFE7,128,9933,1,16353,8780,8193
9113792,9113780,TXFE7,128,9933,7,16360,8782,8194
9113792,9113781,TXFE7,128,9932,2,16362,8783,8195
9113792,9113782,TXFE7,128,9934,5,16367,8784,8197
9113792,9113783,TXFE7,128,9934,1,16368,8785,8198
9113792,9113787,TXFE7,128,9934,4,16372,8786,8200
9113792,9113788,TXFE7,128,9933,1,16373,8787,8201
9113792,9113790,TXFE7,128,9933,1,16374,8788,8202
9113804,9113796,TXFE7,128,9934,12,16386,8789,8206
9113804,9113797,TXFE7,128,9933,4,16390,8790,8207
9113804,9113800,TXFE7,128,9934,2,16392,8791,8209
9113804,9113800,TXFE7,128,9934,1,16393,8792,8210
9113804,9113800,TXFE7,128,9933,6,16399,8795,8211
9113804,9113801,TXFE7,128,9933,2,16401,8797,8212
9113804,9113803,TXFE7,128,9933,2,16403,8798,8213
9113804,9113804,TXFE7,128,9933,2,16405,8799,8214
9113804,9113804,TXFE7,128,9933,1,16406,8800,8215
9113804,9113804,TXFE7,128,9934,2,16408,8801,8216
9113817,9113804,TXFE7,128,9934,1,16409,8802,8217
9113817,9113804,TXFE7,128,9934,1,16410,8803,8218
9113817,9113805,TXFE7,128,9934,1,16411,8804,8219
9113817,9113806,TXFE7,128,9934,3,16414,8807,8220
9113817,9113806,TXFE7,129,9934,5,16422,8811,8221
9113817,9113806,TXFE7,129,9933,3,16422,8811,8221
9113817,9113806,TXFE7,128,9934,2,16424,8812,8222
9113817,9113807,TXFE7,128,9933,2,16426,8814,8223
9113817,9113807,TXFE7,128,9933,2,16428,8815,8224
9113817,9113808,TXFE7,128,9933,5,16433,8817,8225
9113817,9113808,TXFE7,128,9933,2,16435,8819,8226
9113817,9113808,TXFE7,128,9933,1,16436,8820,8227
9113817,9113810,TXFE7,128,9934,1,16437,8821,8228
9113817,9113811,TXFE7,128,9933,1,16438,8822,8229
9113817,9113816,TXFE7,128,9934,5,16443,8823,8232
9113829,9113817,TXFE7,128,9934,3,16446,8824,8234
9113829,9113817,TXFE7,128,9934,1,16447,8825,8235
9113829,9113819,TXFE7,128,9933,1,16448,8826,8236
9113829,9113821,TXFE7,128,9933,1,16449,8827,8237
9113829,9113822,TXFE7,128,9934,1,16450,8828,8238
9113829,9113824,TXFE7,129,9933,17,16471,8835,8239
9113829,9113824,TXFE7,129,9932,4,16471,8835,8239
9113829,9113826,TXFE7,128,9932,8,16479,8842,8240
9113829,9113827,TXFE7,128,9932,1,16480,8843,8241
9113829,9113829,TXFE7,128,9932,5,16485,8846,8242
9113842,9113836,TXFE7,128,9934,2,16487,8847,8244
9113842,9113836,TXFE7,128,9934,2,16489,8848,8246
9113842,9113839,TXFE7,128,9933,2,16491,8849,8247
9113842,9113840,TXFE7,128,9933,1,16492,8850,8248
9113854,9113845,TXFE7,128,9934,3,16495,8851,8249
9113854,9113846,TXFE7,129,9934,2,16498,8853,8250
9113854,9113846,TXFE7,129,9933,1,16498,8853,8250
9113854,9113847,TXFE7,128,9933,1,16499,8854,8251
9113854,9113851,TXFE7,128,9933,4,16503,8855,8252
9113854,9113852,TXFE7,128,9934,2,16505,8856,8254
9113854,9113854,TXFE7,128,9933,4,16509,8857,8255
9113867,9113861,TXFE7,128,9933,1,16510,8858,8256
9113892,9113881,TXFE7,128,9933,1,16511,8859,8257
9113892,9113884,TXFE7,128,9934,2,16513,8860,8258
9113892,9113884,TXFE7,128,9934,1,16514,8861,8259
9113904,9113900,TXFE7,128,9934,1,16515,8862,8260
9113917,9113905,TXFE7,130,9934,7,16567,8886,8261
9113917,9113905,TXFE7,130,9933,42,16567,8886,8261
9113917,9113905,TXFE7,130,9932,3,16567,8886,8261
9113917,9113911,TXFE7,128,9934,1,16568,8887,8262
9113917,9113913,TXFE7,128,9933,1,16569,8888,8263
9113917,9113916,TXFE7,128,9934,1,16570,8889,8264
9113942,9113936,TXFE7,128,9933,1,16571,8890,8265
9113942,9113940,TXFE7,128,9933,2,16573,8892,8266
9113942,9113940,TXFE7,128,9932,8,16581,8898,8267
9113942,9113941,TXFE7,128,9934,1,16582,8899,8268
9113954,9113942,TXFE7,128,9933,2,16584,8901,8269
9113954,9113947,TXFE7,128,9934,1,16585,8902,8270
9113954,9113948,TXFE7,128,9934,2,16587,8903,8271
9113967,9113955,TXFE7,128,9932,2,16589,8905,8272
9113967,9113960,TXFE7,128,9932,1,16590,8906,8273
9113967,9113963,TXFE7,128,9934,1,16591,8907,8274
9113979,9113969,TXFE7,128,9933,1,16592,8908,8275
9113979,9113973,TXFE7,128,9932,1,16593,8909,8276
9113979,9113978,TXFE7,128,9933,1,16594,8910,8277
9113992,9113987,TXFE7,128,9933,1,16595,8911,8278
9114004,9113995,TXFE7,128,9932,1,16596,8912,8279
9114004,9113997,TXFE7,128,9933,2,16598,8913,8280
9114004,9113997,TXFE7,128,9933,6,16604,8914,8281
9114004,9113997,TXFE7,129,9933,2,16612,8919,8282
9114004,9113997,TXFE7,129,9932,6,16612,8919,8282
9114017,9114008,TXFE7,128,9933,2,16614,8921,8283
9114017,9114008,TXFE7,128,9932,1,16615,8922,8284
9114017,9114012,TXFE7,128,9932,2,16617,8923,8285
9114029,9114017,TXFE7,128,9933,3,16620,8924,8286
9114042,9114029,TXFE7,128,9933,1,16621,8925,8287
9114054,9114043,TXFE7,128,9932,1,16622,8926,8288
9114054,9114046,TXFE7,128,9932,6,16628,8928,8289
9114054,9114046,TXFE7,128,9932,1,16629,8929,8290
9114054,9114050,TXFE7,128,9934,1,16630,8930,8291
9114054,9114051,TXFE7,128,9934,1,16631,8931,8292
9114067,9114054,TXFE7,128,9932,3,16634,8932,8293
9114079,9114077,TXFE7,128,9933,1,16635,8933,8294
9114092,9114079,TXFE7,128,9933,2,16637,8934,8296
9114092,9114081,TXFE7,128,9932,1,16638,8935,8297
9114092,9114082,TXFE7,128,9932,2,16640,8936,8298
9114129,9114123,TXFE7,128,9933,1,16641,8937,8299
9114129,9114125,TXFE7,128,9932,1,16642,8938,8300
9114142,9114129,TXFE7,128,9933,1,16643,8939,8301
9114142,9114136,TXFE7,128,9934,3,16646,8940,8302
9114154,9114143,TXFE7,129,9933,1,16648,8942,8303
9114154,9114143,TXFE7,129,9932,1,16648,8942,8303
9114154,9114148,TXFE7,128,9933,1,16649,8943,8304
9114167,9114159,TXFE7,128,9933,1,16650,8944,8305
9114167,9114163,TXFE7,128,9932,2,16652,8946,8306
9114167,9114166,TXFE7,128,9932,2,16654,8947,8307
9114179,9114167,TXFE7,128,9932,3,16657,8949,8308
9114179,9114168,TXFE7,128,9932,3,16660,8952,8309
9114192,9114179,TXFE7,128,9933,1,16661,8953,8310
9114192,9114182,TXFE7,128,9932,2,16663,8954,8311
9114192,9114186,TXFE7,128,9932,1,16664,8955,8312
9114192,9114192,TXFE7,128,9932,1,16665,8956,8313
9114204,9114197,TXFE7,128,9932,1,16666,8957,8314
9114204,9114203,TXFE7,128,9932,1,16667,8958,8315
9114204,9114204,TXFE7,128,9932,4,16671,8962,8316
9114217,9114204,TXFE7,128,9933,5,16676,8963,8318
9114217,9114204,TXFE7,128,9931,3,16679,8964,8319
9114217,9114207,TXFE7,128,9933,2,16681,8965,8320
9114229,9114219,TXFE7,128,9932,2,16683,8967,8321
9114229,9114220,TXFE7,128,9932,2,16685,8968,8322
9114229,9114220,TXFE7,129,9932,2,16690,8972,8323
9114229,9114220,TXFE7,129,9931,3,16690,8972,8323
9114229,9114220,TXFE7,128,9933,5,16695,8973,8326
9114229,9114220,TXFE7,128,9931,1,16696,8974,8327
9114229,9114220,TXFE7,128,9931,1,16697,8975,8328
9114229,9114221,TXFE7,128,9931,1,16698,8976,8329
9114229,9114222,TXFE7,128,9931,1,16699,8977,8330
9114229,9114222,TXFE7,128,9931,5,16704,8979,8331
9114229,9114222,TXFE7,128,9931,1,16705,8980,8332
9114229,9114223,TXFE7,128,9931,1,16706,8981,8333
9114229,9114225,TXFE7,128,9931,1,16707,8982,8334
9114229,9114225,TXFE7,129,9932,1,16712,8983,8339
9114229,9114225,TXFE7,129,9933,4,16712,8983,8339
9114229,9114225,TXFE7,129,9932,4,16717,8986,8340
9114229,9114225,TXFE7,129,9931,1,16717,8986,8340
9114229,9114226,TXFE7,128,9931,5,16722,8988,8341
9114229,9114227,TXFE7,128,9931,5,16727,8989,8342
9114229,9114227,TXFE7,129,9933,5,16742,8990,8346
9114229,9114227,TXFE7,129,9934,10,16742,8990,8346
9114229,9114229,TXFE7,128,9933,1,16743,8991,8347
9114242,9114231,TXFE7,128,9932,2,16745,8993,8348
9114242,9114237,TXFE7,128,9932,1,16746,8994,8349
9114242,9114241,TXFE7,128,9932,2,16748,8995,8350
9114242,9114241,TXFE7,128,9932,1,16749,8996,8351
9114254,9114245,TXFE7,128,9932,1,16750,8997,8352
9114254,9114250,TXFE7,128,9932,1,16751,8998,8353
9114254,9114251,TXFE7,128,9932,1,16752,8999,8354
9114267,9114257,TXFE7,128,9931,1,16753,9000,8355
9114267,9114258,TXFE7,128,9931,1,16754,9001,8356
9114267,9114263,TXFE7,128,9931,1,16755,9002,8357
9114279,9114268,TXFE7,128,9931,4,16759,9003,8358
9114279,9114279,TXFE7,128,9931,2,16761,9004,8359
9114292,9114281,TXFE7,128,9932,1,16762,9005,8360
9114292,9114285,TXFE7,128,9931,1,16763,9006,8361
9114292,9114285,TXFE7,128,9931,1,16764,9007,8362
9114304,9114292,TXFE7,128,9932,1,16765,9008,8363
9114304,9114295,TXFE7,128,9931,5,16770,9009,8364
9114304,9114296,TXFE7,128,9931,1,16771,9010,8365
9114304,9114302,TXFE7,128,9931,1,16772,9011,8366
9114304,9114304,TXFE7,128,9931,5,16777,9014,8367
9114317,9114306,TXFE7,128,9932,1,16778,9015,8368
9114317,9114308,TXFE7,128,9932,1,16779,9016,8369
9114317,9114309,TXFE7,128,9931,1,16780,9017,8370
9114317,9114314,TXFE7,128,9931,1,16781,9018,8371
9114329,9114317,TXFE7,128,9932,6,16787,9019,8375
9114329,9114323,TXFE7,128,9932,3,16790,9020,8377
9114329,9114326,TXFE7,128,9932,1,16791,9021,8378
9114329,9114327,TXFE7,128,9931,1,16792,9022,8379
9114329,9114328,TXFE7,128,9932,1,16793,9023,8380
9114342,9114329,TXFE7,128,9932,2,16795,9024,8382
9114342,9114335,TXFE7,128,9932,2,16797,9026,8383
9114342,9114337,TXFE7,128,9932,1,16798,9027,8384
9114342,9114338,TXFE7,128,9933,1,16799,9028,8385
9114342,9114341,TXFE7,128,9932,5,16804,9029,8386
9114354,9114345,TXFE7,129,9932,6,16816,9038,8387
9114354,9114345,TXFE7,129,9931,6,16816,9038,8387
9114367,9114356,TXFE7,128,9932,1,16817,9039,8388
9114367,9114356,TXFE7,128,9931,1,16818,9040,8389
9114367,9114364,TXFE7,128,9931,1,16819,9041,8390
9114367,9114365,TXFE7,128,9931,2,16821,9042,8391
9114379,9114367,TXFE7,128,9932,4,16825,9043,8392
9114379,9114367,TXFE7,128,9932,1,16826,9044,8393
9114379,9114369,TXFE7,128,9933,4,16830,9045,8395
9114379,9114372,TXFE7,128,9933,3,16833,9046,8398
9114379,9114379,TXFE7,128,9932,1,16834,9047,8399
9114392,9114390,TXFE7,128,9932,1,16835,9048,8400
9114417,9114413,TXFE7,128,9932,5,16840,9049,8401
9114429,9114419,TXFE7,128,9932,1,16841,9050,8402
9114442,9114431,TXFE7,128,9932,1,16842,9051,8403
9114442,9114440,TXFE7,128,9932,1,16843,9052,8404
9114454,9114447,TXFE7,128,9932,2,16845,9054,8405
9114454,9114450,TXFE7,128,9932,2,16847,9056,8406
9114467,9114461,TXFE7,128,9932,1,16848,9057,8407
9114467,9114465,TXFE7,128,9932,3,16851,9058,8408
9114479,9114467,TXFE7,128,9932,6,16857,9059,8409
9114492,9114486,TXFE7,128,9933,1,16858,9060,8410
9114504,9114496,TXFE7,128,9933,2,16860,9061,8411
9114504,9114496,TXFE7,128,9932,1,16861,9062,8412
9114504,9114499,TXFE7,128,9931,1,16862,9063,8413
9114504,9114501,TXFE7,128,9932,1,16863,9064,8414
9114504,9114502,TXFE7,128,9931,1,16864,9065,8415
9114517,9114508,TXFE7,128,9931,8,16872,9070,8416
9114517,9114512,TXFE7,128,9931,1,16873,9071,8417
9114517,9114512,TXFE7,128,9933,1,16874,9072,8418
9114517,9114513,TXFE7,128,9933,2,16876,9073,8420
9114529,9114517,TXFE7,128,9932,1,16877,9074,8421
9114529,9114518,TXFE7,128,9932,2,16879,9075,8422
9114529,9114528,TXFE7,128,9931,1,16880,9076,8423
9114542,9114531,TXFE7,128,9932,1,16881,9077,8424
9114542,9114532,TXFE7,128,9932,2,16883,9078,8425
9114567,9114565,TXFE7,128,9932,1,16884,9079,8426
9114592,9114582,TXFE7,128,9932,1,16885,9080,8427
9114592,9114583,TXFE7,128,9932,1,16886,9081,8428
9114629,9114622,TXFE7,128,9932,1,16887,9082,8429
9114642,9114638,TXFE7,128,9932,1,16888,9083,8430
9114642,9114639,TXFE7,128,9932,1,16889,9084,8431
9114654,9114648,TXFE7,128,9932,1,16890,9085,8432
9114667,9114657,TXFE7,128,9932,1,16891,9086,8433
9114667,9114662,TXFE7,128,9932,2,16893,9088,8434
9114667,9114666,TXFE7,128,9933,1,16894,9089,8435
9114679,9114672,TXFE7,128,9932,1,16895,9090,8436
9114679,9114676,TXFE7,128,9932,1,16896,9091,8437
9114692,9114689,TXFE7,128,9931,1,16897,9092,8438
9114704,9114692,TXFE7,128,9932,1,16898,9093,8439
9114704,9114699,TXFE7,128,9931,1,16899,9094,8440
9114704,9114704,TXFE7,128,9932,2,16901,9095,8442
9114717,9114704,TXFE7,128,9932,1,16902,9096,8443
9114729,9114719,TXFE7,128,9932,1,16903,9097,8444
9114729,9114729,TXFE7,128,9932,1,16904,9098,8445
9114754,9114746,TXFE7,128,9932,1,16905,9099,8446
9114767,9114760,TXFE7,128,9932,1,16906,9100,8447
9114767,9114763,TXFE7,128,9932,1,16907,9101,8448
9114779,9114778,TXFE7,128,9932,1,16908,9102,8449
9114804,9114792,TXFE7,128,9932,1,16909,9103,8450
9114804,9114803,TXFE7,128,9932,1,16910,9104,8451
9114817,9114804,TXFE7,128,9932,1,16911,9105,8452
9114817,9114809,TXFE7,128,9932,1,16912,9106,8453
9114817,9114816,TXFE7,128,9932,1,16913,9107,8454
9114829,9114817,TXFE7,128,9932,1,16914,9108,8455
9114829,9114817,TXFE7,128,9932,5,16919,9109,8459
9114829,9114822,TXFE7,128,9932,1,16920,9110,8460
9114829,9114824,TXFE7,128,9933,1,16921,9111,8461
9114842,9114834,TXFE7,128,9932,1,16922,9112,8462
9114854,9114846,TXFE7,128,9932,1,16923,9113,8463
9114854,9114853,TXFE7,128,9932,2,16925,9114,8464
9114854,9114853,TXFE7,128,9932,1,16926,9115,8465
9114867,9114857,TXFE7,128,9933,1,16927,9116,8466
9114904,9114900,TXFE7,128,9932,1,16928,9117,8467
9114904,9114901,TXFE7,128,9932,2,16930,9118,8468
9114904,9114904,TXFE7,128,9933,1,16931,9119,8469
9114917,9114911,TXFE7,128,9932,2,16933,9121,8470
9114929,9114925,TXFE7,128,9932,1,16934,9122,8471
9114929,9114926,TXFE7,128,9932,1,16935,9123,8472
9114942,9114932,TXFE7,128,9932,1,16936,9124,8473
9114942,9114938,TXFE7,128,9933,1,16937,9125,8474
9114979,9114969,TXFE7,128,9932,1,16938,9126,8475
9115004,9114993,TXFE7,128,9932,2,16940,9127,8476
9115017,9115005,TXFE7,129,9932,4,16946,9131,8477
9115017,9115005,TXFE7,129,9931,2,16946,9131,8477
9115029,9115022,TXFE7,128,9931,1,16947,9132,8478
9115029,9115024,TXFE7,128,9932,1,16948,9133,8479
9115042,9115039,TXFE7,128,9932,2,16950,9134,8480
9115054,9115044,TXFE7,128,9931,1,16951,9135,8481
9115067,9115064,TXFE7,128,9932,1,16952,9136,8482
9115079,9115075,TXFE7,128,9932,2,16954,9137,8483
9115092,9115084,TXFE7,128,9931,10,16964,9140,8484
9115104,9115100,TXFE7,128,9932,3,16967,9141,8485
9115117,9115114,TXFE7,128,9932,1,16968,9142,8486
9115117,9115115,TXFE7,128,9932,1,16969,9143,8487
9115129,9115122,TXFE7,128,9931,10,16979,9148,8488
9115129,9115126,TXFE7,128,9931,1,16980,9149,8489
9115142,9115140,TXFE7,128,9931,5,16985,9154,8490
9115154,9115143,TXFE7,128,9931,1,16986,9155,8491
9115154,9115143,TXFE7,128,9931,5,16991,9159,8492
9115154,9115148,TXFE7,128,9931,1,16992,9160,8493
9115154,9115152,TXFE7,128,9931,1,16993,9161,8494
9115167,9115155,TXFE7,128,9931,1,16994,9162,8495
9115179,9115172,TXFE7,128,9931,8,17002,9166,8496
9115179,9115176,TXFE7,128,9931,1,17003,9167,8497
9115192,9115181,TXFE7,128,9931,1,17004,9168,8498
9115204,9115204,TXFE7,128,9930,1,17005,9169,8499
9115217,9115207,TXFE7,128,9930,2,17007,9170,8500
9115217,9115208,TXFE7,128,9930,2,17009,9171,8501
9115217,9115210,TXFE7,128,9931,1,17010,9172,8502
9115217,9115211,TXFE7,128,9931,1,17011,9173,8503
9115217,9115211,TXFE7,128,9930,1,17012,9174,8504
9115217,9115211,TXFE7,128,9930,6,17018,9178,8505
9115217,9115211,TXFE7,128,9930,2,17020,9179,8506
9115217,9115211,TXFE7,128,9930,1,17021,9180,8507
9115217,9115212,TXFE7,128,9930,2,17023,9182,8508
9115217,9115212,TXFE7,128,9930,1,17024,9183,8509
9115217,9115213,TXFE7,128,9930,10,17034,9192,8510
9115217,9115214,TXFE7,128,9930,1,17035,9193,8511
9115229,9115220,TXFE7,128,9931,1,17036,9194,8512
9115229,9115225,TXFE7,128,9930,8,17044,9196,8513
9115229,9115225,TXFE7,128,9930,1,17045,9197,8514
9115229,9115226,TXFE7,128,9930,3,17048,9198,8515
9115229,9115226,TXFE7,128,9930,1,17049,9199,8516
9115242,9115230,TXFE7,128,9930,2,17051,9200,8517
9115242,9115230,TXFE7,128,9930,1,17052,9201,8518
9115242,9115231,TXFE7,128,9930,2,17054,9202,8519
9115242,9115232,TXFE7,128,9930,1,17055,9203,8520
9115242,9115234,TXFE7,128,9930,1,17056,9204,8521
9115242,9115234,TXFE7,128,9930,2,17058,9205,8522
9115242,9115234,TXFE7,128,9930,8,17066,9206,8523
9115242,9115239,TXFE7,128,9930,1,17067,9207,8524
9115242,9115242,TXFE7,128,9930,1,17068,9208,8525
9115254,9115243,TXFE7,128,9931,1,17069,9209,8526
9115254,9115243,TXFE7,128,9930,2,17071,9211,8527
9115254,9115244,TXFE7,128,9931,1,17072,9212,8528
9115254,9115247,TXFE7,128,9930,1,17073,9213,8529
9115254,9115248,TXFE7,128,9931,1,17074,9214,8530
9115254,9115248,TXFE7,128,9930,22,17096,9231,8531
9115254,9115252,TXFE7,128,9931,2,17098,9232,8533
9115254,9115253,TXFE7,128,9930,1,17099,9233,8534
9115254,9115254,TXFE7,128,9930,2,17101,9234,8535
9115267,9115254,TXFE7,128,9930,2,17103,9235,8536
9115267,9115254,TXFE7,128,9930,1,17104,9236,8537
9115267,9115254,TXFE7,128,9930,2,17106,9238,8538
9115267,9115254,TXFE7,128,9930,6,17112,9243,8539
9115267,9115254,TXFE7,128,9930,2,17114,9245,8540
9115267,9115254,TXFE7,128,9930,2,17116,9247,8541
9115267,9115257,TXFE7,128,9930,1,17117,9248,8542
9115267,9115259,TXFE7,128,9930,1,17118,9249,8543
9115279,9115267,TXFE7,128,9930,3,17121,9252,8544
9115279,9115267,TXFE7,128,9930,6,17127,9255,8545
9115279,9115267,TXFE7,128,9930,4,17131,9259,8546
9115279,9115267,TXFE7,128,9930,3,17134,9261,8547
9115279,9115267,TXFE7,128,9930,1,17135,9262,8548
9115279,9115267,TXFE7,128,9930,1,17136,9263,8549
9115279,9115267,TXFE7,128,9930,21,17157,9276,8550
9115279,9115269,TXFE7,128,9929,3,17160,9279,8551
9115279,9115274,TXFE7,128,9929,1,17161,9280,8552
9115279,9115274,TXFE7,128,9930,1,17162,9281,8553
9115292,9115282,TXFE7,128,9929,1,17163,9282,8554
9115292,9115284,TXFE7,128,9930,1,17164,9283,8555
9115292,9115287,TXFE7,128,9929,1,17165,9284,8556
9115292,9115287,TXFE7,128,9929,2,17167,9286,8557
9115292,9115287,TXFE7,128,9929,1,17168,9287,8558
9115304,9115293,TXFE7,128,9929,1,17169,9288,8559
9115304,9115297,TXFE7,128,9929,1,17170,9289,8560
9115304,9115298,TXFE7,129,9929,24,17196,9299,8561
9115304,9115298,TXFE7,129,9928,2,17196,9299,8561
9115304,9115303,TXFE7,128,9930,1,17197,9300,8562
9115317,9115305,TXFE7,128,9928,1,17198,9301,8563
9115317,9115305,TXFE7,128,9928,2,17200,9302,8564
9115317,9115306,TXFE7,128,9928,1,17201,9303,8565
9115317,9115307,TXFE7,128,9929,1,17202,9304,8566
9115317,9115309,TXFE7,128,9928,1,17203,9305,8567
9115317,9115309,TXFE7,128,9928,6,17209,9311,8568
9115317,9115309,TXFE7,128,9928,1,17210,9312,8569
9115317,9115313,TXFE7,128,9928,3,17213,9314,8570
9115317,9115315,TXFE7,128,9928,1,17214,9315,8571
9115329,9115318,TXFE7,128,9928,8,17222,9320,8572
9115329,9115321,TXFE7,128,9928,8,17230,9325,8573
9115329,9115322,TXFE7,128,9928,2,17232,9327,8574
9115329,9115323,TXFE7,128,9928,2,17234,9329,8575
9115329,9115325,TXFE7,128,9928,1,17235,9330,8576
9115329,9115325,TXFE7,128,9928,1,17236,9331,8577
9115329,9115327,TXFE7,128,9928,1,17237,9332,8578
9115329,9115329,TXFE7,128,9928,1,17238,9333,8579
9115342,9115330,TXFE7,128,9928,9,17247,9337,8580
9115342,9115333,TXFE7,128,9929,3,17250,9338,8582
9115342,9115334,TXFE7,128,9929,1,17251,9339,8583
9115342,9115339,TXFE7,128,9928,1,17252,9340,8584
9115342,9115341,TXFE7,128,9928,1,17253,9341,8585
9115342,9115342,TXFE7,128,9928,2,17255,9342,8586
9115354,9115348,TXFE7,128,9928,1,17256,9343,8587
9115367,9115356,TXFE7,128,9928,1,17257,9344,8588
9115367,9115358,TXFE7,128,9928,1,17258,9345,8589
9115367,9115365,TXFE7,128,9929,1,17259,9346,8590
9115379,9115369,TXFE7,128,9928,5,17264,9347,8591
9115379,9115369,TXFE7,128,9928,13,17277,9357,8592
9115379,9115374,TXFE7,128,9927,1,17278,9358,8593
9115379,9115376,TXFE7,128,9928,5,17283,9359,8594
9115392,9115380,TXFE7,128,9927,22,17305,9371,8595
9115392,9115382,TXFE7,128,9928,2,17307,9372,8596
9115392,9115385,TXFE7,128,9927,1,17308,9373,8597
9115392,9115385,TXFE7,128,9927,2,17310,9375,8598
9115392,9115385,TXFE7,128,9927,1,17311,9376,8599
9115392,9115387,TXFE7,128,9928,1,17312,9377,8600
9115392,9115387,TXFE7,129,9927,6,17322,9385,8601
9115392,9115387,TXFE7,129,9926,4,17322,9385,8601
9115392,9115389,TXFE7,128,9926,1,17323,9386,8602
9115392,9115391,TXFE7,128,9926,1,17324,9387,8603
9115404,9115393,TXFE7,128,9926,3,17327,9390,8604
9115404,9115395,TXFE7,128,9926,2,17329,9392,8605
9115404,9115396,TXFE7,128,9926,1,17330,9393,8606
9115404,9115401,TXFE7,128,9926,1,17331,9394,8607
9115404,9115403,TXFE7,128,9927,1,17332,9395,8608
9115417,9115405,TXFE7,128,9926,1,17333,9396,8609
9115417,9115405,TXFE7,128,9926,3,17336,9397,8610
9115417,9115405,TXFE7,128,9926,3,17339,9398,8611
9115417,9115407,TXFE7,128,9926,2,17341,9400,8612
9115417,9115407,TXFE7,128,9928,1,17342,9401,8613
9115417,9115409,TXFE7,128,9926,2,17344,9402,8614
9115417,9115410,TXFE7,128,9926,6,17350,9403,8615
9115417,9115410,TXFE7,128,9926,1,17351,9404,8616
9115417,9115412,TXFE7,128,9926,1,17352,9405,8617
9115417,9115413,TXFE7,128,9926,1,17353,9406,8618
9115429,9115417,TXFE7,128,9926,2,17355,9408,8619
9115429,9115418,TXFE7,128,9927,2,17357,9409,8621
9115429,9115419,TXFE7,128,9927,1,17358,9410,8622
9115429,9115419,TXFE7,128,9926,1,17359,9411,8623
9115429,9115422,TXFE7,128,9926,2,17361,9412,8624
9115429,9115424,TXFE7,128,9927,4,17365,9413,8627
9115429,9115429,TXFE7,128,9927,1,17366,9414,8628
9115442,9115431,TXFE7,128,9926,1,17367,9415,8629
9115442,9115432,TXFE7,128,9927,1,17368,9416,8630
9115442,9115433,TXFE7,128,9927,4,17372,9417,8631
9115442,9115436,TXFE7,128,9926,4,17376,9420,8632
9115442,9115439,TXFE7,129,9927,2,17379,9421,8634
9115442,9115439,TXFE7,129,9928,1,17379,9421,8634
9115454,9115449,TXFE7,128,9927,1,17380,9422,8635
9115454,9115450,TXFE7,128,9927,1,17381,9423,8636
9115454,9115451,TXFE7,128,9928,1,17382,9424,8637
9115454,9115453,TXFE7,128,9927,1,17383,9425,8638
9115467,9115459,TXFE7,128,9927,1,17384,9426,8639
9115467,9115463,TXFE7,128,9927,4,17388,9427,8640
9115479,9115468,TXFE7,128,9927,1,17389,9428,8641
9115479,9115473,TXFE7,128,9928,3,17392,9429,8643
9115479,9115474,TXFE7,128,9927,4,17396,9430,8644
9115479,9115476,TXFE7,128,9927,2,17398,9432,8645
9115479,9115476,TXFE7,128,9927,2,17400,9433,8646
9115479,9115478,TXFE7,128,9928,2,17402,9434,8647
9115492,9115480,TXFE7,128,9927,2,17404,9435,8648
9115492,9115480,TXFE7,128,9927,2,17406,9436,8649
9115492,9115481,TXFE7,128,9928,1,17407,9437,8650
9115492,9115482,TXFE7,128,9927,2,17409,9438,8651
9115492,9115482,TXFE7,128,9927,2,17411,9439,8652
9115492,9115484,TXFE7,128,9927,2,17413,9440,8653
9115492,9115484,TXFE7,128,9927,2,17415,9441,8654
9115492,9115485,TXFE7,128,9927,2,17417,9442,8655
9115492,9115486,TXFE7,128,9927,1,17418,9443,8656
9115504,9115493,TXFE7,128,9927,1,17419,9444,8657
9115504,9115494,TXFE7,128,9927,1,17420,9445,8658
9115504,9115500,TXFE7,128,9927,2,17422,9446,8659
9115504,9115501,TXFE7,128,9928,3,17425,9447,8660
9115517,9115505,TXFE7,128,9928,1,17426,9448,8661
9115517,9115506,TXFE7,128,9927,1,17427,9449,8662
9115517,9115515,TXFE7,128,9928,1,17428,9450,8663
9115529,9115517,TXFE7,128,9928,5,17433,9451,8664
9115529,9115517,TXFE7,128,9927,1,17434,9452,8665
9115529,9115521,TXFE7,128,9928,1,17435,9453,8666
9115529,9115525,TXFE7,128,9928,1,17436,9454,8667
9115542,9115529,TXFE7,128,9928,4,17440,9455,8670
9115542,9115530,TXFE7,128,9928,5,17445,9456,8673
9115542,9115534,TXFE7,128,9929,3,17448,9457,8675
9115542,9115538,TXFE7,128,9929,1,17449,9458,8676
9115554,9115547,TXFE7,128,9928,1,17450,9459,8677
9115554,9115553,TXFE7,128,9928,1,17451,9460,8678
9115567,9115558,TXFE7,128,9929,1,17452,9461,8679
9115567,9115565,TXFE7,128,9929,3,17455,9462,8680
9115592,9115583,TXFE7,128,9929,5,17460,9463,8683
9115592,9115591,TXFE7,128,9928,7,17467,9467,8684
9115592,9115591,TXFE7,128,9928,3,17470,9468,8685
9115604,9115592,TXFE7,128,9928,1,17471,9469,8686
9115617,9115616,TXFE7,128,9928,1,17472,9470,8687
9115629,9115621,TXFE7,128,9928,1,17473,9471,8688
9115629,9115624,TXFE7,128,9928,1,17474,9472,8689
9115629,9115627,TXFE7,128,9928,1,17475,9473,8690
9115629,9115629,TXFE7,128,9929,1,17476,9474,8691
9115642,9115640,TXFE7,128,9929,5,17481,9475,8693
9115642,9115640,TXFE7,128,9928,2,17483,9477,8694
9115642,9115641,TXFE7,128,9929,30,17513,9478,8705
9115642,9115642,TXFE7,128,9929,1,17514,9479,8706
9115654,9115644,TXFE7,128,9928,1,17515,9480,8707
9115654,9115648,TXFE7,128,9930,1,17516,9481,8708
9115654,9115651,TXFE7,128,9929,1,17517,9482,8709
9115654,9115653,TXFE7,128,9929,4,17521,9483,8710
9115667,9115654,TXFE7,128,9929,2,17523,9484,8711
9115667,9115654,TXFE7,128,9929,1,17524,9485,8712
9115667,9115656,TXFE7,128,9929,2,17526,9486,8713
9115667,9115664,TXFE7,128,9929,1,17527,9487,8714
9115667,9115667,TXFE7,128,9928,1,17528,9488,8715
9115679,9115667,TXFE7,128,9928,1,17529,9489,8716
9115679,9115676,TXFE7,128,9930,1,17530,9490,8717
9115704,9115699,TXFE7,128,9929,2,17532,9492,8718
9115704,9115699,TXFE7,128,9929,1,17533,9493,8719
9115717,9115708,TXFE7,128,9929,1,17534,9494,8720
9115717,9115715,TXFE7,128,9928,1,17535,9495,8721
9115717,9115715,TXFE7,128,9929,1,17536,9496,8722
9115729,9115717,TXFE7,128,9929,1,17537,9497,8723
9115729,9115726,TXFE7,128,9930,1,17538,9498,8724
9115742,9115730,TXFE7,128,9930,1,17539,9499,8725
9115742,9115735,TXFE7,128,9929,1,17540,9500,8726
9115754,9115744,TXFE7,128,9929,1,17541,9501,8727
9115754,9115750,TXFE7,128,9929,5,17546,9504,8728
9115754,9115753,TXFE7,128,9930,1,17547,9505,8729
9115767,9115756,TXFE7,128,9930,1,17548,9506,8730
9115779,9115772,TXFE7,128,9930,3,17551,9507,8732
9115779,9115779,TXFE7,128,9928,1,17552,9508,8733
9115792,9115781,TXFE7,128,9929,1,17553,9509,8734
9115792,9115782,TXFE7,128,9928,1,17554,9510,8735
9115792,9115783,TXFE7,128,9928,30,17584,9523,8736
9115792,9115784,TXFE7,128,9928,1,17585,9524,8737
9115792,9115784,TXFE7,128,9928,1,17586,9525,8738
9115792,9115787,TXFE7,128,9928,1,17587,9526,8739
9115792,9115791,TXFE7,128,9929,1,17588,9527,8740
9115804,9115794,TXFE7,128,9929,1,17589,9528,8741
9115804,9115799,TXFE7,128,9928,1,17590,9529,8742
9115804,9115803,TXFE7,128,9928,1,17591,9530,8743
9115817,9115809,TXFE7,128,9928,1,17592,9531,8744
9115817,9115810,TXFE7,128,9929,3,17595,9532,8746
9115829,9115819,TXFE7,128,9928,1,17596,9533,8747
9115829,9115820,TXFE7,128,9929,1,17597,9534,8748
9115829,9115822,TXFE7,128,9929,1,17598,9535,8749
9115829,9115827,TXFE7,128,9929,2,17600,9536,8750
9115842,9115830,TXFE7,128,9929,1,17601,9537,8751
9115842,9115838,TXFE7,128,9929,1,17602,9538,8752
9115842,9115842,TXFE7,128,9929,1,17603,9539,8753
9115867,9115863,TXFE7,128,9928,1,17604,9540,8754
9115867,9115865,TXFE7,128,9928,1,17605,9541,8755
9115879,9115879,TXFE7,128,9928,1,17606,9542,8756
9115892,9115882,TXFE7,128,9929,1,17607,9543,8757
9115892,9115883,TXFE7,128,9929,1,17608,9544,8758
9115892,9115884,TXFE7,128,9929,1,17609,9545,8759
9115892,9115889,TXFE7,128,9928,1,17610,9546,8760
9115904,9115894,TXFE7,128,9928,1,17611,9547,8761
9115904,9115895,TXFE7,128,9929,1,17612,9548,8762
9115904,9115902,TXFE7,128,9929,1,17613,9549,8763
9115929,9115921,TXFE7,128,9929,7,17620,9550,8767
9115929,9115927,TXFE7,128,9928,2,17622,9552,8768
9115942,9115930,TXFE7,128,9929,1,17623,9553,8769
9115942,9115932,TXFE7,128,9928,1,17624,9554,8770
9115942,9115936,TXFE7,128,9928,1,17625,9555,8771
9115942,9115941,TXFE7,128,9928,2,17627,9557,8772
9115954,9115943,TXFE7,128,9928,2,17629,9559,8773
9115954,9115944,TXFE7,128,9928,3,17632,9560,8774
9115954,9115945,TXFE7,128,9930,1,17633,9561,8775
9115954,9115945,TXFE7,128,9929,3,17636,9562,8776
9115967,9115959,TXFE7,128,9930,1,17637,9563,8777
9115979,9115979,TXFE7,128,9928,5,17642,9568,8778
9115992,9115984,TXFE7,128,9928,2,17644,9570,8779
9115992,9115985,TXFE7,128,9928,2,17646,9572,8780
9115992,9115985,TXFE7,128,9928,2,17648,9574,8781
9115992,9115988,TXFE7,128,9928,15,17663,9584,8782
9115992,9115989,TXFE7,128,9928,1,17664,9585,8783
9120004,9115992,TXFE7,128,9928,3,17667,9587,8784
9120004,9115994,TXFE7,128,9929,1,17668,9588,8785
9120004,9120000,TXFE7,128,9929,1,17669,9589,8786
9120004,9120003,TXFE7,128,9928,2,17671,9590,8787
9120004,9120004,TXFE7,128,9928,2,17673,9591,8788
9120017,9120005,TXFE7,128,9929,2,17675,9592,8789
9120029,9120024,TXFE7,128,9928,4,17679,9596,8790
9120029,9120025,TXFE7,128,9929,1,17680,9597,8791
9120042,9120038,TXFE7,128,9929,2,17682,9598,8792
9120054,9120047,TXFE7,128,9929,1,17683,9599,8793
9120054,9120049,TXFE7,128,9929,9,17692,9600,8800
9120054,9120051,TXFE7,128,9928,5,17697,9604,8801
9120079,9120072,TXFE7,128,9928,2,17699,9606,8802
9120079,9120074,TXFE7,128,9928,2,17701,9608,8803
9120092,9120082,TXFE7,128,9929,1,17702,9609,8804
9120092,9120084,TXFE7,128,9929,1,17703,9610,8805
9120092,9120086,TXFE7,128,9928,1,17704,9611,8806
9120092,9120089,TXFE7,128,9928,1,17705,9612,8807
9120117,9120117,TXFE7,128,9928,5,17710,9616,8808
9120129,9120117,TXFE7,128,9929,9,17719,9617,8810
9120129,9120120,TXFE7,129,9928,5,17725,9620,8811
9120129,9120120,TXFE7,129,9927,1,17725,9620,8811
9120129,9120125,TXFE7,129,9928,1,17731,9622,8812
9120129,9120125,TXFE7,129,9927,5,17731,9622,8812
9120142,9120129,TXFE7,128,9928,1,17732,9623,8813
9120142,9120131,TXFE7,128,9928,1,17733,9624,8814
9120167,9120155,TXFE7,128,9928,1,17734,9625,8815
9120167,9120160,TXFE7,128,9927,1,17735,9626,8816
9120167,9120161,TXFE7,128,9928,1,17736,9627,8817
9120167,9120162,TXFE7,128,9928,1,17737,9628,8818
9120167,9120163,TXFE7,128,9927,1,17738,9629,8819
9120167,9120164,TXFE7,128,9927,1,17739,9630,8820
9120167,9120166,TXFE7,128,9927,1,17740,9631,8821
9120179,9120169,TXFE7,128,9928,1,17741,9632,8822
9120179,9120174,TXFE7,128,9928,1,17742,9633,8823
9120192,9120185,TXFE7,128,9928,1,17743,9634,8824
9120204,9120200,TXFE7,128,9927,2,17745,9635,8825
9120217,9120212,TXFE7,128,9927,1,17746,9636,8826
9120217,9120217,TXFE7,128,9927,2,17748,9638,8827
9120217,9120217,TXFE7,128,9928,1,17749,9639,8828
9120229,9120218,TXFE7,128,9927,1,17750,9640,8829
9120229,9120219,TXFE7,128,9927,1,17751,9641,8830
9120229,9120220,TXFE7,128,9927,2,17753,9643,8831
9120229,9120222,TXFE7,128,9927,1,17754,9644,8832
9120229,9120224,TXFE7,128,9928,1,17755,9645,8833
9120229,9120229,TXFE7,128,9928,1,17756,9646,8834
9120242,9120234,TXFE7,128,9927,1,17757,9647,8835
9120242,9120235,TXFE7,128,9928,1,17758,9648,8836
9120242,9120237,TXFE7,128,9928,3,17761,9649,8837
9120242,9120237,TXFE7,128,9928,2,17763,9650,8838
9120242,9120240,TXFE7,128,9927,3,17766,9652,8839
9120254,9120243,TXFE7,128,9927,1,17767,9653,8840
9120254,9120248,TXFE7,128,9927,1,17768,9654,8841
9120267,9120264,TXFE7,128,9928,3,17771,9655,8842
9120267,9120267,TXFE7,128,9928,2,17773,9656,8843
9120279,9120271,TXFE7,128,9928,9,17782,9657,8848
9120279,9120272,TXFE7,128,9928,1,17783,9658,8849
9120279,9120279,TXFE7,128,9928,1,17784,9659,8850
9120292,9120290,TXFE7,128,9928,1,17785,9660,8851
9120304,9120292,TXFE7,128,9927,5,17790,9663,8852
9120317,9120306,TXFE7,128,9927,5,17795,9668,8853
9120317,9120310,TXFE7,128,9928,1,17796,9669,8854
9120317,9120310,TXFE7,128,9927,2,17798,9671,8855
9120329,9120318,TXFE7,128,9928,1,17799,9672,8856
9120329,9120318,TXFE7,128,9927,2,17801,9673,8857
9120329,9120327,TXFE7,128,9928,1,17802,9674,8858
9120342,9120332,TXFE7,129,9927,3,17852,9698,8859
9120342,9120332,TXFE7,129,9926,47,17852,9698,8859
9120342,9120332,TXFE7,128,9926,1,17853,9699,8860
9120354,9120350,TXFE7,128,9926,1,17854,9700,8861
9120354,9120350,TXFE7,128,9926,2,17856,9701,8862
9120354,9120350,TXFE7,128,9926,1,17857,9702,8863
9120354,9120350,TXFE7,128,9926,1,17858,9703,8864
9120354,9120351,TXFE7,128,9926,2,17860,9705,8865
9120354,9120353,TXFE7,128,9926,2,17862,9706,8866
9120354,9120354,TXFE7,128,9926,1,17863,9707,8867
9120367,9120354,TXFE7,128,9926,2,17865,9708,8868
9120367,9120354,TXFE7,128,9926,1,17866,9709,8869
9120367,9120354,TXFE7,128,9926,11,17877,9716,8870
9120367,9120355,TXFE7,128,9925,2,17879,9718,8871
9120367,9120358,TXFE7,128,9925,1,17880,9719,8872
9120367,9120366,TXFE7,128,9925,2,17882,9721,8873
9120379,9120368,TXFE7,128,9925,1,17883,9722,8874
9120379,9120370,TXFE7,128,9925,5,17888,9723,8875
9120392,9120380,TXFE7,128,9925,8,17896,9727,8876
9120392,9120382,TXFE7,128,9925,4,17900,9728,8877
9120392,9120383,TXFE7,128,9925,3,17903,9729,8878
9120392,9120386,TXFE7,128,9925,2,17905,9730,8879
9120392,9120391,TXFE7,128,9926,2,17907,9731,8880
9120404,9120392,TXFE7,128,9926,1,17908,9732,8881
9120404,9120392,TXFE7,128,9926,1,17909,9733,8882
9120404,9120392,TXFE7,128,9926,1,17910,9734,8883
9120404,9120393,TXFE7,128,9925,1,17911,9735,8884
9120404,9120395,TXFE7,128,9925,1,17912,9736,8885
9120404,9120397,TXFE7,128,9926,1,17913,9737,8886
9120404,9120397,TXFE7,128,9925,1,17914,9738,8887
9120404,9120399,TXFE7,128,9926,1,17915,9739,8888
9120404,9120404,TXFE7,128,9925,1,17916,9740,8889
9120417,9120408,TXFE7,128,9925,3,17919,9742,8890
9120417,9120412,TXFE7,128,9925,4,17923,9746,8891
9120417,9120413,TXFE7,128,9925,1,17924,9747,8892
9120417,9120417,TXFE7,128,9925,5,17929,9752,8893
9120429,9120418,TXFE7,128,9926,1,17930,9753,8894
9120429,9120423,TXFE7,128,9926,1,17931,9754,8895
9120442,9120434,TXFE7,128,9926,2,17933,9755,8897
9120442,9120434,TXFE7,128,9926,1,17934,9756,8898
9120442,9120441,TXFE7,128,9926,1,17935,9757,8899
9120442,9120442,TXFE7,128,9925,21,17956,9769,8900
9120454,9120445,TXFE7,129,9925,11,17975,9779,8901
9120454,9120445,TXFE7,129,9924,8,17975,9779,8901
9120454,9120448,TXFE7,128,9924,2,17977,9780,8902
9120467,9120455,TXFE7,128,9924,1,17978,9781,8903
9120467,9120459,TXFE7,130,9925,5,18018,9800,8904
9120467,9120459,TXFE7,130,9924,32,18018,9800,8904
9120467,9120459,TXFE7,130,9923,3,18018,9800,8904
9120467,9120460,TXFE7,128,9923,7,18025,9806,8905
9120467,9120460,TXFE7,128,9923,7,18032,9813,8906
9120479,9120469,TXFE7,129,9923,41,18074,9837,8907
9120479,9120469,TXFE7,129,9922,1,18074,9837,8907
9120479,9120471,TXFE7,128,9924,1,18075,9838,8908
9120479,9120472,TXFE7,128,9923,1,18076,9839,8909
9120479,9120475,TXFE7,128,9922,1,18077,9840,8910
9120479,9120476,TXFE7,128,9922,2,18079,9842,8911
9120492,9120482,TXFE7,128,9922,1,18080,9843,8912
9120492,9120483,TXFE7,128,9924,3,18083,9844,8915
9120492,9120486,TXFE7,128,9924,1,18084,9845,8916
9120492,9120487,TXFE7,129,9923,2,18093,9853,8917
9120492,9120487,TXFE7,129,9922,7,18093,9853,8917
9120492,9120489,TXFE7,128,9922,1,18094,9854,8918
9120492,9120489,TXFE7,128,9922,4,18098,9856,8919
9120492,9120491,TXFE7,128,9924,1,18099,9857,8920
9120504,9120498,TXFE7,128,9923,1,18100,9858,8921
9120504,9120498,TXFE7,128,9924,4,18104,9859,8925
9120504,9120499,TXFE7,128,9924,1,18105,9860,8926
9120517,9120504,TXFE7,128,9924,1,18106,9861,8927
9120517,9120505,TXFE7,128,9924,12,18118,9862,8930
9120517,9120505,TXFE7,128,9925,2,18120,9863,8931
9120517,9120505,TXFE7,128,9925,2,18122,9864,8933
9120517,9120506,TXFE7,128,9924,2,18124,9866,8934
9120517,9120507,TXFE7,128,9924,1,18125,9867,8935
9120529,9120517,TXFE7,128,9924,2,18127,9868,8936
9120529,9120519,TXFE7,128,9924,1,18128,9869,8937
9120529,9120526,TXFE7,128,9925,1,18129,9870,8938
9120529,9120526,TXFE7,128,9925,2,18131,9871,8940
9120529,9120527,TXFE7,128,9925,1,18132,9872,8941
9120542,9120529,TXFE7,128,9925,5,18137,9873,8943
9120542,9120529,TXFE7,128,9925,1,18138,9874,8944
9120542,9120530,TXFE7,128,9925,2,18140,9875,8946
9120542,9120533,TXFE7,128,9925,3,18143,9876,8949
9120542,9120533,TXFE7,128,9925,1,18144,9877,8950
9120542,9120534,TXFE7,128,9925,2,18146,9878,8951
9120542,9120534,TXFE7,128,9925,1,18147,9879,8952
9120542,9120537,TXFE7,128,9925,2,18149,9881,8953
9120542,9120540,TXFE7,128,9925,1,18150,9882,8954
9120554,9120545,TXFE7,128,9924,2,18152,9884,8955
9120554,9120545,TXFE7,128,9924,5,18157,9886,8956
9120554,9120548,TXFE7,128,9924,1,18158,9887,8957
9120554,9120549,TXFE7,128,9925,1,18159,9888,8958
9120554,9120552,TXFE7,128,9926,1,18160,9889,8959
9120554,9120554,TXFE7,128,9924,1,18161,9890,8960
9120554,9120554,TXFE7,128,9924,2,18163,9891,8961
9120567,9120559,TXFE7,128,9925,2,18165,9892,8962
9120567,9120561,TXFE7,129,9925,4,18171,9894,8963
9120567,9120561,TXFE7,129,9924,2,18171,9894,8963
9120567,9120565,TXFE7,128,9924,1,18172,9895,8964
9120567,9120565,TXFE7,128,9926,1,18173,9896,8965
9120567,9120566,TXFE7,128,9926,1,18174,9897,8966
9120579,9120567,TXFE7,128,9924,2,18176,9899,8967
9120592,9120581,TXFE7,128,9926,1,18177,9900,8968
9120592,9120584,TXFE7,128,9925,1,18178,9901,8969
9120592,9120585,TXFE7,128,9925,1,18179,9902,8970
9120592,9120589,TXFE7,128,9925,1,18180,9903,8971
9120592,9120592,TXFE7,128,9926,1,18181,9904,8972
9120604,9120597,TXFE7,128,9926,1,18182,9905,8973
9120604,9120600,TXFE7,128,9926,3,18185,9906,8975
9120604,9120601,TXFE7,128,9925,1,18186,9907,8976
9120604,9120603,TXFE7,128,9926,1,18187,9908,8977
9120604,9120604,TXFE7,128,9925,1,18188,9909,8978
9120617,9120608,TXFE7,128,9926,2,18190,9910,8979
9120617,9120608,TXFE7,128,9925,1,18191,9911,8980
9120617,9120611,TXFE7,128,9925,1,18192,9912,8981
9120629,9120627,TXFE7,128,9925,1,18193,9913,8982
9120629,9120628,TXFE7,128,9926,2,18195,9914,8984
9120642,9120629,TXFE7,128,9926,2,18197,9915,8985
9120642,9120630,TXFE7,128,9926,5,18202,9916,8987
9120654,9120649,TXFE7,128,9927,6,18208,9917,8991
9120654,9120649,TXFE7,128,9927,2,18210,9918,8993
9120654,9120653,TXFE7,128,9926,1,18211,9919,8994
9120667,9120657,TXFE7,128,9926,1,18212,9920,8995
9120667,9120658,TXFE7,128,9926,3,18215,9923,8996
9120679,9120670,TXFE7,128,9927,2,18217,9924,8997
9120679,9120670,TXFE7,128,9926,1,18218,9925,8998
9120692,9120681,TXFE7,128,9926,1,18219,9926,8999
9120692,9120681,TXFE7,128,9926,5,18224,9928,9000
9120704,9120694,TXFE7,128,9926,5,18229,9931,9001
9120704,9120696,TXFE7,128,9926,4,18233,9933,9002
9120704,9120698,TXFE7,128,9927,1,18234,9934,9003
9120704,9120698,TXFE7,128,9927,1,18235,9935,9004
9120704,9120701,TXFE7,128,9926,1,18236,9936,9005
9120717,9120711,TXFE7,128,9926,1,18237,9937,9006
9120717,9120716,TXFE7,128,9927,1,18238,9938,9007
9120729,9120718,TXFE7,128,9926,1,18239,9939,9008
9120729,9120728,TXFE7,128,9927,1,18240,9940,9009
9120729,9120729,TXFE7,128,9926,1,18241,9941,9010
9120742,9120734,TXFE7,128,9927,1,18242,9942,9011
9120742,9120735,TXFE7,128,9926,1,18243,9943,9012
9120742,9120735,TXFE7,128,9927,4,18247,9944,9015
9120742,9120735,TXFE7,128,9927,1,18248,9945,9016
9120742,9120740,TXFE7,128,9927,1,18249,9946,9017
9120754,9120742,TXFE7,128,9927,2,18251,9947,9018
9120754,9120744,TXFE7,128,9927,5,18256,9948,9019
9120754,9120745,TXFE7,128,9926,1,18257,9949,9020
9120754,9120746,TXFE7,128,9927,1,18258,9950,9021
9120754,9120750,TXFE7,128,9927,12,18270,9951,9023
9120754,9120753,TXFE7,128,9926,1,18271,9952,9024
9120767,9120754,TXFE7,128,9927,2,18273,9953,9025
9120767,9120754,TXFE7,128,9927,5,18278,9954,9028
9120779,9120769,TXFE7,128,9928,1,18279,9955,9029
9120779,9120773,TXFE7,128,9928,1,18280,9956,9030
9120779,9120773,TXFE7,128,9928,1,18281,9957,9031
9120779,9120779,TXFE7,128,9927,6,18287,9961,9032
9120792,9120781,TXFE7,128,9927,1,18288,9962,9033
9120792,9120785,TXFE7,128,9927,5,18293,9964,9034
9120804,9120793,TXFE7,128,9927,1,18294,9965,9035
9120804,9120797,TXFE7,128,9928,1,18295,9966,9036
9120804,9120804,TXFE7,128,9927,1,18296,9967,9037
9120817,9120804,TXFE7,128,9927,5,18301,9969,9038
9120817,9120809,TXFE7,128,9927,1,18302,9970,9039
9120817,9120809,TXFE7,128,9928,1,18303,9971,9040
9120817,9120810,TXFE7,128,9927,1,18304,9972,9041
9120817,9120814,TXFE7,128,9927,1,18305,9973,9042
9120829,9120827,TXFE7,128,9928,2,18307,9974,9044
9120842,9120838,TXFE7,128,9927,1,18308,9975,9045
9120854,9120844,TXFE7,128,9927,1,18309,9976,9046
9120854,9120845,TXFE7,128,9927,1,18310,9977,9047
9120854,9120849,TXFE7,128,9928,1,18311,9978,9048
9120854,9120852,TXFE7,128,9927,1,18312,9979,9049
9120867,9120865,TXFE7,128,9927,1,18313,9980,9050
9120879,9120870,TXFE7,128,9927,1,18314,9981,9051
9120879,9120871,TXFE7,128,9928,1,18315,9982,9052
9120892,9120886,TXFE7,128,9927,1,18316,9983,9053
9120904,9120903,TXFE7,128,9928,2,18318,9984,9055
9120917,9120905,TXFE7,128,9928,3,18321,9985,9056
9120917,9120906,TXFE7,128,9927,2,18323,9986,9057
9120917,9120908,TXFE7,128,9927,2,18325,9987,9058
9120917,9120910,TXFE7,128,9927,2,18327,9989,9059
9120917,9120913,TXFE7,128,9927,2,18329,9991,9060
9120929,9120919,TXFE7,128,9927,1,18330,9992,9061
9120942,9120937,TXFE7,128,9928,1,18331,9993,9062
9120942,9120938,TXFE7,128,9928,1,18332,9994,9063
9120954,9120943,TXFE7,128,9927,4,18336,9995,9064
9120954,9120949,TXFE7,128,9927,1,18337,9996,9065
9120954,9120952,TXFE7,128,9928,1,18338,9997,9066
9120967,9120955,TXFE7,128,9928,2,18340,9998,9067
9120979,9120972,TXFE7,128,9928,1,18341,9999,9068
9120979,9120976,TXFE7,128,9928,1,18342,10000,9069
9120979,9120976,TXFE7,128,9928,1,18343,10001,9070
9120992,9120988,TXFE7,128,9928,2,18345,10002,9072
9121004,9121004,TXFE7,128,9928,1,18346,10003,9073
9121017,9121007,TXFE7,128,9928,1,18347,10004,9074
9121042,9121032,TXFE7,128,9928,1,18348,10005,9075
9121054,9121042,TXFE7,128,9927,1,18349,10006,9076
9121054,9121044,TXFE7,128,9928,1,18350,10007,9077
9121067,9121061,TXFE7,128,9927,1,18351,10008,9078
9121092,9121081,TXFE7,128,9928,1,18352,10009,9079
9121104,9121095,TXFE7,128,9927,1,18353,10010,9080
9121129,9121123,TXFE7,128,9927,2,18355,10011,9081
9121142,9121139,TXFE7,128,9927,2,18357,10012,9082
9121142,9121140,TXFE7,128,9928,3,18360,10013,9084
9121154,9121154,TXFE7,128,9928,1,18361,10014,9085
9121192,9121185,TXFE7,128,9928,4,18365,10015,9086
9121204,9121198,TXFE7,128,9928,1,18366,10016,9087
9121217,9121216,TXFE7,128,9927,1,18367,10017,9088
9121242,9121235,TXFE7,128,9927,1,18368,10018,9089
9121279,9121268,TXFE7,128,9927,8,18376,10024,9090
9121292,9121279,TXFE7,128,9927,2,18378,10025,9091
9121329,9121324,TXFE7,128,9927,1,18379,10026,9092
9121342,9121335,TXFE7,128,9928,9,18388,10027,9096
9121342,9121336,TXFE7,128,9928,1,18389,10028,9097
9121367,9121355,TXFE7,128,9928,14,18403,10029,9105
9121379,9121373,TXFE7,128,9928,1,18404,10030,9106
9121392,9121387,TXFE7,128,9928,1,18405,10031,9107
9121404,9121400,TXFE7,128,9928,1,18406,10032,9108
9121404,9121403,TXFE7,128,9928,1,18407,10033,9109
9121429,9121422,TXFE7,128,9928,1,18408,10034,9110
9121429,9121424,TXFE7,128,9929,1,18409,10035,9111
9121442,9121429,TXFE7,128,9928,1,18410,10036,9112
9121454,9121449,TXFE7,128,9928,1,18411,10037,9113
9121467,9121455,TXFE7,128,9928,1,18412,10038,9114
9121479,9121471,TXFE7,128,9929,1,18413,10039,9115
9121492,9121480,TXFE7,128,9929,1,18414,10040,9116
9121529,9121525,TXFE7,128,9929,1,18415,10041,9117
9121554,9121548,TXFE7,128,9928,1,18416,10042,9118
9121567,9121557,TXFE7,128,9928,1,18417,10043,9119
9121579,9121568,TXFE7,128,9928,1,18418,10044,9120
9121579,9121571,TXFE7,128,9928,2,18420,10045,9121
9121592,9121586,TXFE7,128,9928,3,18423,10048,9122
9121604,9121592,TXFE7,128,9928,1,18424,10049,9123
9121604,9121595,TXFE7,128,9928,1,18425,10050,9124
9121604,9121603,TXFE7,128,9928,1,18426,10051,9125
9121642,9121634,TXFE7,128,9929,6,18432,10052,9129
9121654,9121647,TXFE7,128,9928,5,18437,10057,9130
9121667,9121657,TXFE7,128,9929,10,18447,10058,9133
9121667,9121657,TXFE7,128,9928,1,18448,10059,9134
9121667,9121663,TXFE7,128,9928,2,18450,10060,9135
9121679,9121671,TXFE7,128,9929,1,18451,10061,9136
9121679,9121675,TXFE7,128,9929,1,18452,10062,9137
9121692,9121684,TXFE7,128,9929,1,18453,10063,9138
9121692,9121689,TXFE7,128,9928,1,18454,10064,9139
9121704,9121695,TXFE7,128,9929,5,18459,10065,9140
9121704,9121695,TXFE7,128,9929,1,18460,10066,9141
9121717,9121715,TXFE7,128,9929,2,18462,10067,9142
9121729,9121720,TXFE7,128,9929,1,18463,10068,9143
9121729,9121723,TXFE7,128,9928,1,18464,10069,9144
9121729,9121724,TXFE7,128,9929,2,18466,10070,9145
9121767,9121759,TXFE7,128,9928,2,18468,10072,9146
9121792,9121785,TXFE7,128,9929,1,18469,10073,9147
9121817,9121812,TXFE7,128,9929,1,18470,10074,9148
9121817,9121813,TXFE7,128,9928,1,18471,10075,9149
9121817,9121813,TXFE7,128,9928,1,18472,10076,9150
9121829,9121824,TXFE7,128,9928,1,18473,10077,9151
9121879,9121876,TXFE7,128,9929,25,18498,10078,9164
9121892,9121879,TXFE7,128,9929,4,18502,10079,9168
9121892,9121880,TXFE7,128,9929,1,18503,10080,9169
9121904,9121901,TXFE7,128,9930,1,18504,10081,9170
9121917,9121907,TXFE7,128,9928,1,18505,10082,9171
9121917,9121909,TXFE7,128,9928,1,18506,10083,9172
9121929,9121917,TXFE7,128,9929,1,18507,10084,9173
9121942,9121936,TXFE7,128,9928,3,18510,10087,9174
9121942,9121939,TXFE7,128,9930,1,18511,10088,9175
9121979,9121967,TXFE7,128,9928,1,18512,10089,9176
9121992,9121983,TXFE7,128,9929,1,18513,10090,9177
9122004,9121996,TXFE7,128,9929,1,18514,10091,9178
9122004,9121999,TXFE7,128,9929,1,18515,10092,9179
9122054,9122049,TXFE7,128,9928,3,18518,10093,9180
9122067,9122062,TXFE7,128,9929,1,18519,10094,9181
9122104,9122097,TXFE7,128,9929,2,18521,10095,9182
9122117,9122105,TXFE7,128,9928,2,18523,10097,9183
9122117,9122108,TXFE7,128,9929,1,18524,10098,9184
9122129,9122125,TXFE7,128,9929,1,18525,10099,9185
9122129,9122126,TXFE7,128,9928,1,18526,10100,9186
9122129,9122129,TXFE7,128,9929,25,18551,10101,9198
9122142,9122140,TXFE7,128,9929,1,18552,10102,9199
9122154,9122142,TXFE7,128,9929,11,18563,10103,9205
9122154,9122143,TXFE7,128,9929,3,18566,10104,9208
9122167,9122165,TXFE7,128,9930,1,18567,10105,9209
9122179,9122169,TXFE7,128,9928,4,18571,10108,9210
9122192,9122179,TXFE7,128,9929,1,18572,10109,9211
9122192,9122179,TXFE7,128,9929,2,18574,10110,9212
9122192,9122181,TXFE7,128,9930,1,18575,10111,9213
9122192,9122186,TXFE7,128,9930,1,18576,10112,9214
9122192,9122186,TXFE7,128,9930,1,18577,10113,9215
9122192,9122188,TXFE7,128,9930,3,18580,10114,9218
9122192,9122191,TXFE7,129,9929,2,18587,10118,9219
9122192,9122191,TXFE7,129,9928,5,18587,10118,9219
9122217,9122207,TXFE7,128,9929,1,18588,10119,9220
9122217,9122212,TXFE7,128,9928,1,18589,10120,9221
9122242,9122233,TXFE7,128,9928,1,18590,10121,9222
9122242,9122236,TXFE7,128,9929,5,18595,10122,9225
9122242,9122236,TXFE7,128,9929,1,18596,10123,9226
9122242,9122237,TXFE7,128,9929,1,18597,10124,9227
9122254,9122245,TXFE7,128,9928,20,18617,10135,9228
9122254,9122247,TXFE7,128,9929,5,18622,10136,9230
9122267,9122257,TXFE7,128,9929,1,18623,10137,9231
9122267,9122264,TXFE7,128,9928,2,18625,10139,9232
9122279,9122273,TXFE7,128,9929,1,18626,10140,9233
9122292,9122290,TXFE7,128,9929,3,18629,10141,9236
9122304,9122299,TXFE7,128,9928,1,18630,10142,9237
9122317,9122311,TXFE7,128,9929,2,18632,10143,9238
9122317,9122312,TXFE7,128,9929,3,18635,10144,9239
9122329,9122318,TXFE7,128,9929,4,18639,10145,9242
9122329,9122321,TXFE7,128,9928,7,18646,10149,9243
9122329,9122328,TXFE7,128,9929,9,18655,10150,9246
9122354,9122344,TXFE7,128,9929,1,18656,10151,9247
9122367,9122361,TXFE7,128,9928,2,18658,10153,9248
9122379,9122367,TXFE7,128,9929,1,18659,10154,9249
9122379,9122374,TXFE7,128,9928,1,18660,10155,9250
9122392,9122391,TXFE7,128,9929,1,18661,10156,9251
9122404,9122399,TXFE7,128,9929,2,18663,10157,9253
9122404,9122404,TXFE7,128,9928,1,18664,10158,9254
9122417,9122412,TXFE7,128,9929,1,18665,10159,9255
9122429,9122420,TXFE7,128,9928,1,18666,10160,9256
9122442,9122433,TXFE7,128,9929,1,18667,10161,9257
9122454,9122443,TXFE7,128,9928,5,18672,10164,9258
9122454,9122446,TXFE7,128,9929,1,18673,10165,9259
9122454,9122446,TXFE7,128,9928,1,18674,10166,9260
9122454,9122448,TXFE7,128,9929,1,18675,10167,9261
9122479,9122472,TXFE7,128,9929,1,18676,10168,9262
9122517,9122514,TXFE7,128,9929,1,18677,10169,9263
9122517,9122516,TXFE7,128,9929,2,18679,10170,9264
9122529,9122523,TXFE7,128,9929,5,18684,10171,9266
9122529,9122524,TXFE7,128,9929,1,18685,10172,9267
9122542,9122536,TXFE7,128,9929,5,18690,10173,9272
9122604,9122597,TXFE7,128,9929,1,18691,10174,9273
9122617,9122611,TXFE7,128,9929,1,18692,10175,9274
9122629,9122621,TXFE7,128,9929,1,18693,10176,9275
9122629,9122623,TXFE7,128,9929,2,18695,10177,9276
9122667,9122657,TXFE7,128,9929,1,18696,10178,9277
9122704,9122692,TXFE7,128,9928,5,18701,10180,9278
9122704,9122698,TXFE7,128,9929,1,18702,10181,9279
9122717,9122705,TXFE7,128,9929,1,18703,10182,9280
9122717,9122711,TXFE7,128,9928,1,18704,10183,9281
9122742,9122731,TXFE7,128,9929,1,18705,10184,9282
9122742,9122736,TXFE7,128,9928,2,18707,10185,9283
9122742,9122737,TXFE7,128,9928,2,18709,10187,9284
9122754,9122742,TXFE7,128,9928,4,18713,10190,9285
9122754,9122744,TXFE7,128,9929,1,18714,10191,9286
9122754,9122749,TXFE7,128,9928,4,18718,10192,9287
9122754,9122754,TXFE7,128,9928,1,18719,10193,9288
9122792,9122783,TXFE7,128,9928,1,18720,10194,9289
9122804,9122793,TXFE7,128,9929,9,18729,10195,9292
9122842,9122834,TXFE7,128,9929,1,18730,10196,9293
9122842,9122835,TXFE7,128,9929,1,18731,10197,9294
9122854,9122849,TXFE7,128,9928,1,18732,10198,9295
9122854,9122849,TXFE7,128,9929,1,18733,10199,9296
9122854,9122851,TXFE7,128,9929,9,18742,10200,9303
9122867,9122859,TXFE7,128,9928,1,18743,10201,9304
9122879,9122871,TXFE7,128,9928,3,18746,10204,9305
9122892,9122880,TXFE7,128,9929,1,18747,10205,9306
9122904,9122903,TXFE7,128,9929,3,18750,10206,9309
9122917,9122916,TXFE7,128,9929,1,18751,10207,9310
9122917,9122917,TXFE7,128,9929,1,18752,10208,9311
9122942,9122932,TXFE7,128,9928,2,18754,10209,9312
9122954,9122949,TXFE7,128,9929,7,18761,10210,9315
9122967,9122954,TXFE7,128,9929,3,18764,10211,9316
9122967,9122956,TXFE7,128,9929,1,18765,10212,9317
9122967,9122963,TXFE7,128,9928,1,18766,10213,9318
9122992,9122984,TXFE7,128,9929,2,18768,10214,9319
9122992,9122986,TXFE7,128,9929,4,18772,10215,9322
9123004,9122999,TXFE7,128,9929,1,18773,10216,9323
9123004,9123004,TXFE7,128,9930,1,18774,10217,9324
9123017,9123010,TXFE7,128,9929,1,18775,10218,9325
9123029,9123018,TXFE7,128,9929,1,18776,10219,9326
9123029,9123026,TXFE7,128,9930,4,18780,10220,9330
9123042,9123030,TXFE7,128,9930,1,18781,10221,9331
9123042,9123036,TXFE7,128,9929,1,18782,10222,9332
9123054,9123048,TXFE7,128,9930,3,18785,10223,9334
9123117,9123111,TXFE7,128,9930,2,18787,10224,9335
9123167,9123156,TXFE7,128,9930,1,18788,10225,9336
9123179,9123179,TXFE7,128,9930,3,18791,10226,9337
9123192,9123181,TXFE7,128,9930,3,18794,10227,9339
9123192,9123182,TXFE7,128,9929,20,18814,10236,9340
9123192,9123188,TXFE7,128,9930,1,18815,10237,9341
9123192,9123189,TXFE7,128,9929,2,18817,10239,9342
9123217,9123211,TXFE7,128,9929,1,18818,10240,9343
9123217,9123212,TXFE7,128,9930,1,18819,10241,9344
9123229,9123219,TXFE7,128,9930,1,18820,10242,9345
9123229,9123228,TXFE7,128,9929,1,18821,10243,9346
9123242,9123232,TXFE7,128,9930,1,18822,10244,9347
9123242,9123232,TXFE7,128,9930,1,18823,10245,9348
9123242,9123237,TXFE7,128,9930,1,18824,10246,9349
9123279,9123279,TXFE7,128,9930,5,18829,10247,9354
9123292,9123280,TXFE7,128,9929,1,18830,10248,9355
9123292,9123288,TXFE7,128,9930,1,18831,10249,9356
9123304,9123300,TXFE7,128,9929,1,18832,10250,9357
9123379,9123377,TXFE7,128,9930,2,18834,10251,9359
9123417,9123414,TXFE7,128,9930,2,18836,10252,9361
9123442,9123435,TXFE7,128,9929,14,18850,10258,9362
9123467,9123458,TXFE7,128,9930,1,18851,10259,9363
9123517,9123506,TXFE7,128,9930,1,18852,10260,9364
9123567,9123556,TXFE7,128,9929,1,18853,10261,9365
9123579,9123574,TXFE7,128,9930,2,18855,10262,9367
9123592,9123580,TXFE7,128,9930,31,18886,10263,9393
9123604,9123592,TXFE7,128,9930,5,18891,10264,9398
9123604,9123593,TXFE7,128,9930,1,18892,10265,9399
9123604,9123596,TXFE7,128,9930,2,18894,10266,9400
9123604,9123598,TXFE7,128,9930,1,18895,10267,9401
9123617,9123607,TXFE7,128,9931,4,18899,10268,9405
9123617,9123611,TXFE7,128,9931,4,18903,10269,9408
9123629,9123617,TXFE7,128,9931,12,18915,10270,9412
9123642,9123637,TXFE7,128,9930,1,18916,10271,9413
9123654,9123643,TXFE7,128,9930,2,18918,10272,9414
9123654,9123652,TXFE7,128,9930,2,18920,10274,9415
9123667,9123665,TXFE7,128,9931,1,18921,10275,9416
9123679,9123671,TXFE7,128,9930,1,18922,10276,9417
9123692,9123690,TXFE7,128,9931,1,18923,10277,9418
9123729,9123722,TXFE7,128,9931,1,18924,10278,9419
9123742,9123736,TXFE7,128,9931,1,18925,10279,9420
9123742,9123737,TXFE7,128,9931,1,18926,10280,9421
9123754,9123743,TXFE7,128,9931,1,18927,10281,9422
9123767,9123756,TXFE7,128,9931,4,18931,10282,9425
9123792,9123780,TXFE7,128,9931,2,18933,10283,9426
9123804,9123793,TXFE7,128,9930,1,18934,10284,9427
9123829,9123821,TXFE7,128,9930,4,18938,10287,9428
9123854,9123853,TXFE7,128,9930,1,18939,10288,9429
9123867,9123862,TXFE7,128,9930,1,18940,10289,9430
9123867,9123865,TXFE7,128,9930,1,18941,10290,9431
9123879,9123870,TXFE7,128,9931,1,18942,10291,9432
9123892,9123880,TXFE7,128,9931,1,18943,10292,9433
9123904,9123894,TXFE7,128,9930,4,18947,10296,9434
9123904,9123903,TXFE7,128,9931,1,18948,10297,9435
9123942,9123941,TXFE7,128,9931,1,18949,10298,9436
9123967,9123962,TXFE7,128,9931,1,18950,10299,9437
9123992,9123983,TXFE7,128,9931,1,18951,10300,9438
9124017,9124011,TXFE7,128,9931,1,18952,10301,9439
9124042,9124039,TXFE7,128,9931,10,18962,10302,9445
9124054,9124042,TXFE7,128,9931,4,18966,10303,9448
9124104,9124096,TXFE7,128,9931,1,18967,10304,9449
9124117,9124110,TXFE7,128,9932,2,18969,10305,9450
9124129,9124124,TXFE7,128,9932,2,18971,10306,9451
9124142,9124133,TXFE7,128,9932,3,18974,10307,9452
9124142,9124134,TXFE7,128,9931,1,18975,10308,9453
9124142,9124136,TXFE7,128,9932,1,18976,10309,9454
9124154,9124146,TXFE7,128,9932,7,18983,10310,9455
9124192,9124181,TXFE7,128,9931,3,18986,10312,9456
9124192,9124190,TXFE7,128,9931,4,18990,10314,9457
9124204,9124200,TXFE7,128,9931,2,18992,10315,9458
9124217,9124207,TXFE7,128,9932,1,18993,10316,9459
9124217,9124214,TXFE7,128,9932,1,18994,10317,9460
9124229,9124223,TXFE7,128,9932,5,18999,10318,9461
9124242,9124237,TXFE7,128,9931,1,19000,10319,9462
9124267,9124264,TXFE7,128,9932,3,19003,10320,9463
9124279,9124277,TXFE7,128,9932,2,19005,10321,9464
9124292,9124284,TXFE7,128,9932,2,19007,10322,9465
9124304,9124299,TXFE7,128,9931,1,19008,10323,9466
9124329,9124324,TXFE7,128,9932,1,19009,10324,9467
9124354,9124351,TXFE7,128,9931,1,19010,10325,9468
9124367,9124364,TXFE7,128,9932,1,19011,10326,9469
9124392,9124384,TXFE7,128,9932,1,19012,10327,9470
9124417,9124410,TXFE7,128,9932,1,19013,10328,9471
9124429,9124419,TXFE7,128,9932,2,19015,10329,9472
9124429,9124422,TXFE7,128,9931,1,19016,10330,9473
9124429,9124423,TXFE7,128,9932,1,19017,10331,9474
9124479,9124474,TXFE7,128,9931,1,19018,10332,9475
9124504,9124503,TXFE7,128,9932,1,19019,10333,9476
9124517,9124512,TXFE7,128,9932,1,19020,10334,9477
9124529,9124519,TXFE7,128,9932,1,19021,10335,9478
9124529,9124522,TXFE7,128,9932,1,19022,10336,9479
9124554,9124553,TXFE7,128,9931,1,19023,10337,9480
9124567,9124559,TXFE7,128,9931,10,19033,10343,9481
9124579,9124573,TXFE7,128,9931,1,19034,10344,9482
9124579,9124577,TXFE7,128,9931,1,19035,10345,9483
9124604,9124596,TXFE7,128,9931,1,19036,10346,9484
9124604,9124597,TXFE7,128,9931,2,19038,10347,9485
9124617,9124612,TXFE7,128,9931,1,19039,10348,9486
9124642,9124639,TXFE7,128,9931,1,19040,10349,9487
9124667,9124656,TXFE7,128,9931,1,19041,10350,9488
9124704,9124695,TXFE7,128,9931,1,19042,10351,9489
9124717,9124706,TXFE7,128,9931,3,19045,10352,9491
9124717,9124706,TXFE7,128,9931,1,19046,10353,9492
9124729,9124723,TXFE7,128,9931,1,19047,10354,9493
9124729,9124724,TXFE7,128,9930,1,19048,10355,9494
9124754,9124749,TXFE7,128,9931,10,19058,10356,9498
9124767,9124756,TXFE7,128,9931,2,19060,10357,9499
9124767,9124766,TXFE7,128,9931,2,19062,10358,9501
9124779,9124771,TXFE7,128,9930,1,19063,10359,9502
9124779,9124777,TXFE7,128,9930,5,19068,10361,9503
9124792,9124783,TXFE7,128,9930,1,19069,10362,9504
9124792,9124787,TXFE7,128,9930,1,19070,10363,9505
9124804,9124793,TXFE7,128,9931,1,19071,10364,9506
9124867,9124858,TXFE7,128,9930,3,19074,10366,9507
9124879,9124877,TXFE7,128,9930,1,19075,10367,9508
9124904,9124897,TXFE7,128,9931,1,19076,10368,9509
9124917,9124911,TXFE7,128,9930,1,19077,10369,9510
9124917,9124916,TXFE7,128,9931,1,19078,10370,9511
9124967,9124955,TXFE7,128,9930,28,19106,10387,9512
9124967,9124958,TXFE7,128,9931,1,19107,10388,9513
9124967,9124960,TXFE7,128,9931,2,19109,10389,9514
9124967,9124964,TXFE7,128,9931,1,19110,10390,9515
9124967,9124967,TXFE7,128,9930,1,19111,10391,9516
9124979,9124967,TXFE7,128,9930,1,19112,10392,9517
9125004,9124997,TXFE7,128,9930,3,19115,10393,9518
9125017,9125011,TXFE7,128,9930,1,19116,10394,9519
9125017,9125011,TXFE7,128,9930,1,19117,10395,9520
9125017,9125012,TXFE7,128,9930,1,19118,10396,9521
9125054,9125052,TXFE7,128,9930,2,19120,10397,9522
9125054,9125052,TXFE7,128,9930,1,19121,10398,9523
9125067,9125058,TXFE7,128,9930,1,19122,10399,9524
9125067,9125059,TXFE7,128,9929,1,19123,10400,9525
9125092,9125086,TXFE7,128,9929,3,19126,10403,9526
9125117,9125108,TXFE7,128,9930,1,19127,10404,9527
9125142,9125141,TXFE7,128,9929,1,19128,10405,9528
9125154,9125152,TXFE7,128,9930,1,19129,10406,9529
9125179,9125175,TXFE7,128,9930,1,19130,10407,9530
9125254,9125250,TXFE7,128,9930,1,19131,10408,9531
9125254,9125252,TXFE7,128,9929,4,19135,10411,9532
9125267,9125259,TXFE7,128,9930,1,19136,10412,9533
9125279,9125275,TXFE7,128,9930,1,19137,10413,9534
9125292,9125290,TXFE7,128,9930,1,19138,10414,9535
9125317,9125316,TXFE7,128,9930,1,19139,10415,9536
9125342,9125330,TXFE7,128,9930,1,19140,10416,9537
9125354,9125349,TXFE7,128,9930,1,19141,10417,9538
9125379,9125376,TXFE7,128,9930,1,19142,10418,9539
9125392,9125388,TXFE7,128,9930,1,19143,10419,9540
9125404,9125393,TXFE7,128,9931,1,19144,10420,9541
9125404,9125396,TXFE7,128,9930,1,19145,10421,9542
9125417,9125409,TXFE7,128,9931,1,19146,10422,9543
9125467,9125460,TXFE7,128,9930,6,19152,10424,9544
9125542,9125536,TXFE7,128,9931,11,19163,10425,9549
9125567,9125556,TXFE7,128,9930,4,19167,10426,9550
9125592,9125585,TXFE7,128,9931,9,19176,10427,9557
9125604,9125594,TXFE7,128,9931,1,19177,10428,9558
9125642,9125642,TXFE7,128,9931,9,19186,10429,9566
9125654,9125650,TXFE7,128,9931,1,19187,10430,9567
9125654,9125651,TXFE7,128,9930,1,19188,10431,9568
9125667,9125662,TXFE7,128,9930,5,19193,10434,9569
9125692,9125691,TXFE7,128,9930,15,19208,10441,9570
9125704,9125698,TXFE7,128,9931,2,19210,10442,9571
9125742,9125736,TXFE7,128,9931,1,19211,10443,9572
9125767,9125754,TXFE7,128,9931,1,19212,10444,9573
9125817,9125816,TXFE7,128,9931,9,19221,10445,9577
9125829,9125824,TXFE7,128,9930,1,19222,10446,9578
9125879,9125872,TXFE7,128,9931,1,19223,10447,9579
9125892,9125879,TXFE7,128,9930,1,19224,10448,9580
9125892,9125885,TXFE7,128,9931,1,19225,10449,9581
9125929,9125928,TXFE7,128,9931,1,19226,10450,9582
9125992,9125988,TXFE7,128,9930,1,19227,10451,9583
9130004,9125999,TXFE7,128,9930,5,19232,10453,9584
9130029,9130029,TXFE7,128,9931,1,19233,10454,9585
9130054,9130044,TXFE7,128,9930,10,19243,10460,9586
9130054,9130044,TXFE7,128,9930,6,19249,10462,9587
9130054,9130046,TXFE7,128,9930,1,19250,10463,9588
9130054,9130048,TXFE7,128,9930,1,19251,10464,9589
9130054,9130049,TXFE7,128,9930,1,19252,10465,9590
9130054,9130049,TXFE7,128,9930,1,19253,10466,9591
9130054,9130050,TXFE7,128,9930,1,19254,10467,9592
9130054,9130050,TXFE7,128,9930,1,19255,10468,9593
9130054,9130050,TXFE7,128,9930,1,19256,10469,9594
9130054,9130051,TXFE7,128,9930,1,19257,10470,9595
9130054,9130053,TXFE7,128,9930,2,19259,10471,9596
9130067,9130056,TXFE7,128,9930,1,19260,10472,9597
9130067,9130057,TXFE7,128,9931,2,19262,10473,9598
9130067,9130057,TXFE7,128,9930,1,19263,10474,9599
9130067,9130058,TXFE7,128,9930,1,19264,10475,9600
9130067,9130064,TXFE7,128,9930,1,19265,10476,9601
9130092,9130080,TXFE7,128,9930,3,19268,10479,9602
9130104,9130095,TXFE7,128,9930,1,19269,10480,9603
9130104,9130100,TXFE7,128,9930,1,19270,10481,9604
9130117,9130112,TXFE7,128,9930,1,19271,10482,9605
9130129,9130122,TXFE7,128,9931,1,19272,10483,9606
9130129,9130129,TXFE7,128,9930,1,19273,10484,9607
9130154,9130149,TXFE7,128,9931,3,19276,10485,9608
9130154,9130149,TXFE7,128,9930,1,19277,10486,9609
9130192,9130189,TXFE7,128,9931,1,19278,10487,9610
9130204,9130197,TXFE7,128,9931,1,19279,10488,9611
9130217,9130205,TXFE7,128,9930,1,19280,10489,9612
9130217,9130205,TXFE7,128,9930,3,19283,10490,9613
9130229,9130222,TXFE7,128,9930,1,19284,10491,9614
9130317,9130314,TXFE7,128,9931,1,19285,10492,9615
9130329,9130317,TXFE7,128,9931,1,19286,10493,9616
9130342,9130338,TXFE7,128,9931,1,19287,10494,9617
9130417,9130411,TXFE7,128,9930,1,19288,10495,9618
9130417,9130415,TXFE7,128,9931,37,19325,10496,9634
9130417,9130415,TXFE7,128,9931,9,19334,10497,9636
9130429,9130419,TXFE7,128,9931,5,19339,10498,9637
9130429,9130426,TXFE7,128,9931,1,19340,10499,9638
9130442,9130435,TXFE7,128,9932,1,19341,10500,9639
9130442,9130436,TXFE7,128,9932,3,19344,10501,9641
9130442,9130441,TXFE7,128,9932,3,19347,10502,9642
9130454,9130444,TXFE7,128,9931,1,19348,10503,9643
9130454,9130446,TXFE7,128,9932,2,19350,10504,9645
9130454,9130448,TXFE7,128,9932,2,19352,10505,9647
9130454,9130450,TXFE7,128,9931,5,19357,10509,9648
9130467,9130460,TXFE7,128,9932,1,19358,10510,9649
9130467,9130465,TXFE7,128,9932,1,19359,10511,9650
9130492,9130487,TXFE7,128,9931,1,19360,10512,9651
9130517,9130512,TXFE7,128,9931,1,19361,10513,9652
9130529,9130522,TXFE7,128,9932,1,19362,10514,9653
9130529,9130524,TXFE7,128,9931,6,19368,10518,9654
9130542,9130534,TXFE7,128,9932,1,19369,10519,9655
9130542,9130539,TXFE7,128,9931,1,19370,10520,9656
9130542,9130540,TXFE7,128,9931,2,19372,10522,9657
9130567,9130557,TXFE7,128,9931,1,19373,10523,9658
9130567,9130558,TXFE7,128,9932,2,19375,10524,9659
9130604,9130598,TXFE7,128,9931,1,19376,10525,9660
9130679,9130672,TXFE7,128,9932,1,19377,10526,9661
9130692,9130680,TXFE7,128,9932,1,19378,10527,9662
9130692,9130682,TXFE7,128,9932,1,19379,10528,9663
9130729,9130728,TXFE7,128,9932,1,19380,10529,9664
9130742,9130734,TXFE7,128,9932,1,19381,10530,9665
9130804,9130794,TXFE7,128,9931,1,19382,10531,9666
9130804,9130799,TXFE7,128,9932,1,19383,10532,9667
9130829,9130820,TXFE7,128,9932,2,19385,10533,9669
9130867,9130865,TXFE7,128,9932,1,19386,10534,9670
9130879,9130869,TXFE7,128,9932,10,19396,10535,9678
9130892,9130884,TXFE7,128,9932,18,19414,10536,9693
9130917,9130914,TXFE7,128,9932,1,19415,10537,9694
9130929,9130923,TXFE7,128,9933,1,19416,10538,9695
9130942,9130934,TXFE7,128,9933,1,19417,10539,9696
9130942,9130936,TXFE7,128,9933,10,19427,10540,9701
9130954,9130952,TXFE7,128,9933,2,19429,10541,9702
9131004,9131004,TXFE7,128,9933,5,19434,10542,9706
9131017,9131009,TXFE7,128,9933,1,19435,10543,9707
9131042,9131037,TXFE7,128,9933,1,19436,10544,9708
9131054,9131044,TXFE7,128,9932,1,19437,10545,9709
9131054,9131044,TXFE7,128,9933,1,19438,10546,9710
9131054,9131052,TXFE7,128,9933,1,19439,10547,9711
9131079,9131070,TXFE7,128,9933,1,19440,10548,9712
9131104,9131096,TXFE7,128,9933,1,19441,10549,9713
9131117,9131111,TXFE7,128,9933,1,19442,10550,9714
9131154,9131146,TXFE7,128,9933,1,19443,10551,9715
9131167,9131157,TXFE7,128,9933,1,19444,10552,9716
9131167,9131159,TXFE7,128,9933,1,19445,10553,9717
9131179,9131175,TXFE7,128,9933,1,19446,10554,9718
9131192,9131188,TXFE7,128,9932,1,19447,10555,9719
9131192,9131188,TXFE7,128,9932,1,19448,10556,9720
9131217,9131205,TXFE7,128,9932,1,19449,10557,9721
9131217,9131213,TXFE7,128,9933,1,19450,10558,9722
9131229,9131222,TXFE7,128,9933,2,19452,10559,9723
9131242,9131237,TXFE7,128,9933,10,19462,10560,9728
9131267,9131263,TXFE7,128,9932,13,19475,10570,9729
9131304,9131304,TXFE7,128,9932,1,19476,10571,9730
9131342,9131335,TXFE7,128,9932,1,19477,10572,9731
9131354,9131350,TXFE7,128,9932,1,19478,10573,9732
9131367,9131364,TXFE7,128,9931,10,19488,10581,9733
9131379,9131367,TXFE7,128,9931,23,19511,10590,9734
9131379,9131372,TXFE7,128,9932,1,19512,10591,9735
9131404,9131398,TXFE7,128,9931,1,19513,10592,9736
9131417,9131405,TXFE7,128,9931,1,19514,10593,9737
9131417,9131407,TXFE7,128,9931,1,19515,10594,9738
9131467,9131456,TXFE7,128,9931,5,19520,10595,9739
9131467,9131458,TXFE7,128,9931,1,19521,10596,9740
9131467,9131461,TXFE7,128,9931,4,19525,10597,9742
9131479,9131476,TXFE7,128,9930,11,19536,10599,9743
9131504,9131499,TXFE7,128,9931,1,19537,10600,9744
9131529,9131520,TXFE7,128,9931,1,19538,10601,9745
9131529,9131520,TXFE7,128,9931,1,19539,10602,9746
9131554,9131547,TXFE7,128,9931,1,19540,10603,9747
9131567,9131557,TXFE7,128,9931,1,19541,10604,9748
9131592,9131591,TXFE7,128,9931,1,19542,10605,9749
9131679,9131672,TXFE7,128,9930,1,19543,10606,9750
9131679,9131675,TXFE7,128,9930,1,19544,10607,9751
9131717,9131717,TXFE7,128,9931,1,19545,10608,9752
9131767,9131757,TXFE7,128,9930,15,19560,10613,9753
9131779,9131772,TXFE7,128,9930,1,19561,10614,9754
9131779,9131774,TXFE7,128,9930,1,19562,10615,9755
9131829,9131820,TXFE7,128,9930,1,19563,10616,9756
9131854,9131854,TXFE7,128,9930,1,19564,10617,9757
9131867,9131856,TXFE7,128,9930,1,19565,10618,9758
9131867,9131857,TXFE7,128,9931,1,19566,10619,9759
9131879,9131875,TXFE7,128,9930,25,19591,10634,9760
9131892,9131880,TXFE7,128,9930,20,19611,10650,9761
9131892,9131880,TXFE7,128,9929,2,19613,10652,9762
9131892,9131881,TXFE7,128,9930,1,19614,10653,9763
9131892,9131882,TXFE7,128,9930,1,19615,10654,9764
9131892,9131885,TXFE7,128,9930,1,19616,10655,9765
9131904,9131899,TXFE7,128,9929,2,19618,10657,9766
9131917,9131907,TXFE7,128,9929,3,19621,10660,9767
9131942,9131930,TXFE7,128,9929,8,19629,10665,9768
9131954,9131942,TXFE7,128,9929,15,19644,10673,9769
9131954,9131942,TXFE7,129,9929,3,19650,10678,9770
9131954,9131942,TXFE7,129,9928,3,19650,10678,9770
9131954,9131943,TXFE7,128,9930,5,19655,10679,9774
9131967,9131955,TXFE7,128,9928,1,19656,10680,9775
9131967,9131958,TXFE7,128,9929,1,19657,10681,9776
9131967,9131963,TXFE7,128,9929,1,19658,10682,9777
9131979,9131968,TXFE7,128,9928,1,19659,10683,9778
9131979,9131969,TXFE7,128,9929,1,19660,10684,9779
9132017,9132011,TXFE7,128,9928,1,19661,10685,9780
9132017,9132014,TXFE7,128,9929,1,19662,10686,9781
9132042,9132034,TXFE7,128,9929,1,19663,10687,9782
9132067,9132064,TXFE7,128,9929,1,19664,10688,9783
9132067,9132067,TXFE7,128,9928,1,19665,10689,9784
9132079,9132069,TXFE7,128,9929,1,19666,10690,9785
9132092,9132085,TXFE7,128,9928,1,19667,10691,9786
9132104,9132098,TXFE7,128,9929,2,19669,10692,9788
9132117,9132109,TXFE7,128,9928,1,19670,10693,9789
9132129,9132117,TXFE7,128,9929,9,19679,10694,9794
9132142,9132132,TXFE7,128,9928,2,19681,10695,9795
9132142,9132140,TXFE7,128,9928,1,19682,10696,9796
9132154,9132153,TXFE7,128,9928,1,19683,10697,9797
9132167,9132162,TXFE7,128,9928,1,19684,10698,9798
9132179,9132172,TXFE7,128,9928,1,19685,10699,9799
9132229,9132227,TXFE7,128,9929,2,19687,10700,9800
9132304,9132292,TXFE7,128,9929,1,19688,10701,9801
9132304,9132294,TXFE7,128,9929,3,19691,10702,9804
9132304,9132298,TXFE7,128,9928,2,19693,10703,9805
9132317,9132309,TXFE7,128,9928,1,19694,10704,9806
9132329,9132319,TXFE7,128,9928,3,19697,10705,9807
9132367,9132362,TXFE7,128,9928,3,19700,10707,9808
9132404,9132401,TXFE7,128,9928,1,19701,10708,9809
9132467,9132461,TXFE7,128,9928,1,19702,10709,9810
9132504,9132494,TXFE7,128,9928,1,19703,10710,9811
9132629,9132619,TXFE7,128,9928,1,19704,10711,9812
9132692,9132687,TXFE7,128,9928,1,19705,10712,9813
9132729,9132729,TXFE7,128,9928,1,19706,10713,9814
9132754,9132742,TXFE7,128,9929,1,19707,10714,9815
9132779,9132773,TXFE7,128,9929,1,19708,10715,9816
9132779,9132775,TXFE7,128,9928,1,19709,10716,9817
9132829,9132826,TXFE7,128,9928,1,19710,10717,9818
9132879,9132872,TXFE7,128,9928,1,19711,10718,9819
9132879,9132875,TXFE7,128,9928,1,19712,10719,9820
9132892,9132880,TXFE7,128,9929,1,19713,10720,9821
9132892,9132884,TXFE7,128,9929,1,19714,10721,9822
9132929,9132921,TXFE7,128,9929,1,19715,10722,9823
9132954,9132943,TXFE7,128,9928,1,19716,10723,9824
9132954,9132948,TXFE7,128,9929,1,19717,10724,9825
9132954,9132950,TXFE7,128,9928,1,19718,10725,9826
9132979,9132977,TXFE7,128,9928,1,19719,10726,9827
9132979,9132979,TXFE7,128,9929,1,19720,10727,9828
9133004,9132997,TXFE7,128,9928,1,19721,10728,9829
9133029,9133019,TXFE7,128,9928,1,19722,10729,9830
9133067,9133067,TXFE7,128,9929,2,19724,10730,9832
9133079,9133075,TXFE7,128,9929,1,19725,10731,9833
9133092,9133079,TXFE7,128,9929,1,19726,10732,9834
9133092,9133079,TXFE7,128,9929,1,19727,10733,9835
9133104,9133092,TXFE7,128,9929,2,19729,10734,9837
9133104,9133096,TXFE7,128,9929,1,19730,10735,9838
9133104,9133096,TXFE7,128,9929,2,19732,10736,9840
9133104,9133100,TXFE7,128,9929,1,19733,10737,9841
9133104,9133101,TXFE7,128,9928,1,19734,10738,9842
9133142,9133133,TXFE7,128,9929,1,19735,10739,9843
9133167,9133158,TXFE7,128,9929,1,19736,10740,9844
9133192,9133184,TXFE7,128,9929,1,19737,10741,9845
9133204,9133195,TXFE7,128,9929,1,19738,10742,9846
9133204,9133201,TXFE7,128,9929,1,19739,10743,9847
9133217,9133213,TXFE7,128,9929,2,19741,10744,9848
9133242,9133236,TXFE7,128,9929,1,19742,10745,9849
9133242,9133237,TXFE7,128,9930,5,19747,10746,9854
9133292,9133290,TXFE7,128,9930,2,19749,10747,9856
9133292,9133291,TXFE7,128,9930,1,19750,10748,9857
9133304,9133300,TXFE7,128,9929,1,19751,10749,9858
9133354,9133344,TXFE7,128,9929,2,19753,10750,9859
9133404,9133399,TXFE7,128,9930,1,19754,10751,9860
9133442,9133431,TXFE7,128,9930,9,19763,10752,9863
9133479,9133479,TXFE7,128,9930,1,19764,10753,9864
9133529,9133528,TXFE7,128,9931,9,19773,10754,9868
9133554,9133547,TXFE7,128,9930,1,19774,10755,9869
9133567,9133566,TXFE7,128,9931,5,19779,10756,9872
9133579,9133567,TXFE7,128,9931,3,19782,10757,9875
9133592,9133583,TXFE7,128,9931,5,19787,10758,9878
9133617,9133610,TXFE7,128,9931,10,19797,10759,9881
9133642,9133640,TXFE7,128,9931,1,19798,10760,9882
9133654,9133649,TXFE7,128,9932,2,19800,10761,9883
9133667,9133662,TXFE7,128,9932,1,19801,10762,9884
9133679,9133668,TXFE7,128,9930,1,19802,10763,9885
9133679,9133670,TXFE7,128,9932,1,19803,10764,9886
9133729,9133718,TXFE7,128,9930,1,19804,10765,9887
9133754,9133750,TXFE7,128,9932,1,19805,10766,9888
9133767,9133762,TXFE7,128,9930,1,19806,10767,9889
9133842,9133838,TXFE7,128,9930,1,19807,10768,9890
9133854,9133854,TXFE7,128,9930,3,19810,10769,9891
9133917,9133916,TXFE7,128,9930,1,19811,10770,9892
9133954,9133946,TXFE7,128,9931,1,19812,10771,9893
9133992,9133984,TXFE7,128,9931,10,19822,10772,9899
9134004,9133994,TXFE7,128,9931,1,19823,10773,9900
9134017,9134009,TXFE7,128,9931,6,19829,10774,9905
9134029,9134028,TXFE7,128,9931,1,19830,10775,9906
9134042,9134040,TXFE7,128,9931,2,19832,10777,9907
9134042,9134041,TXFE7,128,9930,1,19833,10778,9908
9134054,9134045,TXFE7,128,9930,1,19834,10779,9909
9134079,9134073,TXFE7,128,9930,1,19835,10780,9910
9134129,9134127,TXFE7,128,9931,3,19838,10781,9912
9134167,9134155,TXFE7,128,9931,1,19839,10782,9913
9134192,9134184,TXFE7,128,9930,1,19840,10783,9914
9134192,9134190,TXFE7,128,9931,2,19842,10784,9916
9134254,9134245,TXFE7,128,9931,7,19849,10785,9918
9134267,9134254,TXFE7,128,9931,1,19850,10786,9919
9134517,9134510,TXFE7,128,9931,3,19853,10787,9920
9134529,9134518,TXFE7,128,9931,1,19854,10788,9921
9134542,9134535,TXFE7,128,9931,1,19855,10789,9922
9134554,9134550,TXFE7,128,9931,1,19856,10790,9923
9134567,9134560,TXFE7,128,9932,5,19861,10791,9926
9134567,9134561,TXFE7,128,9932,1,19862,10792,9927
9134592,9134580,TXFE7,128,9931,1,19863,10793,9928
9134629,9134621,TXFE7,128,9932,1,19864,10794,9929
9134679,9134673,TXFE7,128,9931,1,19865,10795,9930
9134692,9134684,TXFE7,128,9931,2,19867,10797,9931
9134704,9134692,TXFE7,128,9931,3,19870,10800,9932
9134704,9134695,TXFE7,128,9931,1,19871,10801,9933
9134717,9134714,TXFE7,128,9930,1,19872,10802,9934
9134754,9134746,TXFE7,128,9930,40,19912,10824,9935
9134767,9134754,TXFE7,128,9930,1,19913,10825,9936
9134767,9134754,TXFE7,128,9930,1,19914,10826,9937
9134792,9134779,TXFE7,128,9930,1,19915,10827,9938
9134842,9134831,TXFE7,128,9931,1,19916,10828,9939
9134967,9134960,TXFE7,128,9930,1,19917,10829,9940
9135004,9135003,TXFE7,128,9930,2,19919,10830,9941
9135154,9135152,TXFE7,128,9930,1,19920,10831,9942
9135167,9135164,TXFE7,128,9931,1,19921,10832,9943
9135179,9135169,TXFE7,128,9930,1,19922,10833,9944
9135192,9135185,TXFE7,128,9930,4,19926,10834,9945
9135279,9135267,TXFE7,128,9930,3,19929,10835,9946
9135279,9135275,TXFE7,128,9931,1,19930,10836,9947
9135317,9135316,TXFE7,128,9931,1,19931,10837,9948
9135342,9135335,TXFE7,128,9930,1,19932,10838,9949
9135342,9135340,TXFE7,128,9931,1,19933,10839,9950
9135342,9135341,TXFE7,128,9930,2,19935,10840,9951
9135379,9135368,TXFE7,128,9931,1,19936,10841,9952
9135417,9135408,TXFE7,128,9930,1,19937,10842,9953
9135417,9135410,TXFE7,128,9930,3,19940,10843,9954
9135417,9135411,TXFE7,128,9931,3,19943,10844,9956
9135429,9135420,TXFE7,128,9930,7,19950,10850,9957
9135479,9135473,TXFE7,128,9930,1,19951,10851,9958
9135567,9135555,TXFE7,128,9930,1,19952,10852,9959
9135579,9135573,TXFE7,128,9930,2,19954,10854,9960
9135592,9135588,TXFE7,128,9930,1,19955,10855,9961
9135592,9135590,TXFE7,128,9930,2,19957,10856,9962
9135604,9135598,TXFE7,128,9930,1,19958,10857,9963
9135667,9135658,TXFE7,128,9930,3,19961,10859,9964
9135667,9135659,TXFE7,128,9930,1,19962,10860,9965
9135667,9135663,TXFE7,128,9931,1,19963,10861,9966
9135679,9135669,TXFE7,128,9930,4,19967,10864,9967
9135679,9135669,TXFE7,128,9931,1,19968,10865,9968
9135729,9135720,TXFE7,128,9930,1,19969,10866,9969
9135742,9135732,TXFE7,128,9930,3,19972,10868,9970
9135754,9135748,TXFE7,129,9930,4,19977,10872,9971
9135754,9135748,TXFE7,129,9929,1,19977,10872,9971
9135767,9135756,TXFE7,128,9930,1,19978,10873,9972
9135792,9135779,TXFE7,128,9930,1,19979,10874,9973
9135804,9135794,TXFE7,128,9930,2,19981,10875,9974
9135817,9135805,TXFE7,128,9930,4,19985,10876,9976
9135829,9135818,TXFE7,128,9931,1,19986,10877,9977
9135829,9135820,TXFE7,128,9930,2,19988,10878,9978
9135829,9135823,TXFE7,128,9930,1,19989,10879,9979
9135854,9135853,TXFE7,128,9931,1,19990,10880,9980
9135917,9135912,TXFE7,128,9930,1,19991,10881,9981
9135917,9135917,TXFE7,128,9930,1,19992,10882,9982
9135929,9135925,TXFE7,128,9930,5,19997,10885,9983
9135942,9135935,TXFE7,128,9930,1,19998,10886,9984
9135992,9135982,TXFE7,128,9930,1,19999,10887,9985
9135992,9135984,TXFE7,128,9930,1,20000,10888,9986
9135992,9135991,TXFE7,128,9930,1,20001,10889,9987
9140004,9135997,TXFE7,128,9930,1,20002,10890,9988
9140017,9140007,TXFE7,128,9929,5,20007,10893,9989
9140042,9140035,TXFE7,128,9930,1,20008,10894,9990
9140042,9140038,TXFE7,128,9929,1,20009,10895,9991
9140054,9140044,TXFE7,128,9930,1,20010,10896,9992
9140054,9140048,TXFE7,128,9930,1,20011,10897,9993
9140054,9140050,TXFE7,128,9930,1,20012,10898,9994
9140067,9140056,TXFE7,128,9930,6,20018,10899,9995
9140067,9140058,TXFE7,128,9930,1,20019,10900,9996
9140117,9140112,TXFE7,128,9930,1,20020,10901,9997
9140142,9140141,TXFE7,128,9929,1,20021,10902,9998
9140167,9140160,TXFE7,128,9930,1,20022,10903,9999
9140179,9140175,TXFE7,128,9930,1,20023,10904,10000
9140229,9140220,TXFE7,128,9930,1,20024,10905,10001
9140317,9140305,TXFE7,128,9930,2,20026,10906,10003
9140317,9140305,TXFE7,128,9931,1,20027,10907,10004
9140342,9140331,TXFE7,128,9929,2,20029,10909,10005
9140354,9140349,TXFE7,128,9930,2,20031,10910,10007
9140404,9140392,TXFE7,128,9929,1,20032,10911,10008
9140417,9140407,TXFE7,128,9931,1,20033,10912,10009
9140467,9140459,TXFE7,128,9931,1,20034,10913,10010
9140479,9140474,TXFE7,128,9931,1,20035,10914,10011
9140504,9140499,TXFE7,128,9930,7,20042,10917,10012
9140529,9140525,TXFE7,128,9931,1,20043,10918,10013
9140529,9140528,TXFE7,128,9931,1,20044,10919,10014
9140629,9140622,TXFE7,128,9930,1,20045,10920,10015
9140642,9140638,TXFE7,128,9930,2,20047,10921,10016
9140642,9140639,TXFE7,128,9931,1,20048,10922,10017
9140767,9140764,TXFE7,128,9930,1,20049,10923,10018
9140767,9140766,TXFE7,128,9930,6,20055,10928,10019
9140779,9140769,TXFE7,128,9929,1,20056,10929,10020
9140792,9140785,TXFE7,128,9930,1,20057,10930,10021
9140804,9140798,TXFE7,128,9930,1,20058,10931,10022
9140867,9140859,TXFE7,128,9930,1,20059,10932,10023
9140904,9140898,TXFE7,128,9930,2,20061,10933,10025
9141054,9141046,TXFE7,128,9930,7,20068,10934,10029
9141067,9141063,TXFE7,128,9930,11,20079,10935,10035
9141117,9141116,TXFE7,128,9930,1,20080,10936,10036
9141129,9141127,TXFE7,128,9930,2,20082,10937,10037
9141167,9141161,TXFE7,128,9930,1,20083,10938,10038
9141179,9141172,TXFE7,128,9930,1,20084,10939,10039
9141217,9141217,TXFE7,128,9930,2,20086,10940,10040
9141392,9141384,TXFE7,128,9930,1,20087,10941,10041
9141417,9141415,TXFE7,128,9930,3,20090,10944,10042
9141479,9141470,TXFE7,128,9929,2,20092,10945,10043
9141479,9141472,TXFE7,128,9929,1,20093,10946,10044
9141542,9141542,TXFE7,128,9930,1,20094,10947,10045
9141592,9141579,TXFE7,128,9930,1,20095,10948,10046
9141604,9141592,TXFE7,128,9930,3,20098,10949,10047
9141617,9141606,TXFE7,128,9929,1,20099,10950,10048
9141629,9141620,TXFE7,128,9929,1,20100,10951,10049
9141642,9141640,TXFE7,128,9930,1,20101,10952,10050
9141642,9141641,TXFE7,128,9930,1,20102,10953,10051
9141717,9141704,TXFE7,128,9930,1,20103,10954,10052
9141754,9141747,TXFE7,128,9929,1,20104,10955,10053
9141792,9141785,TXFE7,128,9929,1,20105,10956,10054
9141804,9141792,TXFE7,128,9930,1,20106,10957,10055
9141817,9141810,TXFE7,128,9929,1,20107,10958,10056
9141842,9141835,TXFE7,128,9930,10,20117,10959,10061
9141867,9141861,TXFE7,128,9929,2,20119,10961,10062
9141917,9141914,TXFE7,128,9930,2,20121,10962,10063
9141929,9141927,TXFE7,128,9929,1,20122,10963,10064
9141954,9141949,TXFE7,128,9930,2,20124,10964,10065
9141954,9141950,TXFE7,128,9929,1,20125,10965,10066
9141992,9141992,TXFE7,128,9930,2,20127,10966,10068
9142017,9142006,TXFE7,128,9930,1,20128,10967,10069
9142042,9142034,TXFE7,128,9929,1,20129,10968,10070
9142092,9142080,TXFE7,128,9929,1,20130,10969,10071
9142129,9142127,TXFE7,128,9929,1,20131,10970,10072
9142129,9142129,TXFE7,128,9929,1,20132,10971,10073
9142142,9142135,TXFE7,128,9929,1,20133,10972,10074
9142204,9142194,TXFE7,128,9930,10,20143,10973,10076
9142229,9142228,TXFE7,128,9929,1,20144,10974,10077
9142254,9142254,TXFE7,128,9929,2,20146,10976,10078
9142267,9142258,TXFE7,128,9930,10,20156,10977,10083
9142279,9142278,TXFE7,128,9929,1,20157,10978,10084
9142317,9142315,TXFE7,128,9930,1,20158,10979,10085
9142342,9142331,TXFE7,128,9930,1,20159,10980,10086
9142379,9142371,TXFE7,128,9930,1,20160,10981,10087
9142467,9142465,TXFE7,128,9930,2,20162,10982,10088
9142504,9142501,TXFE7,128,9929,1,20163,10983,10089
9142554,9142548,TXFE7,128,9929,20,20183,11000,10090
9142617,9142613,TXFE7,128,9930,1,20184,11001,10091
9142729,9142727,TXFE7,128,9929,1,20185,11002,10092
9142767,9142754,TXFE7,128,9930,1,20186,11003,10093
9142767,9142760,TXFE7,128,9929,1,20187,11004,10094
9142817,9142814,TXFE7,128,9929,1,20188,11005,10095
9142854,9142844,TXFE7,128,9929,1,20189,11006,10096
9142867,9142861,TXFE7,128,9929,1,20190,11007,10097
9142892,9142884,TXFE7,128,9929,1,20191,11008,10098
9142917,9142915,TXFE7,128,9929,1,20192,11009,10099
9142967,9142962,TXFE7,128,9929,1,20193,11010,10100
9142992,9142979,TXFE7,128,9929,1,20194,11011,10101
9142992,9142987,TXFE7,128,9930,1,20195,11012,10102
9143054,9143049,TXFE7,128,9929,8,20203,11015,10103
9143054,9143050,TXFE7,128,9929,3,20206,11016,10104
9143104,9143097,TXFE7,128,9930,3,20209,11017,10107
9143204,9143193,TXFE7,128,9930,1,20210,11018,10108
9143229,9143228,TXFE7,128,9929,1,20211,11019,10109
9143242,9143236,TXFE7,128,9929,1,20212,11020,10110
9143254,9143249,TXFE7,128,9929,1,20213,11021,10111
9143292,9143288,TXFE7,128,9929,1,20214,11022,10112
9143429,9143425,TXFE7,128,9929,1,20215,11023,10113
9143442,9143436,TXFE7,128,9929,1,20216,11024,10114
9143442,9143440,TXFE7,128,9928,30,20246,11039,10115
9143467,9143460,TXFE7,128,9928,3,20249,11040,10116
9143467,9143463,TXFE7,128,9929,1,20250,11041,10117
9143467,9143464,TXFE7,128,9928,1,20251,11042,10118
9143467,9143464,TXFE7,128,9929,3,20254,11043,10120
9143492,9143482,TXFE7,128,9929,1,20255,11044,10121
9143554,9143545,TXFE7,128,9929,9,20264,11045,10125
9143567,9143560,TXFE7,128,9928,2,20266,11047,10126
9143604,9143599,TXFE7,128,9928,5,20271,11051,10127
9143654,9143651,TXFE7,128,9929,2,20273,11052,10128
9143704,9143700,TXFE7,128,9928,1,20274,11053,10129
9143717,9143713,TXFE7,128,9928,2,20276,11054,10130
9143829,9143817,TXFE7,128,9929,5,20281,11055,10132
9143829,9143818,TXFE7,128,9929,1,20282,11056,10133
9143829,9143821,TXFE7,128,9928,1,20283,11057,10134
9143842,9143839,TXFE7,128,9929,1,20284,11058,10135
9143854,9143850,TXFE7,128,9928,2,20286,11059,10136
9143867,9143866,TXFE7,128,9928,1,20287,11060,10137
9143879,9143873,TXFE7,128,9929,1,20288,11061,10138
9143979,9143976,TXFE7,128,9928,1,20289,11062,10139
9144004,9144003,TXFE7,128,9929,1,20290,11063,10140
9144017,9144013,TXFE7,128,9929,1,20291,11064,10141
9144079,9144070,TXFE7,128,9929,1,20292,11065,10142
9144079,9144072,TXFE7,128,9929,5,20297,11066,10144
9144092,9144081,TXFE7,128,9929,1,20298,11067,10145
9144092,9144086,TXFE7,128,9929,1,20299,11068,10146
9144104,9144103,TXFE7,128,9929,2,20301,11070,10147
9144117,9144114,TXFE7,128,9929,1,20302,11071,10148
9144154,9144151,TXFE7,128,9929,1,20303,11072,10149
9144154,9144153,TXFE7,128,9928,1,20304,11073,10150
9144167,9144160,TXFE7,128,9929,4,20308,11074,10151
9144204,9144194,TXFE7,128,9929,2,20310,11075,10152
9144242,9144237,TXFE7,128,9928,2,20312,11077,10153
9144304,9144298,TXFE7,128,9928,2,20314,11079,10154
9144329,9144318,TXFE7,128,9928,5,20319,11084,10155
9144329,9144319,TXFE7,128,9928,25,20344,11101,10156
9144342,9144329,TXFE7,128,9928,4,20348,11104,10157
9144354,9144342,TXFE7,128,9928,2,20350,11105,10158
9144354,9144348,TXFE7,128,9929,3,20353,11106,10160
9144379,9144378,TXFE7,128,9928,5,20358,11109,10161
9144479,9144471,TXFE7,128,9928,2,20360,11111,10162
9144479,9144473,TXFE7,128,9928,1,20361,11112,10163
9144492,9144486,TXFE7,128,9928,1,20362,11113,10164
9144504,9144499,TXFE7,128,9929,1,20363,11114,10165
9144592,9144584,TXFE7,129,9928,22,20405,11137,10166
9144592,9144584,TXFE7,129,9927,20,20405,11137,10166
9144592,9144587,TXFE7,128,9928,1,20406,11138,10167
9144592,9144589,TXFE7,128,9928,2,20408,11139,10168
9144592,9144589,TXFE7,128,9928,6,20414,11140,10169
9144592,9144589,TXFE7,128,9928,4,20418,11141,10170
9144604,9144592,TXFE7,128,9928,2,20420,11142,10171
9144604,9144592,TXFE7,128,9928,3,20423,11143,10172
9144604,9144604,TXFE7,128,9928,1,20424,11144,10173
9144629,9144621,TXFE7,128,9928,2,20426,11145,10174
9144629,9144621,TXFE7,128,9928,3,20429,11146,10177
9144642,9144630,TXFE7,128,9929,1,20430,11147,10178
9144654,9144651,TXFE7,128,9928,1,20431,11148,10179
9144692,9144680,TXFE7,128,9928,1,20432,11149,10180
9144704,9144692,TXFE7,128,9928,1,20433,11150,10181
9144754,9144743,TXFE7,128,9929,1,20434,11151,10182
9144779,9144774,TXFE7,128,9928,1,20435,11152,10183
9144829,9144826,TXFE7,128,9929,1,20436,11153,10184
9144942,9144937,TXFE7,128,9928,1,20437,11154,10185
9144992,9144984,TXFE7,128,9928,1,20438,11155,10186
9144992,9144990,TXFE7,128,9929,1,20439,11156,10187
9145017,9145013,TXFE7,128,9929,1,20440,11157,10188
9145042,9145031,TXFE7,128,9929,1,20441,11158,10189
9145304,9145292,TXFE7,128,9928,1,20442,11159,10190
9145367,9145355,TXFE7,128,9928,1,20443,11160,10191
9145367,9145361,TXFE7,128,9929,1,20444,11161,10192
9145367,9145362,TXFE7,128,9929,1,20445,11162,10193
9145392,9145384,TXFE7,128,9929,1,20446,11163,10194
9145417,9145411,TXFE7,128,9928,1,20447,11164,10195
9145479,9145472,TXFE7,128,9928,12,20459,11168,10196
9145567,9145561,TXFE7,128,9928,1,20460,11169,10197
9145592,9145590,TXFE7,128,9928,1,20461,11170,10198
9145604,9145601,TXFE7,128,9928,2,20463,11172,10199
9145654,9145647,TXFE7,128,9928,1,20464,11173,10200
9145729,9145720,TXFE7,128,9928,1,20465,11174,10201
9145867,9145867,TXFE7,128,9928,1,20466,11175,10202
9145904,9145903,TXFE7,128,9928,10,20476,11185,10203
9145917,9145912,TXFE7,128,9928,1,20477,11186,10204
9145929,9145919,TXFE7,128,9929,2,20479,11187,10206
9145954,9145944,TXFE7,128,9928,1,20480,11188,10207
9145992,9145988,TXFE7,128,9928,1,20481,11189,10208
9150004,9145999,TXFE7,128,9929,1,20482,11190,10209
9150017,9150016,TXFE7,128,9928,1,20483,11191,10210
9150029,9150021,TXFE7,128,9929,5,20488,11192,10213
9150042,9150032,TXFE7,128,9928,22,20510,11211,10214
9150042,9150033,TXFE7,128,9928,2,20512,11213,10215
9150042,9150035,TXFE7,128,9928,1,20513,11214,10216
9150042,9150035,TXFE7,128,9928,1,20514,11215,10217
9150042,9150037,TXFE7,128,9929,1,20515,11216,10218
9150042,9150039,TXFE7,128,9928,2,20517,11218,10219
9150042,9150040,TXFE7,128,9928,1,20518,11219,10220
9150042,9150040,TXFE7,128,9928,1,20519,11220,10221
9150054,9150047,TXFE7,128,9928,1,20520,11221,10222
9150054,9150047,TXFE7,128,9928,1,20521,11222,10223
9150054,9150048,TXFE7,128,9928,1,20522,11223,10224
9150054,9150049,TXFE7,128,9927,1,20523,11224,10225
9150054,9150051,TXFE7,129,9928,1,20526,11226,10226
9150054,9150051,TXFE7,129,9927,2,20526,11226,10226
9150054,9150054,TXFE7,128,9927,2,20528,11227,10227
9150067,9150055,TXFE7,128,9927,8,20536,11229,10228
9150067,9150060,TXFE7,128,9928,1,20537,11230,10229
9150067,9150062,TXFE7,128,9928,2,20539,11231,10230
9150067,9150063,TXFE7,128,9928,2,20541,11232,10231
9150067,9150064,TXFE7,128,9927,1,20542,11233,10232
9150079,9150075,TXFE7,128,9928,3,20545,11234,10234
9150092,9150080,TXFE7,128,9928,1,20546,11235,10235
9150092,9150080,TXFE7,128,9928,1,20547,11236,10236
9150092,9150083,TXFE7,128,9927,2,20549,11237,10237
9150092,9150084,TXFE7,128,9928,1,20550,11238,10238
9150092,9150084,TXFE7,128,9928,1,20551,11239,10239
9150092,9150085,TXFE7,128,9927,2,20553,11240,10240
9150092,9150089,TXFE7,128,9928,1,20554,11241,10241
9150092,9150091,TXFE7,128,9928,2,20556,11242,10242
9150104,9150093,TXFE7,128,9929,1,20557,11243,10243
9150104,9150096,TXFE7,128,9928,1,20558,11244,10244
9150104,9150099,TXFE7,128,9928,1,20559,11245,10245
9150104,9150100,TXFE7,129,9928,1,20561,11247,10246
9150104,9150100,TXFE7,129,9927,1,20561,11247,10246
9150117,9150108,TXFE7,128,9928,2,20563,11248,10247
9150129,9150118,TXFE7,128,9928,1,20564,11249,10248
9150129,9150122,TXFE7,128,9929,1,20565,11250,10249
9150129,9150122,TXFE7,128,9929,1,20566,11251,10250
9150129,9150123,TXFE7,128,9928,1,20567,11252,10251
9150129,9150128,TXFE7,128,9929,1,20568,11253,10252
9150129,9150128,TXFE7,128,9928,5,20573,11255,10253
9150142,9150129,TXFE7,128,9929,1,20574,11256,10254
9150142,9150136,TXFE7,128,9928,1,20575,11257,10255
9150142,9150136,TXFE7,128,9929,1,20576,11258,10256
9150142,9150137,TXFE7,128,9928,1,20577,11259,10257
9150142,9150137,TXFE7,128,9928,4,20581,11261,10258
9150142,9150138,TXFE7,128,9929,1,20582,11262,10259
9150142,9150141,TXFE7,128,9929,1,20583,11263,10260
9150154,9150143,TXFE7,128,9929,1,20584,11264,10261
9150154,9150152,TXFE7,128,9929,1,20585,11265,10262
9150154,9150154,TXFE7,128,9928,1,20586,11266,10263
9150167,9150161,TXFE7,128,9928,2,20588,11267,10264
9150179,9150168,TXFE7,128,9928,2,20590,11268,10265
9150179,9150169,TXFE7,128,9928,1,20591,11269,10266
9150192,9150185,TXFE7,128,9929,5,20596,11270,10271
9150192,9150188,TXFE7,128,9929,1,20597,11271,10272
9150204,9150197,TXFE7,128,9929,5,20602,11272,10275
9150204,9150201,TXFE7,128,9928,2,20604,11273,10276
9150217,9150205,TXFE7,128,9928,1,20605,11274,10277
9150217,9150208,TXFE7,128,9929,4,20609,11275,10281
9150217,9150213,TXFE7,128,9928,2,20611,11276,10282
9150217,9150213,TXFE7,128,9929,5,20616,11277,10284
9150217,9150214,TXFE7,128,9929,5,20621,11278,10288
9150229,9150225,TXFE7,128,9928,4,20625,11280,10289
9150229,9150225,TXFE7,128,9929,5,20630,11281,10293
9150229,9150227,TXFE7,128,9929,5,20635,11282,10294
9150242,9150232,TXFE7,128,9929,4,20639,11283,10296
9150242,9150234,TXFE7,128,9929,1,20640,11284,10297
9150242,9150241,TXFE7,128,9929,5,20645,11285,10298
9150267,9150255,TXFE7,128,9930,1,20646,11286,10299
9150279,9150277,TXFE7,128,9930,1,20647,11287,10300
9150292,9150281,TXFE7,128,9929,2,20649,11288,10301
9150304,9150292,TXFE7,128,9929,6,20655,11290,10302
9150304,9150292,TXFE7,128,9929,1,20656,11291,10303
9150304,9150292,TXFE7,128,9929,1,20657,11292,10304
9150304,9150301,TXFE7,128,9930,2,20659,11293,10305
9150329,9150320,TXFE7,128,9929,3,20662,11295,10306
9150329,9150324,TXFE7,128,9930,1,20663,11296,10307
9150342,9150329,TXFE7,128,9929,21,20684,11300,10308
9150342,9150329,TXFE7,128,9929,1,20685,11301,10309
9150342,9150337,TXFE7,128,9930,1,20686,11302,10310
9150354,9150342,TXFE7,128,9929,1,20687,11303,10311
9150354,9150343,TXFE7,128,9929,5,20692,11304,10315
9150367,9150361,TXFE7,128,9929,1,20693,11305,10316
9150379,9150369,TXFE7,128,9929,2,20695,11306,10317
9150392,9150388,TXFE7,128,9929,1,20696,11307,10318
9150417,9150408,TXFE7,128,9928,1,20697,11308,10319
9150429,9150423,TXFE7,128,9929,1,20698,11309,10320
9150429,9150425,TXFE7,128,9929,3,20701,11310,10323
9150429,9150426,TXFE7,128,9928,5,20706,11311,10324
9150442,9150437,TXFE7,128,9929,2,20708,11312,10325
9150454,9150447,TXFE7,128,9929,1,20709,11313,10326
9150479,9150476,TXFE7,128,9928,11,20720,11322,10327
9150479,9150477,TXFE7,128,9929,2,20722,11323,10328
9150479,9150478,TXFE7,128,9928,4,20726,11324,10329
9150542,9150530,TXFE7,128,9928,1,20727,11325,10330
9150554,9150542,TXFE7,128,9927,37,20764,11351,10331
9150567,9150554,TXFE7,128,9927,2,20766,11353,10332
9150567,9150558,TXFE7,128,9928,1,20767,11354,10333
9150567,9150559,TXFE7,128,9927,18,20785,11363,10334
9150579,9150571,TXFE7,128,9926,1,20786,11364,10335
9150592,9150580,TXFE7,128,9926,2,20788,11365,10336
9150592,9150582,TXFE7,128,9926,5,20793,11368,10337
9150592,9150582,TXFE7,128,9926,2,20795,11370,10338
9150592,9150586,TXFE7,128,9926,1,20796,11371,10339
9150592,9150587,TXFE7,128,9926,2,20798,11373,10340
9150604,9150596,TXFE7,128,9927,10,20808,11374,10344
9150604,9150598,TXFE7,128,9926,2,20810,11375,10345
9150604,9150600,TXFE7,128,9926,8,20818,11377,10346
9150604,9150600,TXFE7,128,9926,6,20824,11381,10347
9150617,9150604,TXFE7,128,9927,1,20825,11382,10348
9150617,9150604,TXFE7,128,9927,1,20826,11383,10349
9150617,9150614,TXFE7,128,9926,1,20827,11384,10350
9150629,9150617,TXFE7,128,9926,1,20828,11385,10351
9150629,9150626,TXFE7,128,9926,5,20833,11386,10352
9150642,9150635,TXFE7,128,9926,3,20836,11387,10353
9150654,9150642,TXFE7,128,9926,1,20837,11388,10354
9150654,9150645,TXFE7,128,9927,1,20838,11389,10355
9150654,9150646,TXFE7,128,9926,2,20840,11390,10356
9150667,9150654,TXFE7,128,9926,1,20841,11391,10357
9150667,9150666,TXFE7,128,9927,1,20842,11392,10358
9150692,9150690,TXFE7,128,9927,1,20843,11393,10359
9150704,9150704,TXFE7,128,9927,3,20846,11394,10360
9150717,9150705,TXFE7,128,9927,1,20847,11395,10361
9150717,9150708,TXFE7,128,9926,2,20849,11396,10362
9150779,9150768,TXFE7,129,9927,38,20909,11397,10391
9150779,9150768,TXFE7,129,9928,22,20909,11397,10391
9150779,9150776,TXFE7,128,9927,2,20911,11398,10392
9150804,9150792,TXFE7,128,9928,1,20912,11399,10393
9150829,9150819,TXFE7,128,9928,1,20913,11400,10394
9150842,9150834,TXFE7,128,9928,1,20914,11401,10395
9150867,9150861,TXFE7,128,9927,1,20915,11402,10396
9150879,9150879,TXFE7,128,9928,1,20916,11403,10397
9150904,9150897,TXFE7,128,9927,1,20917,11404,10398
9150917,9150905,TXFE7,128,9927,1,20918,11405,10399
9150929,9150922,TXFE7,128,9927,5,20923,11407,10400
9150979,9150975,TXFE7,128,9928,2,20925,11408,10402
9150979,9150979,TXFE7,128,9927,1,20926,11409,10403
9150992,9150986,TXFE7,128,9928,1,20927,11410,10404
9151017,9151010,TXFE7,128,9927,4,20931,11413,10405
9151029,9151018,TXFE7,128,9928,1,20932,11414,10406
9151054,9151049,TXFE7,128,9927,3,20935,11417,10407
9151079,9151077,TXFE7,128,9927,1,20936,11418,10408
9151079,9151078,TXFE7,128,9927,1,20937,11419,10409
9151092,9151080,TXFE7,128,9927,8,20945,11423,10410
9151104,9151099,TXFE7,128,9927,1,20946,11424,10411
9151179,9151169,TXFE7,128,9926,1,20947,11425,10412
9151204,9151203,TXFE7,128,9926,5,20952,11426,10413
9151242,9151232,TXFE7,128,9927,1,20953,11427,10414
9151242,9151240,TXFE7,128,9927,5,20958,11428,10415
9151279,9151269,TXFE7,128,9926,2,20960,11429,10416
9151304,9151292,TXFE7,128,9927,1,20961,11430,10417
9151317,9151311,TXFE7,128,9926,3,20964,11431,10418
9151329,9151318,TXFE7,128,9926,2,20966,11432,10419
9151329,9151324,TXFE7,128,9927,1,20967,11433,10420
9151329,9151326,TXFE7,128,9927,1,20968,11434,10421
9151379,9151372,TXFE7,128,9926,1,20969,11435,10422
9151379,9151378,TXFE7,128,9926,1,20970,11436,10423
9151392,9151387,TXFE7,128,9927,5,20975,11437,10426
9151404,9151392,TXFE7,128,9927,1,20976,11438,10427
9151417,9151412,TXFE7,128,9927,1,20977,11439,10428
9151417,9151415,TXFE7,128,9926,1,20978,11440,10429
9151442,9151434,TXFE7,128,9926,2,20980,11441,10430
9151504,9151504,TXFE7,128,9927,1,20981,11442,10431
9151529,9151522,TXFE7,128,9927,1,20982,11443,10432
9151529,9151523,TXFE7,128,9927,1,20983,11444,10433
9151554,9151545,TXFE7,128,9926,1,20984,11445,10434
9151579,9151572,TXFE7,128,9927,2,20986,11446,10435
9151579,9151578,TXFE7,128,9926,1,20987,11447,10436
9151604,9151600,TXFE7,128,9926,1,20988,11448,10437
9151642,9151631,TXFE7,128,9926,2,20990,11449,10438
9151654,9151651,TXFE7,128,9926,5,20995,11450,10439
9151692,9151687,TXFE7,128,9927,1,20996,11451,10440
9151742,9151737,TXFE7,128,9927,1,20997,11452,10441
9151754,9151746,TXFE7,128,9927,1,20998,11453,10442
9151767,9151761,TXFE7,128,9927,1,20999,11454,10443
9151767,9151761,TXFE7,128,9927,1,21000,11455,10444
9151767,9151761,TXFE7,128,9927,2,21002,11456,10445
9151767,9151761,TXFE7,128,9927,4,21006,11457,10446
9151767,9151761,TXFE7,128,9927,2,21008,11458,10447
9151767,9151761,TXFE7,128,9927,1,21009,11459,10448
9151767,9151761,TXFE7,128,9927,1,21010,11460,10449
9151767,9151761,TXFE7,128,9927,13,21023,11461,10457
9151779,9151776,TXFE7,128,9927,2,21025,11462,10458
9151817,9151806,TXFE7,128,9928,1,21026,11463,10459
9151817,9151811,TXFE7,128,9927,1,21027,11464,10460
9151842,9151832,TXFE7,128,9927,1,21028,11465,10461
9151842,9151840,TXFE7,128,9927,1,21029,11466,10462
9151854,9151848,TXFE7,128,9927,1,21030,11467,10463
9151867,9151856,TXFE7,128,9927,1,21031,11468,10464
9151879,9151868,TXFE7,128,9927,1,21032,11469,10465
9151879,9151871,TXFE7,128,9927,2,21034,11471,10466
9151892,9151886,TXFE7,128,9927,1,21035,11472,10467
9151904,9151898,TXFE7,128,9928,1,21036,11473,10468
9151904,9151900,TXFE7,128,9927,2,21038,11475,10469
9151929,9151929,TXFE7,128,9927,1,21039,11476,10470
9151954,9151950,TXFE7,128,9927,1,21040,11477,10471
9151979,9151976,TXFE7,128,9928,1,21041,11478,10472
9151992,9151987,TXFE7,128,9928,1,21042,11479,10473
9152029,9152025,TXFE7,128,9928,1,21043,11480,10474
9152042,9152035,TXFE7,128,9927,3,21046,11481,10475
9152079,9152071,TXFE7,128,9928,1,21047,11482,10476
9152092,9152083,TXFE7,128,9928,1,21048,11483,10477
9152092,9152084,TXFE7,128,9928,2,21050,11484,10478
9152154,9152149,TXFE7,128,9928,1,21051,11485,10479
9152204,9152201,TXFE7,128,9928,1,21052,11486,10480
9152229,9152224,TXFE7,128,9928,1,21053,11487,10481
9152254,9152245,TXFE7,128,9928,1,21054,11488,10482
9152267,9152261,TXFE7,128,9927,1,21055,11489,10483
9152279,9152270,TXFE7,128,9928,1,21056,11490,10484
9152292,9152281,TXFE7,128,9928,1,21057,11491,10485
9152317,9152306,TXFE7,128,9928,2,21059,11492,10487
9152317,9152312,TXFE7,128,9927,2,21061,11494,10488
9152329,9152319,TXFE7,128,9928,1,21062,11495,10489
9152329,9152320,TXFE7,128,9927,1,21063,11496,10490
9152329,9152321,TXFE7,128,9927,3,21066,11499,10491
9152342,9152330,TXFE7,128,9928,1,21067,11500,10492
9152392,9152383,TXFE7,128,9928,1,21068,11501,10493
9152392,9152390,TXFE7,128,9927,2,21070,11502,10494
9152404,9152396,TXFE7,128,9927,15,21085,11509,10495
9152417,9152409,TXFE7,128,9927,1,21086,11510,10496
9152429,9152417,TXFE7,128,9927,1,21087,11511,10497
9152442,9152439,TXFE7,128,9928,10,21097,11512,10503
9152479,9152479,TXFE7,128,9927,1,21098,11513,10504
9152479,9152479,TXFE7,128,9927,1,21099,11514,10505
9152492,9152480,TXFE7,128,9928,2,21101,11515,10506
9152529,9152525,TXFE7,128,9927,1,21102,11516,10507
9152567,9152554,TXFE7,128,9927,1,21103,11517,10508
9152567,9152555,TXFE7,128,9927,5,21108,11521,10509
9152579,9152567,TXFE7,128,9927,1,21109,11522,10510
9152579,9152567,TXFE7,128,9927,15,21124,11530,10511
9152629,9152617,TXFE7,128,9926,1,21125,11531,10512
9152629,9152626,TXFE7,128,9927,1,21126,11532,10513
9152654,9152642,TXFE7,128,9927,3,21129,11533,10516
9152692,9152685,TXFE7,128,9927,2,21131,11534,10517
9152692,9152688,TXFE7,128,9927,1,21132,11535,10518
9152754,9152748,TXFE7,128,9927,2,21134,11536,10520
9152767,9152759,TXFE7,128,9927,1,21135,11537,10521
9152829,9152819,TXFE7,128,9927,1,21136,11538,10522
9152854,9152845,TXFE7,128,9926,1,21137,11539,10523
9152879,9152869,TXFE7,128,9926,1,21138,11540,10524
9152892,9152888,TXFE7,128,9926,1,21139,11541,10525
9152904,9152902,TXFE7,128,9927,1,21140,11542,10526
9152954,9152943,TXFE7,128,9926,1,21141,11543,10527
9152979,9152976,TXFE7,128,9927,1,21142,11544,10528
9152992,9152988,TXFE7,128,9927,1,21143,11545,10529
9153042,9153033,TXFE7,128,9926,1,21144,11546,10530
9153042,9153034,TXFE7,128,9926,10,21154,11547,10531
9153054,9153042,TXFE7,128,9926,93,21247,11582,10532
9153067,9153054,TXFE7,128,9925,4,21251,11586,10533
9153067,9153054,TXFE7,128,9925,8,21259,11590,10534
9153067,9153055,TXFE7,128,9925,2,21261,11592,10535
9153067,9153055,TXFE7,128,9925,10,21271,11599,10536
9153067,9153056,TXFE7,128,9926,2,21273,11600,10537
9153079,9153067,TXFE7,128,9925,7,21280,11607,10538
9153079,9153067,TXFE7,128,9925,1,21281,11608,10539
9153079,9153067,TXFE7,128,9925,1,21282,11609,10540
9153079,9153067,TXFE7,128,9925,1,21283,11610,10541
9153079,9153067,TXFE7,128,9925,1,21284,11611,10542
9153079,9153067,TXFE7,128,9925,1,21285,11612,10543
9153079,9153067,TXFE7,128,9925,4,21289,11615,10544
9153079,9153068,TXFE7,128,9925,2,21291,11616,10545
9153079,9153068,TXFE7,128,9925,8,21299,11624,10546
9153079,9153068,TXFE7,128,9925,2,21301,11626,10547
9153079,9153070,TXFE7,128,9926,2,21303,11627,10549
9153079,9153073,TXFE7,128,9925,2,21305,11629,10550
9153092,9153079,TXFE7,128,9925,8,21313,11635,10551
9153092,9153079,TXFE7,128,9925,1,21314,11636,10552
9153092,9153079,TXFE7,128,9925,1,21315,11637,10553
9153092,9153080,TXFE7,128,9925,40,21355,11662,10554
9153092,9153089,TXFE7,128,9924,1,21356,11663,10555
9153104,9153092,TXFE7,128,9924,5,21361,11668,10556
9153104,9153094,TXFE7,128,9924,10,21371,11677,10557
9153104,9153094,TXFE7,128,9924,16,21387,11688,10558
9153104,9153095,TXFE7,128,9924,1,21388,11689,10559
9153104,9153096,TXFE7,128,9924,1,21389,11690,10560
9153104,9153098,TXFE7,128,9924,1,21390,11691,10561
9153104,9153098,TXFE7,128,9925,1,21391,11692,10562
9153104,9153099,TXFE7,128,9924,8,21399,11699,10563
9153104,9153101,TXFE7,129,9924,2,21403,11703,10564
9153104,9153101,TXFE7,129,9923,2,21403,11703,10564
9153104,9153104,TXFE7,128,9923,1,21404,11704,10565
9153117,9153104,TXFE7,128,9924,2,21406,11705,10567
9153117,9153108,TXFE7,128,9924,1,21407,11706,10568
9153117,9153108,TXFE7,128,9923,1,21408,11707,10569
9153117,9153110,TXFE7,128,9923,10,21418,11713,10570
9153117,9153115,TXFE7,128,9923,3,21421,11716,10571
9153129,9153117,TXFE7,128,9923,9,21430,11724,10572
9153129,9153117,TXFE7,128,9924,9,21439,11725,10575
9153129,9153118,TXFE7,128,9923,6,21445,11726,10576
9153129,9153123,TXFE7,128,9923,2,21447,11728,10577
9153142,9153129,TXFE7,128,9924,1,21448,11729,10578
9153142,9153130,TXFE7,128,9923,1,21449,11730,10579
9153142,9153130,TXFE7,128,9923,1,21450,11731,10580
9153142,9153130,TXFE7,128,9923,9,21459,11738,10581
9153142,9153131,TXFE7,128,9925,2,21461,11739,10582
9153142,9153134,TXFE7,128,9923,3,21464,11741,10583
9153142,9153134,TXFE7,128,9923,6,21470,11745,10584
9153142,9153135,TXFE7,128,9924,1,21471,11746,10585
9153142,9153141,TXFE7,128,9924,1,21472,11747,10586
9153154,9153142,TXFE7,128,9924,1,21473,11748,10587
9153154,9153147,TXFE7,128,9925,1,21474,11749,10588
9153154,9153153,TXFE7,128,9924,1,21475,11750,10589
9153154,9153154,TXFE7,128,9923,3,21478,11752,10590
9153167,9153156,TXFE7,128,9923,5,21483,11756,10591
9153167,9153156,TXFE7,128,9923,2,21485,11757,10592
9153179,9153167,TXFE7,128,9924,1,21486,11758,10593
9153179,9153179,TXFE7,128,9923,1,21487,11759,10594
9153192,9153181,TXFE7,128,9924,1,21488,11760,10595
9153192,9153186,TXFE7,128,9924,1,21489,11761,10596
9153204,9153194,TXFE7,128,9924,1,21490,11762,10597
9153204,9153194,TXFE7,128,9923,1,21491,11763,10598
9153242,9153236,TXFE7,128,9924,1,21492,11764,10599
9153254,9153245,TXFE7,128,9923,1,21493,11765,10600
9153267,9153259,TXFE7,128,9923,1,21494,11766,10601
9153279,9153272,TXFE7,128,9924,1,21495,11767,10602
9153292,9153287,TXFE7,128,9924,1,21496,11768,10603
9153292,9153289,TXFE7,128,9924,5,21501,11769,10606
9153292,9153289,TXFE7,128,9924,1,21502,11770,10607
9153304,9153293,TXFE7,128,9923,1,21503,11771,10608
9153304,9153295,TXFE7,128,9924,5,21508,11772,10611
9153329,9153319,TXFE7,128,9924,1,21509,11773,10612
9153342,9153330,TXFE7,128,9924,1,21510,11774,10613
9153342,9153331,TXFE7,128,9923,1,21511,11775,10614
9153354,9153352,TXFE7,128,9923,4,21515,11778,10615
9153367,9153357,TXFE7,128,9924,3,21518,11779,10616
9153367,9153360,TXFE7,128,9923,1,21519,11780,10617
9153392,9153390,TXFE7,128,9923,1,21520,11781,10618
9153404,9153392,TXFE7,128,9923,1,21521,11782,10619
9153404,9153393,TXFE7,128,9923,1,21522,11783,10620
9153417,9153412,TXFE7,128,9923,1,21523,11784,10621
9153467,9153462,TXFE7,128,9923,5,21528,11785,10622
9153467,9153466,TXFE7,128,9923,50,21578,11800,10623
9153479,9153468,TXFE7,128,9924,1,21579,11801,10624
9153492,9153480,TXFE7,128,9923,7,21586,11802,10625
9153492,9153490,TXFE7,128,9924,1,21587,11803,10626
9153517,9153508,TXFE7,128,9924,1,21588,11804,10627
9153529,9153528,TXFE7,128,9923,1,21589,11805,10628
9153542,9153532,TXFE7,128,9924,2,21591,11806,10630
9153542,9153535,TXFE7,128,9924,1,21592,11807,10631
9153542,9153539,TXFE7,128,9924,1,21593,11808,10632
9153579,9153569,TXFE7,128,9924,1,21594,11809,10633
9153579,9153579,TXFE7,128,9923,14,21608,11816,10634
9153592,9153582,TXFE7,128,9923,1,21609,11817,10635
9153629,9153619,TXFE7,128,9924,3,21612,11818,10638
9153629,9153622,TXFE7,128,9923,7,21619,11823,10639
9153629,9153625,TXFE7,128,9924,1,21620,11824,10640
9153642,9153632,TXFE7,128,9922,1,21621,11825,10641
9153654,9153644,TXFE7,128,9922,1,21622,11826,10642
9153654,9153645,TXFE7,128,9922,1,21623,11827,10643
9153654,9153646,TXFE7,128,9922,1,21624,11828,10644
9153654,9153646,TXFE7,128,9922,1,21625,11829,10645
9153654,9153647,TXFE7,128,9922,6,21631,11834,10646
9153654,9153647,TXFE7,128,9922,9,21640,11840,10647
9153654,9153647,TXFE7,128,9922,1,21641,11841,10648
9153654,9153648,TXFE7,128,9922,1,21642,11842,10649
9153654,9153648,TXFE7,128,9922,2,21644,11844,10650
9153654,9153649,TXFE7,128,9922,1,21645,11845,10651
9153654,9153650,TXFE7,128,9922,6,21651,11850,10652
9153654,9153653,TXFE7,128,9922,10,21661,11856,10653
9153654,9153654,TXFE7,129,9922,24,21697,11876,10654
9153654,9153654,TXFE7,129,9921,12,21697,11876,10654
9153667,9153659,TXFE7,128,9922,2,21699,11877,10655
9153667,9153660,TXFE7,128,9922,1,21700,11878,10656
9153667,9153661,TXFE7,128,9921,1,21701,11879,10657
9153667,9153663,TXFE7,128,9921,3,21704,11880,10658
9153667,9153663,TXFE7,128,9921,2,21706,11881,10659
9153667,9153664,TXFE7,128,9921,1,21707,11882,10660
9153679,9153667,TXFE7,128,9922,1,21708,11883,10661
9153679,9153667,TXFE7,128,9921,1,21709,11884,10662
9153679,9153668,TXFE7,128,9921,4,21713,11885,10663
9153679,9153669,TXFE7,128,9922,1,21714,11886,10664
9153679,9153670,TXFE7,128,9921,1,21715,11887,10665
9153679,9153670,TXFE7,128,9921,2,21717,11888,10666
9153679,9153671,TXFE7,128,9921,2,21719,11889,10667
9153679,9153672,TXFE7,128,9921,1,21720,11890,10668
9153679,9153673,TXFE7,128,9921,4,21724,11891,10669
9153679,9153673,TXFE7,128,9921,10,21734,11894,10670
9153679,9153673,TXFE7,128,9921,2,21736,11895,10671
9153679,9153673,TXFE7,128,9921,1,21737,11896,10672
9153679,9153674,TXFE7,128,9921,7,21744,11899,10673
9153679,9153675,TXFE7,128,9921,7,21751,11906,10674
9153679,9153676,TXFE7,128,9921,1,21752,11907,10675
9153679,9153677,TXFE7,128,9921,5,21757,11912,10676
9153679,9153678,TXFE7,128,9922,3,21760,11913,10677
9153679,9153679,TXFE7,128,9921,30,21790,11928,10678
9153679,9153679,TXFE7,128,9922,1,21791,11929,10679
9153679,9153679,TXFE7,128,9921,3,21794,11931,10680
9153692,9153679,TXFE7,128,9921,5,21799,11936,10681
9153692,9153680,TXFE7,128,9921,2,21801,11938,10682
9153692,9153685,TXFE7,128,9922,2,21803,11939,10683
9153692,9153685,TXFE7,128,9921,1,21804,11940,10684
9153692,9153690,TXFE7,128,9922,1,21805,11941,10685
9153692,9153690,TXFE7,128,9921,1,21806,11942,10686
9153692,9153692,TXFE7,128,9921,7,21813,11947,10687
9153704,9153694,TXFE7,129,9921,1,21816,11950,10688
9153704,9153694,TXFE7,129,9920,2,21816,11950,10688
9153704,9153695,TXFE7,128,9920,1,21817,11951,10689
9153704,9153695,TXFE7,128,9920,1,21818,11952,10690
9153704,9153695,TXFE7,128,9920,1,21819,11953,10691
9153704,9153696,TXFE7,128,9920,1,21820,11954,10692
9153704,9153697,TXFE7,128,9920,5,21825,11957,10693
9153704,9153699,TXFE7,128,9920,1,21826,11958,10694
9153704,9153701,TXFE7,128,9920,1,21827,11959,10695
9153704,9153703,TXFE7,128,9920,4,21831,11963,10696
9153704,9153703,TXFE7,128,9920,78,21909,12005,10697
9153704,9153704,TXFE7,128,9920,1,21910,12006,10698
9153717,9153704,TXFE7,128,9920,3,21913,12007,10699
9153717,9153704,TXFE7,128,9920,1,21914,12008,10700
9153717,9153705,TXFE7,128,9920,22,21936,12021,10701
9153717,9153705,TXFE7,129,9920,4,21941,12026,10702
9153717,9153705,TXFE7,129,9919,1,21941,12026,10702
9153717,9153709,TXFE7,128,9919,1,21942,12027,10703
9153717,9153710,TXFE7,128,9919,2,21944,12028,10704
9153717,9153711,TXFE7,128,9919,1,21945,12029,10705
9153717,9153713,TXFE7,128,9919,1,21946,12030,10706
9153729,9153717,TXFE7,128,9920,1,21947,12031,10707
9153729,9153718,TXFE7,128,9919,6,21953,12034,10708
9153729,9153719,TXFE7,128,9919,4,21957,12037,10709
9153729,9153720,TXFE7,128,9920,1,21958,12038,10710
9153729,9153722,TXFE7,128,9919,1,21959,12039,10711
9153729,9153723,TXFE7,128,9919,1,21960,12040,10712
9153729,9153724,TXFE7,128,9919,1,21961,12041,10713
9153729,9153728,TXFE7,128,9920,6,21967,12042,10714
9153742,9153730,TXFE7,128,9919,3,21970,12045,10715
9153742,9153730,TXFE7,128,9920,3,21973,12046,10718
9153742,9153731,TXFE7,128,9920,2,21975,12047,10719
9153742,9153732,TXFE7,128,9919,1,21976,12048,10720
9153742,9153736,TXFE7,128,9919,1,21977,12049,10721
9153742,9153738,TXFE7,128,9921,1,21978,12050,10722
9153742,9153740,TXFE7,128,9920,3,21981,12051,10723
9153742,9153740,TXFE7,128,9920,1,21982,12052,10724
9153742,9153741,TXFE7,128,9919,3,21985,12053,10725
9153754,9153743,TXFE7,128,9920,4,21989,12055,10726
9153754,9153743,TXFE7,128,9920,1,21990,12056,10727
9153754,9153746,TXFE7,129,9920,1,22005,12065,10728
9153754,9153746,TXFE7,129,9919,14,22005,12065,10728
9153754,9153746,TXFE7,129,9920,1,22010,12067,10729
9153754,9153746,TXFE7,129,9919,4,22010,12067,10729
9153754,9153751,TXFE7,128,9920,8,22018,12068,10730
9153754,9153752,TXFE7,128,9920,1,22019,12069,10731
9153754,9153752,TXFE7,129,9920,2,22024,12071,10732
9153754,9153752,TXFE7,129,9919,3,22024,12071,10732
9153754,9153754,TXFE7,128,9919,1,22025,12072,10733
9153767,9153755,TXFE7,128,9921,1,22026,12073,10734
9153767,9153755,TXFE7,128,9920,1,22027,12074,10735
9153767,9153755,TXFE7,128,9920,1,22028,12075,10736
9153767,9153757,TXFE7,128,9920,3,22031,12077,10737
9153767,9153759,TXFE7,128,9919,1,22032,12078,10738
9153767,9153760,TXFE7,128,9919,1,22033,12079,10739
9153767,9153760,TXFE7,128,9920,1,22034,12080,10740
9153767,9153763,TXFE7,128,9919,3,22037,12082,10741
9153779,9153767,TXFE7,128,9920,8,22045,12083,10742
9153779,9153767,TXFE7,128,9920,3,22048,12084,10743
9153779,9153767,TXFE7,128,9920,1,22049,12085,10744
9153779,9153768,TXFE7,128,9919,2,22051,12087,10745
9153779,9153769,TXFE7,128,9920,3,22054,12088,10748
9153779,9153771,TXFE7,128,9921,1,22055,12089,10749
9153779,9153772,TXFE7,128,9920,1,22056,12090,10750
9153779,9153778,TXFE7,128,9921,1,22057,12091,10751
9153779,9153779,TXFE7,128,9921,1,22058,12092,10752
9153792,9153780,TXFE7,128,9920,1,22059,12093,10753
9153792,9153784,TXFE7,128,9921,1,22060,12094,10754
9153792,9153784,TXFE7,128,9921,1,22061,12095,10755
9153804,9153792,TXFE7,128,9921,2,22063,12096,10756
9153804,9153792,TXFE7,128,9921,2,22065,12097,10757
9153804,9153792,TXFE7,128,9921,4,22069,12098,10759
9153804,9153792,TXFE7,128,9921,2,22071,12099,10760
9153804,9153792,TXFE7,128,9920,1,22072,12100,10761
9153804,9153794,TXFE7,128,9920,2,22074,12101,10762
9153804,9153796,TXFE7,128,9920,14,22088,12107,10763
9153804,9153797,TXFE7,128,9921,2,22090,12108,10764
9153804,9153799,TXFE7,128,9920,1,22091,12109,10765
9153804,9153800,TXFE7,128,9920,2,22093,12110,10766
9153804,9153801,TXFE7,128,9920,14,22107,12116,10767
9153817,9153804,TXFE7,128,9921,2,22109,12117,10769
9153817,9153804,TXFE7,128,9921,1,22110,12118,10770
9153817,9153805,TXFE7,129,9920,5,22118,12123,10771
9153817,9153805,TXFE7,129,9919,3,22118,12123,10771
9153817,9153808,TXFE7,128,9919,1,22119,12124,10772
9153817,9153808,TXFE7,128,9919,1,22120,12125,10773
9153817,9153809,TXFE7,128,9919,1,22121,12126,10774
9153817,9153810,TXFE7,128,9919,8,22129,12128,10775
9153817,9153813,TXFE7,128,9919,1,22130,12129,10776
9153829,9153821,TXFE7,128,9919,4,22134,12130,10777
9153829,9153821,TXFE7,128,9919,6,22140,12135,10778
9153829,9153822,TXFE7,128,9919,4,22144,12139,10779
9153829,9153822,TXFE7,128,9919,3,22147,12142,10780
9153829,9153822,TXFE7,128,9919,6,22153,12145,10781
9153829,9153823,TXFE7,128,9919,2,22155,12146,10782
9153829,9153824,TXFE7,128,9920,1,22156,12147,10783
9153829,9153824,TXFE7,129,9919,1,22158,12149,10784
9153829,9153824,TXFE7,129,9918,1,22158,12149,10784
9153829,9153826,TXFE7,129,9919,1,22163,12151,10785
9153829,9153826,TXFE7,129,9918,4,22163,12151,10785
9153829,9153827,TXFE7,128,9918,1,22164,12152,10786
9153829,9153828,TXFE7,128,9920,1,22165,12153,10787
9153842,9153830,TXFE7,128,9919,1,22166,12154,10788
9153842,9153836,TXFE7,128,9920,1,22167,12155,10789
9153842,9153836,TXFE7,128,9920,1,22168,12156,10790
9153842,9153839,TXFE7,128,9920,1,22169,12157,10791
9153842,9153841,TXFE7,128,9919,2,22171,12158,10792
9153854,9153842,TXFE7,128,9920,2,22173,12159,10794
9153854,9153844,TXFE7,128,9919,1,22174,12160,10795
9153854,9153848,TXFE7,128,9920,1,22175,12161,10796
9153854,9153853,TXFE7,128,9920,1,22176,12162,10797
9153867,9153858,TXFE7,128,9920,4,22180,12165,10798
9153867,9153860,TXFE7,128,9920,1,22181,12166,10799
9153867,9153860,TXFE7,128,9921,1,22182,12167,10800
9153879,9153868,TXFE7,128,9920,1,22183,12168,10801
9153879,9153872,TXFE7,128,9920,1,22184,12169,10802
9153879,9153873,TXFE7,128,9920,2,22186,12170,10803
9153879,9153875,TXFE7,128,9920,1,22187,12171,10804
9153879,9153876,TXFE7,128,9921,1,22188,12172,10805
9153879,9153876,TXFE7,128,9920,6,22194,12175,10806
9153892,9153880,TXFE7,128,9921,3,22197,12176,10807
9153892,9153885,TXFE7,128,9921,1,22198,12177,10808
9153892,9153887,TXFE7,128,9921,1,22199,12178,10809
9153892,9153891,TXFE7,128,9920,4,22203,12181,10810
9153892,9153891,TXFE7,128,9920,2,22205,12182,10811
9153904,9153893,TXFE7,128,9920,1,22206,12183,10812
9153904,9153896,TXFE7,128,9920,1,22207,12184,10813
9153904,9153898,TXFE7,128,9920,1,22208,12185,10814
9153904,9153898,TXFE7,128,9920,1,22209,12186,10815
9153904,9153904,TXFE7,128,9921,1,22210,12187,10816
9153904,9153904,TXFE7,128,9920,1,22211,12188,10817
9153917,9153907,TXFE7,128,9921,1,22212,12189,10818
9153917,9153908,TXFE7,128,9920,1,22213,12190,10819
9153929,9153922,TXFE7,128,9921,1,22214,12191,10820
9153929,9153923,TXFE7,128,9921,5,22219,12192,10823
9153929,9153924,TXFE7,128,9920,1,22220,12193,10824
9153929,9153925,TXFE7,128,9921,5,22225,12194,10827
9153929,9153927,TXFE7,128,9921,2,22227,12195,10828
9153942,9153930,TXFE7,128,9921,4,22231,12196,10832
9153942,9153932,TXFE7,128,9921,1,22232,12197,10833
9153942,9153940,TXFE7,128,9921,2,22234,12198,10834
9153954,9153944,TXFE7,128,9922,10,22244,12199,10838
9153954,9153946,TXFE7,128,9921,4,22248,12201,10839
9153967,9153959,TXFE7,128,9921,3,22251,12202,10840
9153967,9153964,TXFE7,128,9921,2,22253,12203,10841
9153967,9153964,TXFE7,128,9922,3,22256,12204,10843
9153979,9153968,TXFE7,128,9922,2,22258,12205,10844
9153979,9153972,TXFE7,128,9922,5,22263,12206,10849
9153979,9153978,TXFE7,128,9921,1,22264,12207,10850
9153992,9153979,TXFE7,128,9922,1,22265,12208,10851
9153992,9153985,TXFE7,128,9923,5,22270,12209,10854
9153992,9153990,TXFE7,128,9923,3,22273,12210,10856
9154004,9153992,TXFE7,128,9923,2,22275,12211,10857
9154004,9153992,TXFE7,128,9923,1,22276,12212,10858
9154017,9154007,TXFE7,128,9923,26,22302,12213,10871
9154017,9154012,TXFE7,128,9923,2,22304,12214,10872
9154029,9154017,TXFE7,128,9923,2,22306,12215,10873
9154029,9154018,TXFE7,128,9923,1,22307,12216,10874
9154029,9154025,TXFE7,128,9924,9,22316,12217,10877
9154029,9154027,TXFE7,128,9924,1,22317,12218,10878
9154042,9154031,TXFE7,128,9923,1,22318,12219,10879
9154042,9154032,TXFE7,128,9923,1,22319,12220,10880
9154042,9154033,TXFE7,128,9924,4,22323,12221,10881
9154042,9154037,TXFE7,128,9923,1,22324,12222,10882
9154042,9154037,TXFE7,128,9923,2,22326,12223,10883
9154054,9154043,TXFE7,128,9923,3,22329,12226,10884
9154054,9154052,TXFE7,128,9923,1,22330,12227,10885
9154054,9154053,TXFE7,128,9923,1,22331,12228,10886
9154079,9154072,TXFE7,128,9924,1,22332,12229,10887
9154079,9154075,TXFE7,128,9923,1,22333,12230,10888
9154079,9154077,TXFE7,128,9923,1,22334,12231,10889
9154092,9154090,TXFE7,128,9924,1,22335,12232,10890
9154092,9154090,TXFE7,128,9924,5,22340,12233,10892
9154104,9154094,TXFE7,128,9924,1,22341,12234,10893
9154104,9154095,TXFE7,128,9924,2,22343,12235,10895
9154104,9154096,TXFE7,128,9924,5,22348,12236,10898
9154117,9154108,TXFE7,128,9923,2,22350,12237,10899
9154129,9154118,TXFE7,128,9924,4,22354,12238,10901
9154142,9154129,TXFE7,128,9924,1,22355,12239,10902
9154142,9154133,TXFE7,129,9924,5,22365,12243,10903
9154142,9154133,TXFE7,129,9923,5,22365,12243,10903
9154142,9154133,TXFE7,128,9924,2,22367,12244,10904
9154142,9154140,TXFE7,128,9925,2,22369,12245,10906
9154154,9154143,TXFE7,128,9925,1,22370,12246,10907
9154154,9154148,TXFE7,128,9925,10,22380,12247,10914
9154154,9154148,TXFE7,128,9924,1,22381,12248,10915
9154154,9154152,TXFE7,128,9925,10,22391,12249,10919
9154167,9154154,TXFE7,128,9925,2,22393,12250,10921
9154167,9154154,TXFE7,128,9925,2,22395,12251,10922
9154167,9154157,TXFE7,128,9925,3,22398,12252,10923
9154167,9154160,TXFE7,129,9925,7,22433,12262,10924
9154167,9154160,TXFE7,129,9924,28,22433,12262,10924
9154167,9154160,TXFE7,128,9925,1,22434,12263,10925
9154167,9154162,TXFE7,128,9926,1,22435,12264,10926
9154179,9154168,TXFE7,128,9925,1,22436,12265,10927
9154179,9154174,TXFE7,128,9925,2,22438,12266,10928
9154179,9154174,TXFE7,128,9924,1,22439,12267,10929
9154192,9154181,TXFE7,128,9925,1,22440,12268,10930
9154192,9154185,TXFE7,128,9924,1,22441,12269,10931
9154204,9154200,TXFE7,128,9925,1,22442,12270,10932
9154229,9154222,TXFE7,128,9925,2,22444,12271,10933
9154229,9154228,TXFE7,128,9924,2,22446,12272,10934
9154254,9154251,TXFE7,128,9925,1,22447,12273,10935
9154254,9154253,TXFE7,128,9925,1,22448,12274,10936
9154267,9154262,TXFE7,128,9924,2,22450,12275,10937
9154267,9154265,TXFE7,128,9924,1,22451,12276,10938
9154292,9154281,TXFE7,128,9925,3,22454,12277,10940
9154292,9154288,TXFE7,128,9924,1,22455,12278,10941
9154304,9154295,TXFE7,128,9925,1,22456,12279,10942
9154304,9154296,TXFE7,128,9924,1,22457,12280,10943
9154304,9154298,TXFE7,128,9925,1,22458,12281,10944
9154317,9154308,TXFE7,128,9925,1,22459,12282,10945
9154329,9154328,TXFE7,128,9924,1,22460,12283,10946
9154392,9154380,TXFE7,128,9925,1,22461,12284,10947
9154417,9154408,TXFE7,128,9924,1,22462,12285,10948
9154417,9154412,TXFE7,128,9925,1,22463,12286,10949
9154429,9154429,TXFE7,128,9924,1,22464,12287,10950
9154442,9154436,TXFE7,128,9924,1,22465,12288,10951
9154442,9154440,TXFE7,128,9925,5,22470,12289,10954
9154467,9154455,TXFE7,128,9924,1,22471,12290,10955
9154467,9154466,TXFE7,128,9924,2,22473,12291,10956
9154479,9154470,TXFE7,128,9925,1,22474,12292,10957
9154479,9154472,TXFE7,128,9925,2,22476,12293,10959
9154479,9154474,TXFE7,128,9925,1,22477,12294,10960
9154479,9154475,TXFE7,128,9925,5,22482,12295,10963
9154517,9154510,TXFE7,128,9924,3,22485,12297,10964
9154517,9154510,TXFE7,128,9925,1,22486,12298,10965
9154529,9154520,TXFE7,128,9925,1,22487,12299,10966
9154542,9154530,TXFE7,128,9925,1,22488,12300,10967
9154542,9154533,TXFE7,128,9924,1,22489,12301,10968
9154554,9154546,TXFE7,128,9925,1,22490,12302,10969
9154554,9154549,TXFE7,128,9924,1,22491,12303,10970
9154554,9154553,TXFE7,128,9925,5,22496,12304,10973
9154579,9154571,TXFE7,128,9925,1,22497,12305,10974
9154579,9154574,TXFE7,128,9925,1,22498,12306,10975
9154592,9154581,TXFE7,128,9925,1,22499,12307,10976
9154604,9154592,TXFE7,128,9925,1,22500,12308,10977
9154617,9154608,TXFE7,128,9925,1,22501,12309,10978
9154617,9154612,TXFE7,129,9925,1,22503,12310,10980
9154617,9154612,TXFE7,129,9926,1,22503,12310,10980
9154704,9154692,TXFE7,128,9925,1,22504,12311,10981
9154742,9154735,TXFE7,128,9925,8,22512,12314,10982
9154742,9154741,TXFE7,128,9926,1,22513,12315,10983
9154754,9154749,TXFE7,128,9925,1,22514,12316,10984
9154754,9154753,TXFE7,128,9925,1,22515,12317,10985
9154792,9154791,TXFE7,128,9926,1,22516,12318,10986
9154804,9154795,TXFE7,128,9926,1,22517,12319,10987
9154829,9154820,TXFE7,128,9926,1,22518,12320,10988
9154829,9154820,TXFE7,128,9925,1,22519,12321,10989
9154829,9154823,TXFE7,128,9925,1,22520,12322,10990
9154842,9154832,TXFE7,128,9925,2,22522,12324,10991
9154842,9154842,TXFE7,128,9926,1,22523,12325,10992
9154854,9154844,TXFE7,128,9925,1,22524,12326,10993
9154854,9154851,TXFE7,128,9926,2,22526,12327,10995
9154867,9154860,TXFE7,128,9926,1,22527,12328,10996
9154867,9154862,TXFE7,128,9926,1,22528,12329,10997
9154879,9154873,TXFE7,128,9926,10,22538,12330,11000
9154879,9154873,TXFE7,128,9925,1,22539,12331,11001
9154892,9154880,TXFE7,128,9926,1,22540,12332,11002
9154892,9154886,TXFE7,128,9926,2,22542,12333,11003
9154892,9154888,TXFE7,128,9926,1,22543,12334,11004
9154904,9154899,TXFE7,128,9926,3,22546,12335,11005
9154904,9154902,TXFE7,128,9926,2,22548,12336,11006
9154917,9154914,TXFE7,128,9926,1,22549,12337,11007
9154942,9154931,TXFE7,128,9925,1,22550,12338,11008
9154942,9154940,TXFE7,128,9926,1,22551,12339,11009
9154954,9154950,TXFE7,128,9926,1,22552,12340,11010
9154954,9154951,TXFE7,128,9925,4,22556,12342,11011
9154979,9154975,TXFE7,128,9926,3,22559,12343,11014
9155004,9154994,TXFE7,128,9925,1,22560,12344,11015
9155017,9155015,TXFE7,128,9926,1,22561,12345,11016
9155042,9155029,TXFE7,128,9925,1,22562,12346,11017
9155092,9155087,TXFE7,128,9925,3,22565,12349,11018
9155117,9155110,TXFE7,128,9926,1,22566,12350,11019
9155129,9155126,TXFE7,128,9926,1,22567,12351,11020
9155142,9155133,TXFE7,128,9926,1,22568,12352,11021
9155142,9155137,TXFE7,128,9926,1,22569,12353,11022
9155179,9155170,TXFE7,128,9926,1,22570,12354,11023
9155192,9155184,TXFE7,128,9926,5,22575,12355,11025
9155217,9155212,TXFE7,128,9925,4,22579,12358,11026
9155217,9155212,TXFE7,128,9926,3,22582,12359,11027
9155229,9155221,TXFE7,128,9925,1,22583,12360,11028
9155229,9155229,TXFE7,128,9926,10,22593,12361,11034
9155242,9155233,TXFE7,128,9926,1,22594,12362,11035
9155304,9155293,TXFE7,128,9926,1,22595,12363,11036
9155304,9155301,TXFE7,128,9926,1,22596,12364,11037
9155317,9155314,TXFE7,128,9926,1,22597,12365,11038
9155342,9155339,TXFE7,128,9926,1,22598,12366,11039
9155404,9155392,TXFE7,128,9926,5,22603,12367,11040
9155404,9155403,TXFE7,128,9925,1,22604,12368,11041
9155417,9155409,TXFE7,128,9925,1,22605,12369,11042
9155417,9155409,TXFE7,128,9926,1,22606,12370,11043
9155417,9155416,TXFE7,128,9926,1,22607,12371,11044
9155467,9155460,TXFE7,128,9925,3,22610,12373,11045
9155504,9155498,TXFE7,128,9926,1,22611,12374,11046
9155554,9155546,TXFE7,128,9926,5,22616,12375,11048
9155579,9155579,TXFE7,128,9926,2,22618,12376,11050
9155617,9155605,TXFE7,128,9925,1,22619,12377,11051
9155642,9155632,TXFE7,128,9926,1,22620,12378,11052
9155667,9155661,TXFE7,128,9925,1,22621,12379,11053
9155692,9155682,TXFE7,128,9926,1,22622,12380,11054
9155692,9155686,TXFE7,128,9926,3,22625,12381,11055
9155692,9155690,TXFE7,128,9926,1,22626,12382,11056
9155754,9155751,TXFE7,128,9925,1,22627,12383,11057
9155792,9155782,TXFE7,128,9925,1,22628,12384,11058
9155792,9155785,TXFE7,128,9925,20,22648,12402,11059
9155804,9155792,TXFE7,128,9925,4,22652,12405,11060
9155804,9155793,TXFE7,128,9925,2,22654,12407,11061
9155804,9155796,TXFE7,128,9925,1,22655,12408,11062
9155804,9155796,TXFE7,128,9925,2,22657,12410,11063
9155817,9155804,TXFE7,128,9925,4,22661,12414,11064
9155817,9155805,TXFE7,128,9925,1,22662,12415,11065
9155854,9155848,TXFE7,129,9925,1,22664,12417,11066
9155854,9155848,TXFE7,129,9924,1,22664,12417,11066
9155854,9155852,TXFE7,128,9924,2,22666,12418,11067
9155892,9155887,TXFE7,128,9925,4,22670,12419,11071
9155892,9155888,TXFE7,128,9925,1,22671,12420,11072
9155929,9155928,TXFE7,128,9924,5,22676,12424,11073
9155942,9155934,TXFE7,128,9925,1,22677,12425,11074
9155942,9155940,TXFE7,128,9925,1,22678,12426,11075
9155954,9155951,TXFE7,128,9925,1,22679,12427,11076
9155979,9155977,TXFE7,128,9925,1,22680,12428,11077
9155979,9155979,TXFE7,128,9925,1,22681,12429,11078
9160004,9155992,TXFE7,128,9925,1,22682,12430,11079
9160004,9160000,TXFE7,128,9925,1,22683,12431,11080
9160004,9160001,TXFE7,128,9925,1,22684,12432,11081
9160017,9160006,TXFE7,128,9925,2,22686,12433,11083
9160017,9160006,TXFE7,128,9925,15,22701,12434,11089
9160017,9160015,TXFE7,128,9925,2,22703,12435,11090
9160029,9160025,TXFE7,129,9925,2,22707,12439,11091
9160029,9160025,TXFE7,129,9924,2,22707,12439,11091
9160042,9160038,TXFE7,128,9925,1,22708,12440,11092
9160067,9160058,TXFE7,128,9925,3,22711,12442,11093
9160067,9160064,TXFE7,128,9925,1,22712,12443,11094
9160079,9160079,TXFE7,128,9925,1,22713,12444,11095
9160092,9160087,TXFE7,128,9925,1,22714,12445,11096
9160104,9160092,TXFE7,128,9925,1,22715,12446,11097
9160142,9160132,TXFE7,128,9925,1,22716,12447,11098
9160167,9160165,TXFE7,128,9924,1,22717,12448,11099
9160192,9160183,TXFE7,128,9924,6,22723,12450,11100
9160192,9160186,TXFE7,128,9925,1,22724,12451,11101
9160204,9160194,TXFE7,128,9924,2,22726,12452,11102
9160279,9160276,TXFE7,128,9924,1,22727,12453,11103
9160304,9160293,TXFE7,128,9925,2,22729,12454,11104
9160342,9160341,TXFE7,128,9924,2,22731,12456,11105
9160429,9160427,TXFE7,128,9925,1,22732,12457,11106
9160467,9160455,TXFE7,128,9925,15,22747,12458,11118
9160479,9160467,TXFE7,128,9925,1,22748,12459,11119
9160479,9160467,TXFE7,128,9925,1,22749,12460,11120
9160492,9160483,TXFE7,128,9925,1,22750,12461,11121
9160492,9160491,TXFE7,128,9925,1,22751,12462,11122
9160504,9160494,TXFE7,128,9925,15,22766,12472,11123
9160504,9160502,TXFE7,128,9925,4,22770,12473,11124
9160517,9160509,TXFE7,128,9924,1,22771,12474,11125
9160604,9160600,TXFE7,128,9924,1,22772,12475,11126
9160617,9160612,TXFE7,128,9925,3,22775,12476,11127
9160667,9160660,TXFE7,128,9925,1,22776,12477,11128
9160704,9160695,TXFE7,128,9924,1,22777,12478,11129
9160704,9160696,TXFE7,128,9925,1,22778,12479,11130
9160717,9160715,TXFE7,128,9924,1,22779,12480,11131
9160754,9160751,TXFE7,128,9925,1,22780,12481,11132
9160767,9160758,TXFE7,128,9925,1,22781,12482,11133
9160792,9160782,TXFE7,128,9925,1,22782,12483,11134
9160829,9160820,TXFE7,128,9925,1,22783,12484,11135
9160829,9160820,TXFE7,128,9924,1,22784,12485,11136
9160904,9160896,TXFE7,128,9925,1,22785,12486,11137
9160929,9160922,TXFE7,128,9925,16,22801,12487,11145
9160929,9160923,TXFE7,128,9925,3,22804,12488,11147
9160992,9160982,TXFE7,128,9925,1,22805,12489,11148
9160992,9160983,TXFE7,128,9926,1,22806,12490,11149
9161004,9160992,TXFE7,128,9926,49,22855,12491,11169
9161017,9161004,TXFE7,128,9926,4,22859,12492,11171
9161017,9161004,TXFE7,128,9926,3,22862,12493,11174
9161029,9161022,TXFE7,128,9926,4,22866,12494,11175
9161042,9161031,TXFE7,128,9926,1,22867,12495,11176
9161042,9161035,TXFE7,128,9926,3,22870,12497,11177
9161054,9161042,TXFE7,128,9926,1,22871,12498,11178
9161054,9161047,TXFE7,128,9927,1,22872,12499,11179
9161067,9161066,TXFE7,128,9927,2,22874,12500,11181
9161079,9161071,TXFE7,128,9927,1,22875,12501,11182
9161079,9161079,TXFE7,128,9927,2,22877,12502,11183
9161092,9161080,TXFE7,128,9926,2,22879,12503,11184
9161092,9161083,TXFE7,128,9927,1,22880,12504,11185
9161092,9161090,TXFE7,128,9926,1,22881,12505,11186
9161104,9161098,TXFE7,128,9927,5,22886,12506,11187
9161117,9161112,TXFE7,128,9926,5,22891,12510,11188
9161142,9161130,TXFE7,128,9926,1,22892,12511,11189
9161217,9161208,TXFE7,128,9927,1,22893,12512,11190
9161254,9161242,TXFE7,128,9926,1,22894,12513,11191
9161254,9161244,TXFE7,128,9926,2,22896,12514,11192
9161254,9161253,TXFE7,128,9927,12,22908,12515,11193
9161267,9161261,TXFE7,128,9926,2,22910,12517,11194
9161292,9161285,TXFE7,128,9926,2,22912,12518,11195
9161304,9161293,TXFE7,128,9927,1,22913,12519,11196
9161317,9161311,TXFE7,128,9927,1,22914,12520,11197
9161329,9161328,TXFE7,128,9927,1,22915,12521,11198
9161342,9161336,TXFE7,128,9927,1,22916,12522,11199
9161379,9161370,TXFE7,128,9927,1,22917,12523,11200
9161379,9161374,TXFE7,128,9927,1,22918,12524,11201
9161404,9161398,TXFE7,128,9927,1,22919,12525,11202
9161467,9161463,TXFE7,128,9927,9,22928,12526,11203
9161492,9161480,TXFE7,128,9927,38,22966,12527,11222
9161504,9161494,TXFE7,128,9928,2,22968,12528,11223
9161504,9161495,TXFE7,128,9928,1,22969,12529,11224
9161517,9161513,TXFE7,128,9928,2,22971,12530,11226
9161529,9161518,TXFE7,128,9928,1,22972,12531,11227
9161542,9161530,TXFE7,128,9927,5,22977,12534,11228
9161554,9161542,TXFE7,128,9928,1,22978,12535,11229
9161567,9161555,TXFE7,128,9927,2,22980,12536,11230
9161567,9161557,TXFE7,128,9928,18,22998,12537,11246
9161567,9161563,TXFE7,128,9928,12,23010,12538,11252
9161579,9161567,TXFE7,128,9928,6,23016,12539,11258
9161579,9161567,TXFE7,128,9928,2,23018,12540,11260
9161579,9161567,TXFE7,128,9928,2,23020,12541,11262
9161579,9161576,TXFE7,128,9929,1,23021,12542,11263
9161592,9161590,TXFE7,128,9929,4,23025,12543,11265
9161604,9161593,TXFE7,128,9928,1,23026,12544,11266
9161629,9161618,TXFE7,128,9928,1,23027,12545,11267
9161629,9161623,TXFE7,128,9929,3,23030,12546,11269
9161654,9161653,TXFE7,128,9929,1,23031,12547,11270
9161667,9161657,TXFE7,128,9928,1,23032,12548,11271
9161667,9161661,TXFE7,128,9929,1,23033,12549,11272
9161667,9161662,TXFE7,128,9929,1,23034,12550,11273
9161679,9161668,TXFE7,128,9929,2,23036,12551,11274
9161679,9161668,TXFE7,128,9929,2,23038,12552,11275
9161679,9161677,TXFE7,128,9929,1,23039,12553,11276
9161692,9161689,TXFE7,128,9929,1,23040,12554,11277
9161704,9161701,TXFE7,128,9928,1,23041,12555,11278
9161717,9161712,TXFE7,128,9929,1,23042,12556,11279
9161742,9161735,TXFE7,128,9929,3,23045,12557,11281
9161742,9161738,TXFE7,128,9928,1,23046,12558,11282
9161754,9161743,TXFE7,128,9928,1,23047,12559,11283
9161754,9161748,TXFE7,128,9929,1,23048,12560,11284
9161754,9161752,TXFE7,128,9928,4,23052,12561,11285
9161754,9161752,TXFE7,128,9928,5,23057,12563,11286
9161754,9161752,TXFE7,128,9928,2,23059,12565,11287
9161767,9161755,TXFE7,128,9927,15,23074,12569,11288
9161779,9161768,TXFE7,128,9927,10,23084,12576,11289
9161792,9161779,TXFE7,128,9927,1,23085,12577,11290
9161792,9161779,TXFE7,128,9927,3,23088,12579,11291
9161792,9161779,TXFE7,128,9927,1,23089,12580,11292
9161792,9161779,TXFE7,128,9927,2,23091,12581,11293
9161792,9161779,TXFE7,128,9927,3,23094,12582,11294
9161792,9161779,TXFE7,128,9927,1,23095,12583,11295
9161792,9161781,TXFE7,128,9927,1,23096,12584,11296
9161804,9161804,TXFE7,128,9927,1,23097,12585,11297
9161817,9161807,TXFE7,128,9927,1,23098,12586,11298
9161817,9161808,TXFE7,128,9927,1,23099,12587,11299
9161829,9161820,TXFE7,128,9927,1,23100,12588,11300
9161829,9161821,TXFE7,128,9927,1,23101,12589,11301
9161867,9161864,TXFE7,128,9927,1,23102,12590,11302
9161992,9161984,TXFE7,128,9926,1,23103,12591,11303
9161992,9161990,TXFE7,128,9926,3,23106,12593,11305
9162004,9161998,TXFE7,128,9927,1,23107,12594,11306
9162029,9162022,TXFE7,128,9927,2,23109,12595,11308
9162042,9162041,TXFE7,128,9926,2,23111,12597,11309
9162042,9162041,TXFE7,128,9926,2,23113,12598,11310
9162117,9162112,TXFE7,128,9927,1,23114,12599,11311
9162129,9162123,TXFE7,128,9927,1,23115,12600,11312
9162142,9162133,TXFE7,128,9928,1,23116,12601,11313
9162154,9162144,TXFE7,129,9927,1,23121,12603,11314
9162154,9162144,TXFE7,129,9926,4,23121,12603,11314
9162167,9162155,TXFE7,128,9926,2,23123,12604,11315
9162167,9162163,TXFE7,128,9927,1,23124,12605,11316
9162192,9162185,TXFE7,128,9928,1,23125,12606,11317
9162254,9162247,TXFE7,128,9926,1,23126,12607,11318
9162254,9162250,TXFE7,128,9927,1,23127,12608,11319
9162279,9162269,TXFE7,128,9927,1,23128,12609,11320
9162279,9162271,TXFE7,128,9927,4,23132,12610,11321
9162329,9162318,TXFE7,128,9928,1,23133,12611,11322
9162342,9162330,TXFE7,128,9927,1,23134,12612,11323
9162367,9162363,TXFE7,128,9928,1,23135,12613,11324
9162379,9162377,TXFE7,128,9928,3,23138,12614,11325
9162404,9162399,TXFE7,128,9928,2,23140,12615,11327
9162404,9162400,TXFE7,128,9928,1,23141,12616,11328
9162429,9162422,TXFE7,128,9928,6,23147,12617,11332
9162442,9162429,TXFE7,128,9928,2,23149,12618,11333
9162479,9162467,TXFE7,128,9928,1,23150,12619,11334
9162492,9162482,TXFE7,128,9929,1,23151,12620,11335
9162504,9162498,TXFE7,128,9927,1,23152,12621,11336
9162504,9162501,TXFE7,128,9928,1,23153,12622,11337
9162554,9162542,TXFE7,128,9928,1,23154,12623,11338
9162554,9162552,TXFE7,128,9929,2,23156,12624,11340
9162554,9162554,TXFE7,128,9929,1,23157,12625,11341
9162642,9162641,TXFE7,128,9928,1,23158,12626,11342
9162692,9162681,TXFE7,128,9928,1,23159,12627,11343
9162692,9162683,TXFE7,128,9928,1,23160,12628,11344
9162742,9162733,TXFE7,128,9927,1,23161,12629,11345
9162742,9162733,TXFE7,128,9928,1,23162,12630,11346
9162754,9162748,TXFE7,128,9928,1,23163,12631,11347
9162779,9162769,TXFE7,128,9928,1,23164,12632,11348
9162829,9162818,TXFE7,128,9928,1,23165,12633,11349
9162867,9162857,TXFE7,128,9928,1,23166,12634,11350
9162992,9162982,TXFE7,128,9927,1,23167,12635,11351
9162992,9162987,TXFE7,128,9928,1,23168,12636,11352
9162992,9162990,TXFE7,128,9928,1,23169,12637,11353
9163067,9163063,TXFE7,128,9927,2,23171,12638,11354
9163079,9163071,TXFE7,128,9928,5,23176,12639,11357
9163104,9163097,TXFE7,128,9928,1,23177,12640,11358
9163104,9163101,TXFE7,128,9927,1,23178,12641,11359
9163154,9163151,TXFE7,128,9928,1,23179,12642,11360
9163167,9163158,TXFE7,128,9927,1,23180,12643,11361
9163204,9163203,TXFE7,128,9928,1,23181,12644,11362
9163354,9163343,TXFE7,128,9928,1,23182,12645,11363
9163367,9163355,TXFE7,128,9928,20,23202,12646,11372
9163367,9163363,TXFE7,128,9928,1,23203,12647,11373
9163442,9163430,TXFE7,128,9929,10,23213,12648,11381
9163479,9163475,TXFE7,128,9929,2,23215,12649,11383
9163479,9163477,TXFE7,128,9928,1,23216,12650,11384
9163492,9163486,TXFE7,128,9928,1,23217,12651,11385
9163542,9163530,TXFE7,128,9928,1,23218,12652,11386
9163542,9163538,TXFE7,128,9929,2,23220,12653,11388
9163592,9163584,TXFE7,128,9928,1,23221,12654,11389
9163654,9163645,TXFE7,128,9928,1,23222,12655,11390
9163679,9163667,TXFE7,128,9929,3,23225,12656,11392
9163704,9163699,TXFE7,128,9929,1,23226,12657,11393
9163717,9163713,TXFE7,128,9929,2,23228,12658,11395
9163742,9163733,TXFE7,128,9929,1,23229,12659,11396
9163754,9163750,TXFE7,128,9928,6,23235,12664,11397
9163767,9163766,TXFE7,128,9929,1,23236,12665,11398
9163854,9163852,TXFE7,128,9928,1,23237,12666,11399
9163867,9163861,TXFE7,128,9929,1,23238,12667,11400
9163879,9163875,TXFE7,128,9928,1,23239,12668,11401
9163967,9163960,TXFE7,128,9929,1,23240,12669,11402
9163979,9163976,TXFE7,128,9929,1,23241,12670,11403
9164004,9163992,TXFE7,128,9929,1,23242,12671,11404
9164004,9164000,TXFE7,128,9928,1,23243,12672,11405
9164004,9164001,TXFE7,128,9928,2,23245,12673,11406
9164017,9164014,TXFE7,128,9929,1,23246,12674,11407
9164042,9164031,TXFE7,128,9929,1,23247,12675,11408
9164054,9164051,TXFE7,128,9929,1,23248,12676,11409
9164079,9164070,TXFE7,128,9929,1,23249,12677,11410
9164117,9164115,TXFE7,128,9929,1,23250,12678,11411
9164129,9164120,TXFE7,128,9928,1,23251,12679,11412
9164129,9164120,TXFE7,128,9928,1,23252,12680,11413
9164129,9164121,TXFE7,128,9928,1,23253,12681,11414
9164129,9164123,TXFE7,128,9928,1,23254,12682,11415
9164142,9164129,TXFE7,128,9928,8,23262,12686,11416
9164142,9164133,TXFE7,128,9928,1,23263,12687,11417
9164142,9164134,TXFE7,128,9928,3,23266,12690,11418
9164142,9164136,TXFE7,128,9928,1,23267,12691,11419
9164142,9164136,TXFE7,128,9929,2,23269,12692,11420
9164142,9164136,TXFE7,128,9929,1,23270,12693,11421
9164154,9164153,TXFE7,128,9928,2,23272,12695,11422
9164167,9164162,TXFE7,128,9928,1,23273,12696,11423
9164204,9164193,TXFE7,128,9928,1,23274,12697,11424
9164217,9164215,TXFE7,128,9928,1,23275,12698,11425
9164242,9164232,TXFE7,128,9929,1,23276,12699,11426
9164242,9164238,TXFE7,128,9929,1,23277,12700,11427
9164254,9164243,TXFE7,128,9928,1,23278,12701,11428
9164354,9164345,TXFE7,128,9928,1,23279,12702,11429
9164379,9164376,TXFE7,128,9929,1,23280,12703,11430
9164417,9164407,TXFE7,128,9928,1,23281,12704,11431
9164417,9164417,TXFE7,128,9928,1,23282,12705,11432
9164492,9164491,TXFE7,128,9929,1,23283,12706,11433
9164517,9164505,TXFE7,128,9929,1,23284,12707,11434
9164567,9164559,TXFE7,128,9928,1,23285,12708,11435
9164567,9164564,TXFE7,128,9929,1,23286,12709,11436
9164579,9164568,TXFE7,128,9929,1,23287,12710,11437
9164592,9164583,TXFE7,128,9929,1,23288,12711,11438
9164604,9164595,TXFE7,128,9929,3,23291,12712,11439
9164617,9164604,TXFE7,128,9928,1,23292,12713,11440
9164617,9164607,TXFE7,128,9928,2,23294,12715,11441
9164667,9164657,TXFE7,128,9929,1,23295,12716,11442
9164679,9164675,TXFE7,128,9928,5,23300,12721,11443
9164692,9164686,TXFE7,128,9929,1,23301,12722,11444
9164692,9164690,TXFE7,128,9928,1,23302,12723,11445
9164704,9164697,TXFE7,128,9928,2,23304,12725,11446
9164742,9164740,TXFE7,128,9928,7,23311,12729,11447
9164742,9164740,TXFE7,128,9928,1,23312,12730,11448
9164754,9164745,TXFE7,128,9929,1,23313,12731,11449
9164767,9164756,TXFE7,128,9928,1,23314,12732,11450
9164779,9164770,TXFE7,128,9928,1,23315,12733,11451
9164779,9164777,TXFE7,128,9928,1,23316,12734,11452
9164792,9164781,TXFE7,128,9929,1,23317,12735,11453
9164792,9164781,TXFE7,128,9928,2,23319,12737,11454
9164804,9164796,TXFE7,128,9928,1,23320,12738,11455
9164804,9164798,TXFE7,128,9929,1,23321,12739,11456
9164817,9164805,TXFE7,128,9928,1,23322,12740,11457
9164817,9164809,TXFE7,128,9928,2,23324,12741,11458
9164817,9164809,TXFE7,128,9928,2,23326,12742,11459
9164904,9164894,TXFE7,128,9928,1,23327,12743,11460
9164917,9164906,TXFE7,128,9928,2,23329,12744,11462
9164954,9164950,TXFE7,128,9928,1,23330,12745,11463
9165029,9165026,TXFE7,128,9928,6,23336,12746,11466
9165042,9165041,TXFE7,128,9928,2,23338,12747,11467
9165079,9165067,TXFE7,128,9928,1,23339,12748,11468
9165079,9165071,TXFE7,128,9928,1,23340,12749,11469
9165092,9165080,TXFE7,128,9928,2,23342,12750,11470
9165129,9165123,TXFE7,128,9928,1,23343,12751,11471
9165129,9165128,TXFE7,128,9928,1,23344,12752,11472
9165154,9165151,TXFE7,128,9928,1,23345,12753,11473
9165217,9165212,TXFE7,128,9928,1,23346,12754,11474
9165292,9165280,TXFE7,128,9927,3,23349,12756,11475
9165317,9165307,TXFE7,128,9928,1,23350,12757,11476
9165367,9165361,TXFE7,128,9928,1,23351,12758,11477
9165467,9165455,TXFE7,128,9928,1,23352,12759,11478
9165542,9165531,TXFE7,128,9928,1,23353,12760,11479
9165579,9165568,TXFE7,128,9928,2,23355,12761,11480
9165604,9165599,TXFE7,128,9927,3,23358,12763,11481
9165617,9165609,TXFE7,128,9928,5,23363,12764,11483
9165617,9165614,TXFE7,128,9927,2,23365,12766,11484
9165642,9165633,TXFE7,128,9928,1,23366,12767,11485
9165654,9165652,TXFE7,128,9927,1,23367,12768,11486
9165704,9165696,TXFE7,128,9928,2,23369,12769,11487
9165842,9165835,TXFE7,128,9927,1,23370,12770,11488
9165929,9165928,TXFE7,128,9927,73,23443,12803,11489
9165942,9165930,TXFE7,128,9926,2,23445,12805,11490
9165942,9165931,TXFE7,128,9926,6,23451,12808,11491
9165942,9165931,TXFE7,128,9926,6,23457,12810,11492
9165942,9165931,TXFE7,128,9926,6,23463,12812,11493
9165942,9165931,TXFE7,128,9926,6,23469,12813,11494
9165942,9165933,TXFE7,128,9926,6,23475,12817,11495
9165942,9165935,TXFE7,128,9927,5,23480,12818,11498
9165954,9165942,TXFE7,128,9926,2,23482,12819,11499
9165954,9165942,TXFE7,128,9926,2,23484,12820,11500
9165954,9165942,TXFE7,128,9926,1,23485,12821,11501
9165954,9165942,TXFE7,128,9927,1,23486,12822,11502
9165979,9165974,TXFE7,128,9927,1,23487,12823,11503
9165979,9165976,TXFE7,128,9927,1,23488,12824,11504
9165992,9165985,TXFE7,128,9926,4,23492,12825,11505
9170017,9170015,TXFE7,128,9927,1,23493,12826,11506
9170029,9170028,TXFE7,128,9926,1,23494,12827,11507
9170067,9170056,TXFE7,128,9926,2,23496,12828,11508
9170067,9170060,TXFE7,128,9926,1,23497,12829,11509
9170079,9170071,TXFE7,128,9926,1,23498,12830,11510
9170142,9170138,TXFE7,128,9927,1,23499,12831,11511
9170279,9170267,TXFE7,128,9926,9,23508,12839,11512
9170292,9170279,TXFE7,128,9926,2,23510,12840,11513
9170329,9170326,TXFE7,128,9926,3,23513,12841,11514
9170367,9170358,TXFE7,128,9926,1,23514,12842,11515
9170404,9170395,TXFE7,128,9926,1,23515,12843,11516
9170417,9170411,TXFE7,128,9925,2,23517,12845,11517
9170429,9170427,TXFE7,128,9925,1,23518,12846,11518
9170454,9170446,TXFE7,128,9925,1,23519,12847,11519
9170517,9170510,TXFE7,128,9925,1,23520,12848,11520
9170517,9170510,TXFE7,128,9926,6,23526,12849,11525
9170542,9170531,TXFE7,128,9926,2,23528,12850,11526
9170554,9170546,TXFE7,128,9927,2,23530,12851,11527
9170579,9170570,TXFE7,128,9927,1,23531,12852,11528
9170654,9170647,TXFE7,128,9927,10,23541,12853,11533
9170679,9170673,TXFE7,128,9926,1,23542,12854,11534
9170704,9170699,TXFE7,128,9926,1,23543,12855,11535
9170879,9170873,TXFE7,128,9927,1,23544,12856,11536
9171029,9171020,TXFE7,128,9927,1,23545,12857,11537
9171079,9171070,TXFE7,128,9926,1,23546,12858,11538
9171104,9171102,TXFE7,128,9927,5,23551,12859,11541
9171154,9171147,TXFE7,128,9926,5,23556,12860,11542
9171167,9171158,TXFE7,128,9927,1,23557,12861,11543
9171167,9171164,TXFE7,128,9927,1,23558,12862,11544
9171217,9171214,TXFE7,128,9927,1,23559,12863,11545
9171292,9171291,TXFE7,128,9927,10,23569,12864,11551
9171404,9171395,TXFE7,128,9926,1,23570,12865,11552
9171454,9171450,TXFE7,128,9927,1,23571,12866,11553
9171454,9171451,TXFE7,128,9926,5,23576,12867,11554
9171467,9171460,TXFE7,128,9926,1,23577,12868,11555
9171467,9171464,TXFE7,128,9927,1,23578,12869,11556
9171604,9171595,TXFE7,128,9926,2,23580,12870,11557
9171604,9171598,TXFE7,128,9927,2,23582,12871,11559
9171679,9171667,TXFE7,128,9927,1,23583,12872,11560
9171767,9171763,TXFE7,128,9927,2,23585,12873,11562
9171867,9171860,TXFE7,128,9927,1,23586,12874,11563
9171879,9171873,TXFE7,128,9927,1,23587,12875,11564
9172004,9172001,TXFE7,128,9927,1,23588,12876,11565
9172029,9172027,TXFE7,128,9927,3,23591,12877,11568
9172042,9172036,TXFE7,128,9927,1,23592,12878,11569
9172042,9172036,TXFE7,128,9927,1,23593,12879,11570
9172079,9172068,TXFE7,128,9926,3,23596,12880,11571
9172092,9172086,TXFE7,128,9927,2,23598,12881,11572
9172142,9172131,TXFE7,128,9927,1,23599,12882,11573
9172142,9172136,TXFE7,128,9927,1,23600,12883,11574
9172217,9172210,TXFE7,128,9927,1,23601,12884,11575
9172254,9172245,TXFE7,128,9927,1,23602,12885,11576
9172304,9172295,TXFE7,128,9927,3,23605,12886,11578
9172354,9172342,TXFE7,128,9927,4,23609,12889,11579
9172404,9172398,TXFE7,128,9928,3,23612,12890,11581
9172467,9172456,TXFE7,128,9928,24,23636,12891,11595
9172479,9172467,TXFE7,128,9928,8,23644,12892,11603
9172479,9172467,TXFE7,128,9928,2,23646,12893,11605
9172492,9172492,TXFE7,128,9928,2,23648,12894,11606
9172529,9172528,TXFE7,128,9929,2,23650,12895,11607
9172554,9172544,TXFE7,128,9928,1,23651,12896,11608
9172554,9172551,TXFE7,128,9929,1,23652,12897,11609
9172579,9172571,TXFE7,128,9929,2,23654,12898,11610
9172592,9172590,TXFE7,128,9928,1,23655,12899,11611
9172642,9172639,TXFE7,128,9929,1,23656,12900,11612
9172704,9172693,TXFE7,128,9928,1,23657,12901,11613
9172729,9172720,TXFE7,128,9928,3,23660,12902,11614
9172929,9172925,TXFE7,128,9929,1,23661,12903,11615
9172979,9172967,TXFE7,128,9929,1,23662,12904,11616
9172979,9172969,TXFE7,128,9929,10,23672,12905,11617
9173042,9173041,TXFE7,128,9929,1,23673,12906,11618
9173054,9173048,TXFE7,128,9928,2,23675,12908,11619
9173079,9173073,TXFE7,128,9929,1,23676,12909,11620
9173204,9173200,TXFE7,128,9929,7,23683,12910,11621
9173217,9173208,TXFE7,128,9929,1,23684,12911,11622
9173217,9173211,TXFE7,128,9929,1,23685,12912,11623
9173279,9173272,TXFE7,128,9929,1,23686,12913,11624
9173292,9173280,TXFE7,128,9929,1,23687,12914,11625
9173354,9173351,TXFE7,128,9929,1,23688,12915,11626
9173367,9173363,TXFE7,128,9928,5,23693,12920,11627
9173367,9173367,TXFE7,128,9929,1,23694,12921,11628
9173392,9173387,TXFE7,128,9929,3,23697,12922,11629
9173392,9173389,TXFE7,128,9929,1,23698,12923,11630
9173442,9173438,TXFE7,128,9929,1,23699,12924,11631
9173454,9173443,TXFE7,128,9929,1,23700,12925,11632
9173504,9173495,TXFE7,128,9929,1,23701,12926,11633
9173504,9173501,TXFE7,128,9928,5,23706,12928,11634
9173504,9173501,TXFE7,128,9929,1,23707,12929,11635
9173517,9173514,TXFE7,128,9929,1,23708,12930,11636
9173529,9173518,TXFE7,128,9928,1,23709,12931,11637
9173529,9173520,TXFE7,128,9929,2,23711,12932,11638
9173667,9173661,TXFE7,128,9928,2,23713,12933,11639
9173742,9173729,TXFE7,128,9929,1,23714,12934,11640
9173867,9173861,TXFE7,128,9929,1,23715,12935,11641
9173929,9173928,TXFE7,128,9929,1,23716,12936,11642
9174029,9174023,TXFE7,128,9929,2,23718,12937,11643
9174092,9174083,TXFE7,128,9929,1,23719,12938,11644
9174104,9174100,TXFE7,128,9928,2,23721,12939,11645
9174129,9174119,TXFE7,128,9929,1,23722,12940,11646
9174179,9174174,TXFE7,128,9928,1,23723,12941,11647
9174229,9174221,TXFE7,128,9928,3,23726,12942,11648
9174317,9174305,TXFE7,128,9928,2,23728,12943,11649
9174317,9174308,TXFE7,128,9929,1,23729,12944,11650
9174317,9174317,TXFE7,128,9929,1,23730,12945,11651
9174442,9174436,TXFE7,128,9929,2,23732,12946,11652
9174829,9174823,TXFE7,128,9929,2,23747,12953,11659
9174967,9174959,TXFE7,128,9929,1,23748,12954,11660
9174979,9174974,TXFE7,128,9928,2,23750,12955,11661
9175029,9175020,TXFE7,128,9929,3,23753,12956,11662
9175029,9175028,TXFE7,128,9928,2,23755,12957,11663
9175079,9175079,TXFE7,128,9928,1,23756,12958,11664
9175092,9175086,TXFE7,128,9929,1,23757,12959,11665
9175129,9175118,TXFE7,128,9929,1,23758,12960,11666
9175204,9175200,TXFE7,128,9929,3,23761,12961,11667
9175242,9175230,TXFE7,128,9928,2,23763,12962,11668
9175242,9175232,TXFE7,128,9928,1,23764,12963,11669
9175304,9175292,TXFE7,128,9929,2,23766,12964,11670
9175429,9175425,TXFE7,128,9929,1,23767,12965,11671
9175454,9175450,TXFE7,128,9929,1,23768,12966,11672
9175579,9175571,TXFE7,128,9928,2,23770,12967,11673
9175617,9175607,TXFE7,128,9928,1,23771,12968,11674
9175629,9175619,TXFE7,128,9929,1,23772,12969,11675
9175654,9175644,TXFE7,128,9929,1,23773,12970,11676
9175667,9175660,TXFE7,128,9929,1,23774,12971,11677
9175667,9175665,TXFE7,128,9929,1,23775,12972,11678
9175679,9175670,TXFE7,128,9929,1,23776,12973,11679
9175692,9175684,TXFE7,128,9929,2,23778,12974,11680
9175704,9175694,TXFE7,128,9929,1,23779,12975,11681
9175704,9175702,TXFE7,128,9929,5,23784,12976,11683
9175717,9175711,TXFE7,128,9929,4,23788,12977,11686
9175729,9175720,TXFE7,128,9929,1,23789,12978,11687
9175729,9175721,TXFE7,128,9929,5,23794,12979,11690
9175729,9175721,TXFE7,128,9929,5,23799,12980,11694
9175729,9175721,TXFE7,128,9929,2,23801,12981,11695
9175742,9175729,TXFE7,128,9929,16,23817,12982,11707
9175742,9175729,TXFE7,128,9929,6,23823,12983,11711
9175742,9175729,TXFE7,128,9929,2,23825,12984,11713
9175742,9175729,TXFE7,128,9929,27,23852,12985,11724
9175829,9175817,TXFE7,128,9930,2,23854,12986,11725
9175842,9175838,TXFE7,128,9930,2,23856,12987,11726
9175854,9175850,TXFE7,128,9930,10,23866,12988,11732
9175879,9175870,TXFE7,128,9930,3,23869,12989,11733
9175879,9175874,TXFE7,128,9930,75,23944,12990,11772
9175892,9175880,TXFE7,128,9931,6,23950,12991,11777
9175892,9175887,TXFE7,128,9931,1,23951,12992,11778
9175904,9175892,TXFE7,128,9931,8,23959,12993,11783
9175904,9175894,TXFE7,128,9930,2,23961,12994,11784
9175904,9175896,TXFE7,128,9931,1,23962,12995,11785
9175904,9175897,TXFE7,128,9931,1,23963,12996,11786
9175917,9175904,TXFE7,128,9931,1,23964,12997,11787
9175917,9175915,TXFE7,128,9930,1,23965,12998,11788
9175929,9175922,TXFE7,128,9931,2,23967,12999,11789
9175942,9175939,TXFE7,128,9931,1,23968,13000,11790
9175954,9175947,TXFE7,128,9931,1,23969,13001,11791
9175954,9175949,TXFE7,128,9931,2,23971,13002,11792
9175967,9175958,TXFE7,128,9931,3,23974,13003,11794
9175967,9175965,TXFE7,128,9931,1,23975,13004,11795
9175992,9175986,TXFE7,128,9931,1,23976,13005,11796
9180004,9180000,TXFE7,128,9931,1,23977,13006,11797
9180017,9180007,TXFE7,128,9931,1,23978,13007,11798
9180029,9180022,TXFE7,128,9931,1,23979,13008,11799
9180042,9180040,TXFE7,128,9931,1,23980,13009,11800
9180054,9180049,TXFE7,128,9931,2,23982,13010,11802
9180054,9180050,TXFE7,128,9930,2,23984,13011,11803
9180079,9180069,TXFE7,128,9930,6,23990,13013,11804
9180092,9180081,TXFE7,128,9930,1,23991,13014,11805
9180092,9180082,TXFE7,128,9930,1,23992,13015,11806
9180104,9180096,TXFE7,128,9931,1,23993,13016,11807
9180104,9180100,TXFE7,128,9930,1,23994,13017,11808
9180117,9180105,TXFE7,128,9931,1,23995,13018,11809
9180129,9180118,TXFE7,128,9931,1,23996,13019,11810
9180129,9180121,TXFE7,128,9930,1,23997,13020,11811
9180142,9180134,TXFE7,128,9930,3,24000,13023,11812
9180154,9180142,TXFE7,128,9930,1,24001,13024,11813
9180154,9180143,TXFE7,128,9931,3,24004,13025,11816
9180154,9180149,TXFE7,128,9930,2,24006,13027,11817
9180167,9180154,TXFE7,128,9930,1,24007,13028,11818
9180167,9180158,TXFE7,128,9931,1,24008,13029,11819
9180167,9180160,TXFE7,129,9930,1,24013,13032,11820
9180167,9180160,TXFE7,129,9929,4,24013,13032,11820
9180167,9180164,TXFE7,128,9931,1,24014,13033,11821
9180179,9180167,TXFE7,128,9929,2,24016,13034,11822
9180179,9180170,TXFE7,128,9929,2,24018,13035,11823
9180179,9180174,TXFE7,128,9931,3,24021,13036,11826
9180192,9180179,TXFE7,128,9930,1,24022,13037,11827
9180192,9180179,TXFE7,128,9930,1,24023,13038,11828
9180192,9180179,TXFE7,128,9931,1,24024,13039,11829
9180204,9180193,TXFE7,128,9930,1,24025,13040,11830
9180217,9180208,TXFE7,128,9930,2,24027,13041,11831
9180217,9180215,TXFE7,128,9930,3,24030,13042,11834
9180229,9180217,TXFE7,128,9930,2,24032,13043,11835
9180229,9180217,TXFE7,128,9930,1,24033,13044,11836
9180229,9180221,TXFE7,128,9931,2,24035,13045,11838
9180229,9180222,TXFE7,128,9930,1,24036,13046,11839
9180229,9180223,TXFE7,128,9931,1,24037,13047,11840
9180229,9180224,TXFE7,128,9931,1,24038,13048,11841
9180242,9180237,TXFE7,128,9931,1,24039,13049,11842
9180254,9180250,TXFE7,128,9930,4,24043,13052,11843
9180267,9180260,TXFE7,128,9930,1,24044,13053,11844
9180267,9180260,TXFE7,128,9931,1,24045,13054,11845
9180292,9180282,TXFE7,128,9931,1,24046,13055,11846
9180367,9180362,TXFE7,128,9931,1,24047,13056,11847
9180417,9180412,TXFE7,128,9931,1,24048,13057,11848
9180454,9180442,TXFE7,128,9931,1,24049,13058,11849
9180454,9180452,TXFE7,128,9931,6,24055,13059,11853
9180467,9180454,TXFE7,128,9931,25,24080,13060,11868
9180492,9180490,TXFE7,128,9931,1,24081,13061,11869
9180504,9180501,TXFE7,128,9932,1,24082,13062,11870
9180517,9180507,TXFE7,128,9932,1,24083,13063,11871
9180517,9180508,TXFE7,128,9932,1,24084,13064,11872
9180517,9180512,TXFE7,128,9932,1,24085,13065,11873
9180517,9180512,TXFE7,128,9932,1,24086,13066,11874
9180529,9180517,TXFE7,128,9931,4,24090,13069,11875
9180567,9180565,TXFE7,128,9932,1,24091,13070,11876
9180567,9180566,TXFE7,128,9932,1,24092,13071,11877
9180579,9180570,TXFE7,128,9932,1,24093,13072,11878
9180579,9180571,TXFE7,128,9932,3,24096,13073,11881
9180579,9180573,TXFE7,128,9932,1,24097,13074,11882
9180629,9180621,TXFE7,128,9932,1,24098,13075,11883
9180642,9180635,TXFE7,128,9932,3,24101,13076,11884
9180642,9180638,TXFE7,128,9932,1,24102,13077,11885
9180654,9180654,TXFE7,128,9931,1,24103,13078,11886
9180679,9180678,TXFE7,128,9931,1,24104,13079,11887
9180692,9180687,TXFE7,128,9932,1,24105,13080,11888
9180754,9180747,TXFE7,128,9932,1,24106,13081,11889
9180779,9180771,TXFE7,128,9932,1,24107,13082,11890
9180779,9180777,TXFE7,128,9932,1,24108,13083,11891
9180804,9180797,TXFE7,128,9931,1,24109,13084,11892
9180804,9180797,TXFE7,128,9931,1,24110,13085,11893
9180804,9180797,TXFE7,128,9931,2,24112,13087,11894
9180804,9180797,TXFE7,128,9931,2,24114,13089,11895
9180804,9180797,TXFE7,128,9931,2,24116,13090,11896
9180804,9180797,TXFE7,128,9931,2,24118,13092,11897
9180804,9180797,TXFE7,128,9931,2,24120,13094,11898
9180804,9180800,TXFE7,128,9932,1,24121,13095,11899
9180829,9180817,TXFE7,128,9932,1,24122,13096,11900
9180879,9180871,TXFE7,128,9932,1,24123,13097,11901
9180929,9180923,TXFE7,128,9932,1,24124,13098,11902
9180929,9180924,TXFE7,128,9931,2,24126,13099,11903
9180942,9180934,TXFE7,128,9932,1,24127,13100,11904
9180942,9180937,TXFE7,128,9931,1,24128,13101,11905
9180979,9180970,TXFE7,128,9932,2,24130,13102,11906
9180979,9180973,TXFE7,128,9932,1,24131,13103,11907
9180979,9180973,TXFE7,128,9932,2,24133,13104,11908
9180979,9180978,TXFE7,128,9931,1,24134,13105,11909
9180992,9180981,TXFE7,128,9932,1,24135,13106,11910
9180992,9180982,TXFE7,128,9932,2,24137,13107,11912
9180992,9180983,TXFE7,128,9932,1,24138,13108,11913
9180992,9180986,TXFE7,128,9931,7,24145,13113,11914
9181017,9181009,TXFE7,128,9931,1,24146,13114,11915
9181017,9181011,TXFE7,128,9932,1,24147,13115,11916
9181054,9181045,TXFE7,128,9931,1,24148,13116,11917
9181054,9181046,TXFE7,128,9931,3,24151,13119,11918
9181067,9181055,TXFE7,128,9931,2,24153,13121,11919
9181067,9181063,TXFE7,128,9931,2,24155,13122,11920
9181079,9181069,TXFE7,129,9931,1,24157,13123,11922
9181079,9181069,TXFE7,129,9932,1,24157,13123,11922
9181079,9181069,TXFE7,128,9932,5,24162,13124,11925
9181117,9181112,TXFE7,128,9930,1,24163,13125,11926
9181117,9181116,TXFE7,128,9931,1,24164,13126,11927
9181117,9181117,TXFE7,128,9930,1,24165,13127,11928
9181167,9181164,TXFE7,128,9931,1,24166,13128,11929
9181167,9181165,TXFE7,128,9931,1,24167,13129,11930
9181254,9181245,TXFE7,128,9931,1,24168,13130,11931
9181254,9181245,TXFE7,128,9931,1,24169,13131,11932
9181254,9181248,TXFE7,128,9931,1,24170,13132,11933
9181267,9181257,TXFE7,128,9931,1,24171,13133,11934
9181342,9181331,TXFE7,128,9931,1,24172,13134,11935
9181354,9181351,TXFE7,128,9931,1,24173,13135,11936
9181367,9181360,TXFE7,128,9931,5,24178,13136,11939
9181379,9181368,TXFE7,128,9931,1,24179,13137,11940
9181379,9181375,TXFE7,128,9931,1,24180,13138,11941
9181392,9181381,TXFE7,128,9931,1,24181,13139,11942
9181404,9181404,TXFE7,128,9931,2,24183,13140,11944
9181417,9181410,TXFE7,128,9930,1,24184,13141,11945
9181429,9181421,TXFE7,128,9931,1,24185,13142,11946
9181429,9181426,TXFE7,128,9930,1,24186,13143,11947
9181442,9181436,TXFE7,128,9931,1,24187,13144,11948
9181454,9181443,TXFE7,128,9931,4,24191,13145,11952
9181467,9181466,TXFE7,128,9931,1,24192,13146,11953
9181529,9181528,TXFE7,128,9930,1,24193,13147,11954
9181554,9181548,TXFE7,128,9931,5,24198,13148,11957
9181567,9181566,TXFE7,128,9931,7,24205,13149,11961
9181579,9181577,TXFE7,128,9931,1,24206,13150,11962
9181579,9181578,TXFE7,128,9931,1,24207,13151,11963
9181592,9181585,TXFE7,128,9931,3,24210,13152,11966
9181604,9181592,TXFE7,128,9930,2,24212,13153,11967
9181617,9181607,TXFE7,128,9931,16,24228,13154,11975
9181629,9181617,TXFE7,128,9931,1,24229,13155,11976
9181642,9181638,TXFE7,128,9932,1,24230,13156,11977
9181667,9181659,TXFE7,128,9931,1,24231,13157,11978
9181667,9181663,TXFE7,128,9931,2,24233,13158,11979
9181679,9181672,TXFE7,128,9931,5,24238,13160,11980
9181679,9181674,TXFE7,128,9931,1,24239,13161,11981
9181692,9181684,TXFE7,128,9932,1,24240,13162,11982
9181692,9181688,TXFE7,128,9931,2,24242,13163,11983
9181704,9181699,TXFE7,128,9932,3,24245,13164,11986
9181729,9181718,TXFE7,128,9932,1,24246,13165,11987
9181779,9181778,TXFE7,128,9932,1,24247,13166,11988
9181842,9181841,TXFE7,128,9931,1,24248,13167,11989
9181854,9181845,TXFE7,128,9932,3,24251,13168,11992
9181854,9181850,TXFE7,128,9932,1,24252,13169,11993
9181892,9181887,TXFE7,128,9932,1,24253,13170,11994
9181892,9181890,TXFE7,128,9932,1,24254,13171,11995
9181917,9181908,TXFE7,128,9931,1,24255,13172,11996
9181929,9181923,TXFE7,128,9932,5,24260,13173,12001
9181967,9181963,TXFE7,128,9932,1,24261,13174,12002
9182004,9182001,TXFE7,128,9932,3,24264,13175,12005
9182004,9182001,TXFE7,128,9932,5,24269,13176,12008
9182017,9182004,TXFE7,128,9932,1,24270,13177,12009
9182092,9182089,TXFE7,128,9932,1,24274,13181,12013
9182167,9182156,TXFE7,128,9931,1,24275,13182,12014
9182192,9182183,TXFE7,128,9932,1,24276,13183,12015
9182192,9182185,TXFE7,128,9931,2,24278,13185,12016
9182529,9182520,TXFE7,128,9932,1,24349,13228,12048
9182554,9182546,TXFE7,128,9931,1,24350,13229,12049
9182617,9182611,TXFE7,128,9932,1,24351,13230,12050
9182642,9182635,TXFE7,128,9932,1,24352,13231,12051
9182654,9182653,TXFE7,128,9932,1,24353,13232,12052
9182704,9182703,TXFE7,128,9931,1,24354,13233,12053
9182742,9182731,TXFE7,128,9932,1,24355,13234,12054
9182754,9182754,TXFE7,128,9931,1,24356,13235,12055
9182792,9182786,TXFE7,128,9931,1,24357,13236,12056
9182829,9182821,TXFE7,128,9931,1,24358,13237,12057
9182854,9182851,TXFE7,128,9932,2,24360,13238,12059
9182892,9182888,TXFE7,128,9932,7,24367,13239,12065
9182979,9182968,TXFE7,128,9932,5,24372,13240,12070
9182979,9182975,TXFE7,128,9932,2,24374,13241,12072
9183017,9183009,TXFE7,128,9932,1,24375,13242,12073
9183029,9183028,TXFE7,128,9932,10,24385,13243,12076
9183029,9183029,TXFE7,128,9932,1,24386,13244,12077
9183042,9183029,TXFE7,128,9932,2,24388,13245,12079
9183054,9183042,TXFE7,128,9932,12,24400,13246,12089
9183054,9183050,TXFE7,128,9932,2,24402,13247,12090
9183092,9183083,TXFE7,128,9932,1,24403,13248,12091
9183092,9183083,TXFE7,128,9932,1,24404,13249,12092
9183104,9183103,TXFE7,128,9932,1,24405,13250,12093
9183117,9183116,TXFE7,128,9933,10,24415,13251,12102
9183129,9183121,TXFE7,128,9933,1,24416,13252,12103
9183129,9183124,TXFE7,128,9933,2,24418,13253,12105
9183129,9183127,TXFE7,128,9933,3,24421,13254,12108
9183142,9183130,TXFE7,128,9933,1,24422,13255,12109
9183142,9183131,TXFE7,128,9933,3,24425,13256,12111
9183142,9183133,TXFE7,128,9933,3,24428,13257,12113
9183154,9183148,TXFE7,128,9933,3,24431,13258,12115
9183154,9183150,TXFE7,128,9933,5,24436,13259,12119
9183154,9183152,TXFE7,128,9933,1,24437,13260,12120
9183167,9183154,TXFE7,128,9933,4,24441,13261,12122
9183167,9183162,TXFE7,128,9933,6,24447,13262,12126
9183167,9183162,TXFE7,128,9933,1,24448,13263,12127
9183167,9183166,TXFE7,128,9932,1,24449,13264,12128
9183179,9183167,TXFE7,128,9933,9,24458,13265,12135
9183192,9183190,TXFE7,128,9934,9,24467,13266,12140
9183204,9183193,TXFE7,128,9934,12,24479,13267,12150
9183204,9183195,TXFE7,128,9934,5,24484,13268,12152
9183217,9183205,TXFE7,129,9934,35,24523,13269,12172
9183217,9183205,TXFE7,129,9935,4,24523,13269,12172
9183217,9183209,TXFE7,128,9935,1,24524,13270,12173
9183229,9183217,TXFE7,128,9935,4,24528,13271,12175
9183229,9183217,TXFE7,128,9935,4,24532,13272,12177
9183229,9183217,TXFE7,128,9935,4,24536,13273,12181
9183229,9183221,TXFE7,128,9935,4,24540,13274,12183
9183229,9183221,TXFE7,128,9935,1,24541,13275,12184
9183229,9183222,TXFE7,128,9935,10,24551,13276,12188
9183229,9183225,TXFE7,128,9935,1,24552,13277,12189
9183229,9183226,TXFE7,128,9935,1,24553,13278,12190
9183229,9183226,TXFE7,128,9935,1,24554,13279,12191
9183229,9183228,TXFE7,128,9935,1,24555,13280,12192
9183229,9183229,TXFE7,128,9935,10,24565,13281,12201
9183242,9183230,TXFE7,128,9935,4,24569,13282,12203
9183242,9183232,TXFE7,128,9935,1,24570,13283,12204
9183242,9183233,TXFE7,128,9935,1,24571,13284,12205
9183242,9183234,TXFE7,128,9934,1,24572,13285,12206
9183242,9183235,TXFE7,128,9935,1,24573,13286,12207
9183254,9183242,TXFE7,128,9935,2,24575,13287,12209
9183254,9183246,TXFE7,128,9935,1,24576,13288,12210
9183267,9183255,TXFE7,128,9935,7,24583,13289,12213
9183267,9183256,TXFE7,128,9934,10,24593,13293,12214
9183279,9183267,TXFE7,128,9934,3,24596,13295,12215
9183279,9183270,TXFE7,128,9934,1,24597,13296,12216
9183292,9183285,TXFE7,128,9934,5,24602,13297,12218
9183292,9183289,TXFE7,128,9934,1,24603,13298,12219
9183317,9183305,TXFE7,128,9933,4,24607,13301,12220
9183317,9183306,TXFE7,128,9934,1,24608,13302,12221
9183317,9183307,TXFE7,128,9934,5,24613,13303,12223
9183329,9183317,TXFE7,128,9933,3,24616,13305,12224
9183329,9183323,TXFE7,128,9932,1,24617,13306,12225
9183342,9183341,TXFE7,128,9933,1,24618,13307,12226
9183354,9183353,TXFE7,128,9933,1,24619,13308,12227
9183367,9183360,TXFE7,128,9933,1,24620,13309,12228
9183379,9183368,TXFE7,128,9932,1,24621,13310,12229
9183392,9183389,TXFE7,128,9932,1,24622,13311,12230
9183404,9183399,TXFE7,128,9933,1,24623,13312,12231
9183442,9183435,TXFE7,128,9933,1,24624,13313,12232
9183454,9183450,TXFE7,128,9933,5,24629,13314,12233
9183492,9183487,TXFE7,128,9932,1,24630,13315,12234
9183504,9183497,TXFE7,128,9933,1,24631,13316,12235
9183517,9183505,TXFE7,128,9933,1,24632,13317,12236
9183517,9183515,TXFE7,128,9933,1,24633,13318,12237
9183542,9183542,TXFE7,128,9933,1,24634,13319,12238
9183554,9183552,TXFE7,128,9933,1,24635,13320,12239
9183579,9183567,TXFE7,128,9933,3,24638,13321,12240
9183579,9183569,TXFE7,128,9933,1,24639,13322,12241
9183629,9183622,TXFE7,128,9933,8,24647,13323,12243
9183679,9183668,TXFE7,128,9933,1,24648,13324,12244
9183754,9183754,TXFE7,128,9934,3,24651,13325,12245
9183804,9183796,TXFE7,128,9934,1,24652,13326,12246
9183842,9183839,TXFE7,128,9934,1,24653,13327,12247
9183879,9183875,TXFE7,128,9934,1,24654,13328,12248
9183879,9183875,TXFE7,128,9934,1,24655,13329,12249
9183892,9183885,TXFE7,128,9933,1,24656,13330,12250
9183929,9183917,TXFE7,128,9933,1,24657,13331,12251
9183942,9183930,TXFE7,128,9933,1,24658,13332,12252
9183942,9183938,TXFE7,128,9933,1,24659,13333,12253
9183954,9183947,TXFE7,128,9933,1,24660,13334,12254
9183954,9183950,TXFE7,128,9933,2,24662,13336,12255
9183979,9183978,TXFE7,128,9933,3,24665,13339,12256
9183992,9183984,TXFE7,128,9933,2,24667,13341,12257
9183992,9183987,TXFE7,128,9933,14,24681,13348,12258
9184004,9183992,TXFE7,128,9933,1,24682,13349,12259
9184004,9183992,TXFE7,128,9933,5,24687,13353,12260
9184029,9184017,TXFE7,128,9933,1,24688,13354,12261
9184029,9184026,TXFE7,128,9933,2,24690,13355,12263
9184054,9184054,TXFE7,128,9933,3,24693,13356,12264
9184079,9184076,TXFE7,128,9933,2,24695,13357,12265
9184079,9184077,TXFE7,128,9933,1,24696,13358,12266
9184092,9184080,TXFE7,128,9933,3,24699,13360,12267
9184129,9184117,TXFE7,128,9934,2,24701,13361,12269
9184129,9184125,TXFE7,128,9934,1,24702,13362,12270
9184142,9184138,TXFE7,128,9933,4,24706,13366,12271
9184142,9184139,TXFE7,128,9933,1,24707,13367,12272
9184154,9184146,TXFE7,128,9933,1,24708,13368,12273
9184154,9184152,TXFE7,128,9932,3,24711,13371,12274
9184167,9184158,TXFE7,128,9933,2,24713,13372,12275
9184179,9184167,TXFE7,128,9933,2,24715,13373,12276
9184204,9184199,TXFE7,128,9933,2,24717,13374,12277
9184229,9184220,TXFE7,128,9933,2,24719,13375,12278
9184229,9184225,TXFE7,128,9933,1,24720,13376,12279
9184229,9184226,TXFE7,128,9933,2,24722,13377,12280
9184242,9184230,TXFE7,128,9933,2,24724,13378,12281
9184242,9184237,TXFE7,128,9933,1,24725,13379,12282
9184267,9184257,TXFE7,128,9933,2,24727,13380,12283
9184292,9184290,TXFE7,128,9934,1,24728,13381,12284
9184304,9184304,TXFE7,128,9933,2,24730,13383,12285
9184317,9184307,TXFE7,128,9934,1,24731,13384,12286
9184317,9184314,TXFE7,128,9934,1,24732,13385,12287
9184342,9184340,TXFE7,128,9934,2,24734,13386,12289
9184379,9184373,TXFE7,128,9933,1,24735,13387,12290
9184379,9184379,TXFE7,128,9934,1,24736,13388,12291
9184392,9184384,TXFE7,128,9934,2,24738,13389,12293
9184404,9184394,TXFE7,128,9934,8,24746,13390,12299
9184454,9184446,TXFE7,128,9934,1,24747,13391,12300
9184467,9184460,TXFE7,128,9933,1,24748,13392,12301
9184492,9184484,TXFE7,128,9933,3,24751,13393,12302
9184492,9184485,TXFE7,128,9933,1,24752,13394,12303
9184517,9184505,TXFE7,128,9933,1,24753,13395,12304
9184517,9184513,TXFE7,128,9934,1,24754,13396,12305
9184529,9184525,TXFE7,128,9933,1,24755,13397,12306
9184592,9184584,TXFE7,128,9934,1,24756,13398,12307
9184604,9184597,TXFE7,128,9934,1,24757,13399,12308
9184679,9184674,TXFE7,128,9934,1,24758,13400,12309
9184692,9184684,TXFE7,128,9934,3,24761,13401,12312
9184717,9184704,TXFE7,128,9934,1,24762,13402,12313
9184729,9184724,TXFE7,128,9933,1,24763,13403,12314
9184767,9184754,TXFE7,128,9933,1,24764,13404,12315
9184767,9184759,TXFE7,128,9933,1,24765,13405,12316
9184767,9184761,TXFE7,128,9934,1,24766,13406,12317
9184767,9184765,TXFE7,128,9934,1,24767,13407,12318
9184804,9184792,TXFE7,128,9934,1,24768,13408,12319
9184804,9184801,TXFE7,128,9933,1,24769,13409,12320
9184829,9184827,TXFE7,128,9933,1,24770,13410,12321
9184867,9184858,TXFE7,128,9934,1,24771,13411,12322
9184892,9184882,TXFE7,128,9934,3,24774,13412,12324
9184917,9184907,TXFE7,128,9934,1,24775,13413,12325
9184917,9184913,TXFE7,128,9934,1,24776,13414,12326
9184942,9184933,TXFE7,128,9933,1,24777,13415,12327
9184967,9184958,TXFE7,128,9934,1,24778,13416,12328
9185017,9185013,TXFE7,128,9934,1,24779,13417,12329
9185054,9185051,TXFE7,128,9934,2,24781,13418,12331
9185067,9185059,TXFE7,128,9933,5,24786,13420,12332
9185167,9185158,TXFE7,128,9934,1,24787,13421,12333
9185179,9185176,TXFE7,128,9934,1,24788,13422,12334
9185242,9185239,TXFE7,128,9934,5,24793,13423,12337
9185292,9185287,TXFE7,128,9934,2,24795,13424,12339
9185379,9185371,TXFE7,128,9934,1,24796,13425,12340
9185404,9185400,TXFE7,128,9934,1,24797,13426,12341
9185417,9185406,TXFE7,128,9934,5,24802,13427,12345
9185417,9185406,TXFE7,128,9934,6,24808,13428,12348
9185442,9185436,TXFE7,128,9935,1,24809,13429,12349
9185467,9185462,TXFE7,128,9934,1,24810,13430,12350
9185467,9185467,TXFE7,128,9934,1,24811,13431,12351
9185517,9185514,TXFE7,128,9934,1,24812,13432,12352
9185529,9185528,TXFE7,128,9934,2,24814,13433,12353
9185579,9185578,TXFE7,128,9935,1,24815,13434,12354
9185592,9185580,TXFE7,128,9934,2,24817,13435,12355
9185592,9185589,TXFE7,128,9935,1,24818,13436,12356
9185592,9185592,TXFE7,128,9935,7,24825,13437,12359
9185629,9185629,TXFE7,128,9934,1,24826,13438,12360
9185667,9185666,TXFE7,128,9934,1,24827,13439,12361
9185679,9185676,TXFE7,128,9935,2,24829,13440,12362
9185692,9185682,TXFE7,128,9935,1,24830,13441,12363
9185692,9185683,TXFE7,128,9934,1,24831,13442,12364
9185704,9185700,TXFE7,128,9935,1,24832,13443,12365
9185717,9185706,TXFE7,128,9934,1,24833,13444,12366
9185742,9185733,TXFE7,128,9935,2,24835,13445,12367
9185779,9185777,TXFE7,128,9934,1,24836,13446,12368
9185804,9185792,TXFE7,128,9935,1,24837,13447,12369
9185842,9185834,TXFE7,128,9935,25,24862,13448,12378
9185854,9185848,TXFE7,128,9934,1,24863,13449,12379
9185867,9185857,TXFE7,128,9935,3,24866,13450,12382
9185867,9185860,TXFE7,128,9934,1,24867,13451,12383
9185879,9185876,TXFE7,128,9935,10,24877,13452,12389
9185892,9185887,TXFE7,128,9935,1,24878,13453,12390
9185904,9185893,TXFE7,128,9935,1,24879,13454,12391
9185904,9185896,TXFE7,128,9935,1,24880,13455,12392
9185917,9185904,TXFE7,128,9935,1,24881,13456,12393
9185917,9185908,TXFE7,128,9935,1,24882,13457,12394
9185917,9185916,TXFE7,128,9934,1,24883,13458,12395
9185929,9185918,TXFE7,128,9935,1,24884,13459,12396
9185929,9185927,TXFE7,128,9935,2,24886,13460,12397
9185942,9185929,TXFE7,128,9935,5,24891,13461,12398
9185942,9185934,TXFE7,128,9935,1,24892,13462,12399
9185954,9185942,TXFE7,128,9935,3,24895,13463,12402
9185954,9185942,TXFE7,128,9935,1,24896,13464,12403
9185954,9185944,TXFE7,128,9935,1,24897,13465,12404
9185954,9185951,TXFE7,128,9935,1,24898,13466,12405
9185979,9185973,TXFE7,128,9934,1,24899,13467,12406
9185979,9185974,TXFE7,128,9934,1,24900,13468,12407
9185992,9185984,TXFE7,128,9935,1,24901,13469,12408
9185992,9185990,TXFE7,128,9935,6,24907,13470,12414
9185992,9185991,TXFE7,128,9935,1,24908,13471,12415
9190017,9190008,TXFE7,128,9935,1,24909,13472,12416
9190017,9190011,TXFE7,128,9935,1,24910,13473,12417
9190029,9190020,TXFE7,128,9935,1,24911,13474,12418
9190029,9190028,TXFE7,128,9935,1,24912,13475,12419
9190042,9190030,TXFE7,128,9935,4,24916,13476,12420
9190042,9190030,TXFE7,128,9935,1,24917,13477,12421
9190054,9190046,TXFE7,128,9935,1,24918,13478,12422
9190054,9190050,TXFE7,128,9935,1,24919,13479,12423
9190054,9190052,TXFE7,129,9935,1,24923,13480,12426
9190054,9190052,TXFE7,129,9936,3,24923,13480,12426
9190067,9190056,TXFE7,128,9936,3,24926,13481,12428
9190067,9190059,TXFE7,128,9935,1,24927,13482,12429
9190067,9190062,TXFE7,129,9935,3,24936,13483,12435
9190067,9190062,TXFE7,129,9936,6,24936,13483,12435
9190067,9190064,TXFE7,128,9936,3,24939,13484,12438
9190067,9190066,TXFE7,128,9936,9,24948,13485,12444
9190079,9190067,TXFE7,128,9936,3,24951,13486,12445
9190079,9190074,TXFE7,128,9936,1,24952,13487,12446
9190117,9190108,TXFE7,128,9936,4,24956,13488,12447
9190154,9190147,TXFE7,128,9936,1,24957,13489,12448
9190154,9190150,TXFE7,128,9936,1,24958,13490,12449
9190192,9190180,TXFE7,128,9936,1,24959,13491,12450
9190204,9190201,TXFE7,128,9936,1,24960,13492,12451
9190204,9190202,TXFE7,128,9935,1,24961,13493,12452
9190217,9190205,TXFE7,128,9935,2,24963,13495,12453
9190217,9190207,TXFE7,128,9936,10,24973,13496,12462
9190217,9190207,TXFE7,128,9935,1,24974,13497,12463
9190242,9190234,TXFE7,128,9935,1,24975,13498,12464
9190242,9190235,TXFE7,128,9935,1,24976,13499,12465
9190242,9190239,TXFE7,128,9935,1,24977,13500,12466
9190254,9190249,TXFE7,128,9936,1,24978,13501,12467
9190267,9190258,TXFE7,128,9935,1,24979,13502,12468
9190267,9190265,TXFE7,129,9935,1,24981,13503,12470
9190267,9190265,TXFE7,129,9936,1,24981,13503,12470
9190304,9190293,TXFE7,128,9936,19,25000,13504,12479
9190329,9190318,TXFE7,128,9936,1,25001,13505,12480
9190354,9190342,TXFE7,128,9935,3,25004,13507,12481
9190354,9190343,TXFE7,129,9935,2,25023,13508,12494
9190354,9190343,TXFE7,129,9936,17,25023,13508,12494
9190354,9190343,TXFE7,128,9935,5,25028,13511,12495
9190354,9190347,TXFE7,128,9936,1,25029,13512,12496
9190354,9190350,TXFE7,128,9935,1,25030,13513,12497
9190367,9190357,TXFE7,128,9936,1,25031,13514,12498
9190379,9190368,TXFE7,128,9936,2,25033,13515,12500
9190379,9190375,TXFE7,128,9936,1,25034,13516,12501
9190417,9190410,TXFE7,128,9935,1,25035,13517,12502
9190442,9190436,TXFE7,128,9935,1,25036,13518,12503
9190454,9190447,TXFE7,128,9934,1,25037,13519,12504
9190467,9190459,TXFE7,128,9934,1,25038,13520,12505
9190479,9190470,TXFE7,128,9935,1,25039,13521,12506
9190479,9190472,TXFE7,128,9934,1,25040,13522,12507
9190479,9190478,TXFE7,128,9935,1,25041,13523,12508
9190517,9190513,TXFE7,128,9934,1,25042,13524,12509
9190529,9190520,TXFE7,128,9934,1,25043,13525,12510
9190542,9190537,TXFE7,128,9935,1,25044,13526,12511
9190542,9190539,TXFE7,128,9934,1,25045,13527,12512
9190567,9190557,TXFE7,128,9935,10,25055,13528,12519
9190579,9190568,TXFE7,128,9934,1,25056,13529,12520
9190579,9190573,TXFE7,128,9934,1,25057,13530,12521
9190579,9190576,TXFE7,128,9935,2,25059,13531,12522
9190604,9190602,TXFE7,128,9934,1,25060,13532,12523
9190667,9190666,TXFE7,128,9934,2,25062,13533,12524
9190679,9190673,TXFE7,128,9934,5,25067,13537,12525
9190742,9190730,TXFE7,128,9934,43,25110,13560,12526
9190742,9190736,TXFE7,128,9933,1,25111,13561,12527
9190754,9190747,TXFE7,128,9933,1,25112,13562,12528
9190767,9190761,TXFE7,128,9933,1,25113,13563,12529
9190804,9190800,TXFE7,128,9934,1,25114,13564,12530
9190829,9190827,TXFE7,128,9933,1,25115,13565,12531
9190842,9190837,TXFE7,128,9933,1,25116,13566,12532
9190929,9190918,TXFE7,128,9933,2,25118,13568,12533
9190954,9190947,TXFE7,128,9933,2,25120,13570,12534
9190979,9190971,TXFE7,128,9934,1,25121,13571,12535
9190979,9190977,TXFE7,128,9934,1,25122,13572,12536
9190992,9190986,TXFE7,128,9933,1,25123,13573,12537
9190992,9190988,TXFE7,128,9933,1,25124,13574,12538
9191004,9191003,TXFE7,128,9934,1,25125,13575,12539
9191054,9191048,TXFE7,128,9934,1,25126,13576,12540
9191067,9191057,TXFE7,128,9933,1,25127,13577,12541
9191079,9191071,TXFE7,128,9933,1,25128,13578,12542
9191229,9191219,TXFE7,128,9934,1,25129,13579,12543
9191304,9191301,TXFE7,128,9934,2,25131,13580,12544
9191392,9191386,TXFE7,128,9934,1,25132,13581,12545
9191454,9191444,TXFE7,128,9934,1,25133,13582,12546
9191504,9191499,TXFE7,128,9934,2,25135,13583,12548
9191629,9191621,TXFE7,128,9934,1,25136,13584,12549
9191692,9191683,TXFE7,128,9933,1,25137,13585,12550
9191692,9191690,TXFE7,128,9934,1,25138,13586,12551
9191704,9191703,TXFE7,128,9933,25,25163,13600,12552
9191729,9191717,TXFE7,128,9933,1,25164,13601,12553
9191767,9191758,TXFE7,128,9934,2,25166,13602,12555
9191817,9191808,TXFE7,128,9934,1,25167,13603,12556
9191829,9191821,TXFE7,128,9933,2,25169,13604,12557
9191892,9191889,TXFE7,128,9934,5,25174,13605,12561
9191917,9191905,TXFE7,128,9933,5,25179,13608,12562
9191929,9191926,TXFE7,128,9933,1,25180,13609,12563
9191992,9191991,TXFE7,128,9934,1,25181,13610,12564
9192029,9192017,TXFE7,128,9933,1,25182,13611,12565
9192067,9192059,TXFE7,128,9934,1,25183,13612,12566
9192079,9192068,TXFE7,128,9934,31,25214,13613,12583
9192117,9192112,TXFE7,128,9935,15,25229,13614,12591
9192129,9192125,TXFE7,128,9935,2,25231,13615,12592
9192142,9192134,TXFE7,128,9935,11,25242,13616,12600
9192179,9192179,TXFE7,128,9934,1,25243,13617,12601
9192217,9192214,TXFE7,128,9935,1,25244,13618,12602
9192354,9192344,TXFE7,128,9934,1,25245,13619,12603
9192492,9192489,TXFE7,128,9934,1,25246,13620,12604
9192592,9192581,TXFE7,128,9935,1,25247,13621,12605
9192642,9192635,TXFE7,128,9934,1,25248,13622,12606
9192829,9192828,TXFE7,128,9934,1,25249,13623,12607
9192942,9192939,TXFE7,128,9934,1,25250,13624,12608
9193042,9193037,TXFE7,128,9934,1,25251,13625,12609
9193079,9193071,TXFE7,128,9934,10,25261,13630,12610
9193092,9193079,TXFE7,128,9934,4,25265,13634,12611
9193092,9193084,TXFE7,128,9934,1,25266,13635,12612
9193104,9193092,TXFE7,128,9934,1,25267,13636,12613
9193104,9193096,TXFE7,128,9934,1,25268,13637,12614
9193129,9193117,TXFE7,128,9934,1,25269,13638,12615
9193142,9193130,TXFE7,128,9934,2,25271,13639,12617
9193154,9193144,TXFE7,128,9934,1,25272,13640,12618
9193154,9193147,TXFE7,128,9934,1,25273,13641,12619
9193167,9193161,TXFE7,128,9934,5,25278,13642,12622
9193279,9193273,TXFE7,128,9934,1,25288,13648,12628
9193292,9193285,TXFE7,128,9933,1,25289,13649,12629
9193354,9193351,TXFE7,128,9934,1,25290,13650,12630
9193404,9193399,TXFE7,128,9933,25,25315,13667,12631
9193417,9193414,TXFE7,128,9934,1,25316,13668,12632
9193492,9193485,TXFE7,128,9934,1,25317,13669,12633
9193529,9193524,TXFE7,128,9934,2,25319,13670,12635
9193529,9193525,TXFE7,128,9934,1,25320,13671,12636
9193567,9193562,TXFE7,128,9934,1,25321,13672,12637
9193617,9193606,TXFE7,128,9934,3,25324,13673,12640
9193704,9193692,TXFE7,128,9935,3,25327,13674,12642
9193704,9193698,TXFE7,128,9935,1,25328,13675,12643
9193704,9193698,TXFE7,128,9935,1,25329,13676,12644
9193742,9193740,TXFE7,128,9935,2,25331,13677,12646
9193767,9193758,TXFE7,128,9935,1,25332,13678,12647
9193792,9193782,TXFE7,128,9934,1,25333,13679,12648
9193804,9193799,TXFE7,128,9935,1,25334,13680,12649
9193804,9193802,TXFE7,128,9934,1,25335,13681,12650
9193817,9193810,TXFE7,128,9934,1,25336,13682,12651
9193829,9193827,TXFE7,128,9935,7,25343,13683,12655
9193967,9193955,TXFE7,128,9935,1,25344,13684,12656
9193967,9193956,TXFE7,128,9934,1,25345,13685,12657
9194167,9194161,TXFE7,128,9934,1,25346,13686,12658
9194292,9194288,TXFE7,128,9935,4,25350,13687,12659
9194342,9194341,TXFE7,128,9935,2,25352,13688,12661
9194367,9194357,TXFE7,128,9934,1,25353,13689,12662
9194517,9194508,TXFE7,128,9934,1,25354,13690,12663
9194579,9194568,TXFE7,128,9934,1,25355,13691,12664
9194592,9194584,TXFE7,128,9934,1,25356,13692,12665
9194617,9194608,TXFE7,128,9934,2,25358,13693,12666
9194629,9194622,TXFE7,128,9934,1,25359,13694,12667
9194642,9194633,TXFE7,128,9934,1,25360,13695,12668
9194667,9194667,TXFE7,128,9935,6,25366,13696,12671
9194779,9194773,TXFE7,128,9934,3,25369,13698,12672
9194829,9194817,TXFE7,128,9934,1,25370,13699,12673
9194892,9194882,TXFE7,128,9934,3,25373,13700,12674
9194917,9194908,TXFE7,128,9934,3,25376,13703,12675
9194917,9194910,TXFE7,128,9934,6,25382,13707,12676
9194929,9194919,TXFE7,128,9934,2,25384,13708,12677
9194954,9194943,TXFE7,128,9934,2,25386,13709,12678
9194967,9194955,TXFE7,128,9934,1,25387,13710,12679
9194979,9194970,TXFE7,128,9934,1,25388,13711,12680
9195004,9194996,TXFE7,128,9934,1,25389,13712,12681
9195029,9195018,TXFE7,128,9935,1,25390,13713,12682
9195029,9195020,TXFE7,128,9934,1,25391,13714,12683
9195104,9195100,TXFE7,128,9934,1,25392,13715,12684
9195117,9195113,TXFE7,128,9933,1,25393,13716,12685
9195129,9195127,TXFE7,128,9934,1,25394,13717,12686
9195154,9195144,TXFE7,128,9934,1,25395,13718,12687
9195154,9195150,TXFE7,128,9934,1,25396,13719,12688
9195217,9195211,TXFE7,128,9934,1,25397,13720,12689
9195304,9195299,TXFE7,128,9935,5,25402,13721,12693
9195379,9195367,TXFE7,128,9934,1,25403,13722,12694
9195392,9195388,TXFE7,128,9934,1,25404,13723,12695
9195429,9195427,TXFE7,128,9934,4,25408,13724,12696
9195504,9195494,TXFE7,128,9934,1,25409,13725,12697
9195554,9195544,TXFE7,128,9935,1,25410,13726,12698
9195592,9195584,TXFE7,128,9934,3,25413,13728,12699
9195629,9195626,TXFE7,128,9935,1,25414,13729,12700
9195692,9195684,TXFE7,128,9934,1,25415,13730,12701
9195704,9195696,TXFE7,128,9935,10,25425,13731,12711
9195742,9195729,TXFE7,128,9934,1,25426,13732,12712
9195779,9195771,TXFE7,128,9935,2,25428,13733,12713
9195792,9195782,TXFE7,128,9935,1,25429,13734,12714
9195829,9195824,TXFE7,128,9934,1,25430,13735,12715
9195867,9195857,TXFE7,128,9934,1,25431,13736,12716
9195867,9195860,TXFE7,128,9934,1,25432,13737,12717
9195917,9195911,TXFE7,128,9934,2,25434,13738,12718
9200017,9200011,TXFE7,128,9935,10,25444,13739,12725
9200029,9200022,TXFE7,128,9935,1,25445,13740,12726
9200029,9200028,TXFE7,128,9935,1,25446,13741,12727
9200042,9200039,TXFE7,128,9935,8,25454,13742,12731
9200042,9200040,TXFE7,128,9934,3,25457,13744,12732
9200042,9200042,TXFE7,128,9935,1,25458,13745,12733
9200054,9200043,TXFE7,128,9934,2,25460,13747,12734
9200054,9200050,TXFE7,128,9935,6,25466,13748,12738
9200067,9200055,TXFE7,128,9935,1,25467,13749,12739
9200067,9200060,TXFE7,128,9934,7,25474,13753,12740
9200079,9200075,TXFE7,128,9935,1,25475,13754,12741
9200079,9200076,TXFE7,128,9935,1,25476,13755,12742
9200092,9200080,TXFE7,128,9934,1,25477,13756,12743
9200092,9200082,TXFE7,128,9935,1,25478,13757,12744
9200092,9200090,TXFE7,128,9935,2,25480,13758,12746
9200104,9200092,TXFE7,128,9935,3,25483,13759,12749
9200104,9200094,TXFE7,128,9935,10,25493,13760,12755
9200117,9200104,TXFE7,128,9935,3,25496,13761,12758
9200117,9200104,TXFE7,128,9935,60,25556,13762,12769
9200117,9200105,TXFE7,128,9936,1,25557,13763,12770
9200129,9200117,TXFE7,128,9936,7,25564,13764,12777
9200129,9200118,TXFE7,128,9936,2,25566,13765,12779
9200129,9200120,TXFE7,128,9936,1,25567,13766,12780
9200129,9200121,TXFE7,128,9936,1,25568,13767,12781
9200129,9200124,TXFE7,128,9936,9,25577,13768,12784
9200129,9200125,TXFE7,128,9936,3,25580,13769,12785
9200129,9200125,TXFE7,128,9935,2,25582,13770,12786
9200142,9200129,TXFE7,128,9936,1,25583,13771,12787
9200142,9200129,TXFE7,128,9936,2,25585,13772,12789
9200142,9200137,TXFE7,128,9936,3,25588,13773,12791
9200142,9200137,TXFE7,128,9936,15,25603,13774,12795
9200142,9200139,TXFE7,128,9935,1,25604,13775,12796
9200142,9200139,TXFE7,128,9936,5,25609,13776,12799
9200154,9200142,TXFE7,128,9936,1,25610,13777,12800
9200154,9200142,TXFE7,128,9936,1,25611,13778,12801
9200154,9200143,TXFE7,128,9936,1,25612,13779,12802
9200154,9200143,TXFE7,128,9936,4,25616,13780,12806
9200154,9200143,TXFE7,128,9936,2,25618,13781,12807
9200154,9200143,TXFE7,128,9936,1,25619,13782,12808
9200154,9200144,TXFE7,128,9936,2,25621,13783,12810
9200154,9200146,TXFE7,128,9936,4,25625,13784,12813
9200154,9200146,TXFE7,128,9936,2,25627,13785,12814
9200154,9200146,TXFE7,128,9936,1,25628,13786,12815
9200154,9200146,TXFE7,128,9936,2,25630,13787,12816
9200154,9200150,TXFE7,128,9936,10,25640,13788,12825
9200154,9200151,TXFE7,128,9936,2,25642,13789,12827
9200154,9200153,TXFE7,128,9936,3,25645,13790,12828
9200167,9200154,TXFE7,128,9936,2,25647,13791,12829
9200167,9200154,TXFE7,128,9936,1,25648,13792,12830
9200167,9200154,TXFE7,128,9936,2,25650,13793,12832
9200167,9200154,TXFE7,128,9936,3,25653,13794,12834
9200167,9200161,TXFE7,128,9937,9,25662,13795,12842
9200179,9200169,TXFE7,128,9937,16,25678,13796,12849
9200179,9200172,TXFE7,128,9937,3,25681,13797,12850
9200179,9200172,TXFE7,128,9937,2,25683,13798,12851
9200179,9200173,TXFE7,128,9937,10,25693,13799,12852
9200179,9200174,TXFE7,128,9937,1,25694,13800,12853
9200179,9200176,TXFE7,128,9936,3,25697,13802,12854
9200179,9200176,TXFE7,128,9936,1,25698,13803,12855
9200192,9200185,TXFE7,128,9937,2,25700,13804,12856
9200204,9200197,TXFE7,128,9937,1,25701,13805,12857
9200204,9200199,TXFE7,128,9937,3,25704,13806,12858
9200217,9200214,TXFE7,128,9936,1,25705,13807,12859
9200229,9200217,TXFE7,128,9936,1,25706,13808,12860
9200229,9200221,TXFE7,128,9936,1,25707,13809,12861
9200229,9200225,TXFE7,128,9937,4,25711,13810,12865
9200229,9200226,TXFE7,128,9937,1,25712,13811,12866
9200229,9200227,TXFE7,128,9936,1,25713,13812,12867
9200229,9200227,TXFE7,128,9936,3,25716,13813,12868
9200242,9200229,TXFE7,128,9936,1,25717,13814,12869
9200242,9200234,TXFE7,128,9936,1,25718,13815,12870
9200242,9200236,TXFE7,128,9936,1,25719,13816,12871
9200242,9200239,TXFE7,128,9936,5,25724,13817,12874
9200254,9200245,TXFE7,128,9935,1,25725,13818,12875
9200254,9200251,TXFE7,128,9936,1,25726,13819,12876
9200254,9200253,TXFE7,128,9936,3,25729,13820,12877
9200267,9200258,TXFE7,128,9936,4,25733,13821,12878
9200267,9200261,TXFE7,128,9936,1,25734,13822,12879
9200267,9200266,TXFE7,128,9936,1,25735,13823,12880
9200267,9200266,TXFE7,128,9935,4,25739,13824,12881
9200279,9200274,TXFE7,128,9936,1,25740,13825,12882
9200279,9200277,TXFE7,128,9936,1,25741,13826,12883
9200279,9200278,TXFE7,128,9936,2,25743,13827,12885
9200292,9200288,TXFE7,128,9936,1,25744,13828,12886
9200292,9200290,TXFE7,128,9936,1,25745,13829,12887
9200304,9200295,TXFE7,128,9937,1,25746,13830,12888
9200304,9200303,TXFE7,128,9936,1,25747,13831,12889
9200317,9200316,TXFE7,128,9937,8,25755,13832,12893
9200329,9200319,TXFE7,128,9937,1,25756,13833,12894
9200329,9200323,TXFE7,128,9937,3,25759,13834,12895
9200329,9200326,TXFE7,128,9937,1,25760,13835,12896
9200342,9200341,TXFE7,128,9937,1,25761,13836,12897
9200342,9200341,TXFE7,128,9937,2,25763,13837,12899
9200354,9200351,TXFE7,128,9937,1,25764,13838,12900
9200354,9200354,TXFE7,128,9936,1,25765,13839,12901
9200367,9200362,TXFE7,128,9936,1,25766,13840,12902
9200379,9200373,TXFE7,128,9937,1,25767,13841,12903
9200404,9200399,TXFE7,128,9936,1,25768,13842,12904
9200429,9200419,TXFE7,128,9937,1,25769,13843,12905
9200429,9200429,TXFE7,128,9936,8,25777,13847,12906
9200442,9200433,TXFE7,128,9936,5,25782,13848,12908
9200442,9200440,TXFE7,128,9935,2,25784,13849,12909
9200454,9200449,TXFE7,128,9936,1,25785,13850,12910
9200454,9200450,TXFE7,128,9935,1,25786,13851,12911
9200492,9200491,TXFE7,128,9936,5,25791,13852,12913
9200504,9200499,TXFE7,128,9936,1,25792,13853,12914
9200504,9200501,TXFE7,128,9936,1,25793,13854,12915
9200517,9200515,TXFE7,128,9935,2,25795,13855,12916
9200554,9200543,TXFE7,128,9936,1,25796,13856,12917
9200554,9200552,TXFE7,128,9936,1,25797,13857,12918
9200592,9200579,TXFE7,128,9935,4,25801,13860,12919
9200604,9200592,TXFE7,128,9935,2,25803,13862,12920
9200604,9200597,TXFE7,128,9934,1,25804,13863,12921
9200604,9200602,TXFE7,128,9936,1,25805,13864,12922
9200617,9200611,TXFE7,128,9936,1,25806,13865,12923
9200617,9200612,TXFE7,128,9936,1,25807,13866,12924
9200629,9200626,TXFE7,128,9935,1,25808,13867,12925
9200654,9200646,TXFE7,128,9935,2,25810,13868,12926
9200667,9200662,TXFE7,128,9936,1,25811,13869,12927
9200704,9200701,TXFE7,128,9935,1,25812,13870,12928
9200742,9200733,TXFE7,128,9936,1,25813,13871,12929
9200742,9200735,TXFE7,128,9935,1,25814,13872,12930
9200754,9200744,TXFE7,128,9936,2,25816,13873,12932
9200767,9200762,TXFE7,128,9935,1,25817,13874,12933
9200767,9200767,TXFE7,128,9936,1,25818,13875,12934
9200779,9200771,TXFE7,128,9935,2,25820,13876,12935
9200804,9200801,TXFE7,128,9935,1,25821,13877,12936
9200867,9200855,TXFE7,128,9935,9,25837,13884,12940
9200892,9200886,TXFE7,128,9935,1,25838,13885,12941
9200904,9200899,TXFE7,128,9935,1,25839,13886,12942
9200917,9200912,TXFE7,128,9935,1,25840,13887,12943
9200917,9200912,TXFE7,128,9934,1,25841,13888,12944
9200917,9200916,TXFE7,129,9935,8,25853,13889,12949
9200917,9200916,TXFE7,129,9936,4,25853,13889,12949
9200929,9200928,TXFE7,128,9936,2,25855,13890,12951
9200942,9200936,TXFE7,128,9936,2,25857,13891,12952
9200954,9200947,TXFE7,128,9935,3,25860,13893,12953
9200967,9200956,TXFE7,128,9936,5,25865,13894,12954
9200979,9200969,TXFE7,128,9936,1,25866,13895,12955
9200979,9200973,TXFE7,128,9934,3,25869,13898,12956
9201029,9201017,TXFE7,128,9936,1,25870,13899,12957
9201029,9201026,TXFE7,128,9936,1,25871,13900,12958
9201067,9201062,TXFE7,128,9936,1,25872,13901,12959
9201104,9201104,TXFE7,128,9936,2,25874,13902,12961
9201117,9201107,TXFE7,128,9936,2,25876,13903,12962
9201167,9201160,TXFE7,128,9936,1,25877,13904,12963
9201204,9201196,TXFE7,128,9936,1,25878,13905,12964
9201267,9201258,TXFE7,128,9935,1,25886,13910,12968
9201279,9201268,TXFE7,128,9935,2,25888,13912,12969
9201304,9201292,TXFE7,128,9935,21,25909,13919,12970
9201317,9201304,TXFE7,128,9935,2,25911,13920,12971
9201392,9201381,TXFE7,128,9934,3,25914,13922,12972
9201429,9201426,TXFE7,128,9935,1,25915,13923,12973
9201442,9201433,TXFE7,128,9934,2,25917,13924,12974
9201504,9201499,TXFE7,128,9935,5,25922,13925,12978
9201504,9201500,TXFE7,128,9934,1,25923,13926,12979
9201629,9201625,TXFE7,128,9935,1,25924,13927,12980
9201729,9201724,TXFE7,128,9935,1,25925,13928,12981
9201767,9201767,TXFE7,128,9934,5,25930,13932,12982
9201829,9201826,TXFE7,128,9934,2,25932,13934,12983
9201867,9201855,TXFE7,128,9934,3,25935,13937,12984
9201892,9201889,TXFE7,128,9934,1,25936,13938,12985
9201892,9201892,TXFE7,128,9935,1,25937,13939,12986
9201929,9201918,TXFE7,128,9934,1,25938,13940,12987
9201954,9201942,TXFE7,128,9934,1,25939,13941,12988
9201967,9201958,TXFE7,128,9934,1,25940,13942,12989
9201992,9201984,TXFE7,128,9934,1,25941,13943,12990
9201992,9201984,TXFE7,128,9934,1,25942,13944,12991
9202029,9202021,TXFE7,129,9934,6,25949,13950,12992
9202029,9202021,TXFE7,129,9933,1,25949,13950,12992
9202042,9202038,TXFE7,128,9933,1,25950,13951,12993
9202054,9202048,TXFE7,128,9934,1,25951,13952,12994
9202079,9202070,TXFE7,128,9934,1,25952,13953,12995
9202092,9202084,TXFE7,128,9934,1,25953,13954,12996
9202104,9202097,TXFE7,128,9934,2,25955,13955,12997
9202142,9202131,TXFE7,128,9934,1,25956,13956,12998
9202179,9202178,TXFE7,128,9934,5,25961,13957,12999
9202204,9202202,TXFE7,128,9934,1,25962,13958,13000
9202229,9202226,TXFE7,128,9934,1,25963,13959,13001
9202242,9202238,TXFE7,128,9934,2,25965,13960,13002
9202254,9202250,TXFE7,128,9933,2,25967,13961,13003
9202267,9202255,TXFE7,128,9934,2,25969,13962,13004
9202317,9202312,TXFE7,128,9933,1,25970,13963,13005
9202467,9202461,TXFE7,128,9934,1,25971,13964,13006
9202517,9202507,TXFE7,128,9933,1,25972,13965,13007
9202529,9202525,TXFE7,128,9933,1,25973,13966,13008
9202567,9202557,TXFE7,128,9933,53,26026,13996,13009
9202692,9202680,TXFE7,128,9933,1,26027,13997,13010
9202692,9202686,TXFE7,128,9932,5,26032,14000,13011
9202692,9202687,TXFE7,128,9932,1,26033,14001,13012
9202704,9202693,TXFE7,128,9933,2,26035,14002,13014
9202704,9202701,TXFE7,128,9932,3,26038,14003,13015
9202704,9202702,TXFE7,128,9932,1,26039,14004,13016
9202729,9202717,TXFE7,128,9932,2,26041,14006,13017
9202754,9202745,TXFE7,128,9932,1,26042,14007,13018
9202804,9202792,TXFE7,128,9932,21,26063,14013,13019
9202804,9202792,TXFE7,128,9932,35,26098,14033,13020
9202854,9202843,TXFE7,128,9931,1,26099,14034,13021
9202867,9202856,TXFE7,128,9931,1,26100,14035,13022
9202917,9202915,TXFE7,128,9931,25,26125,14046,13023
9202929,9202918,TXFE7,128,9931,1,26126,14047,13024
9202929,9202921,TXFE7,128,9931,8,26134,14052,13025
9202942,9202935,TXFE7,128,9931,1,26135,14053,13026
9202942,9202940,TXFE7,128,9931,2,26137,14054,13027
9203004,9202995,TXFE7,128,9931,6,26143,14058,13028
9203004,9203000,TXFE7,128,9931,1,26144,14059,13029
9203017,9203011,TXFE7,128,9932,1,26145,14060,13030
9203042,9203037,TXFE7,128,9931,1,26146,14061,13031
9203067,9203059,TXFE7,128,9931,1,26147,14062,13032
9203067,9203066,TXFE7,128,9931,1,26148,14063,13033
9203117,9203108,TXFE7,128,9931,1,26149,14064,13034
9203129,9203123,TXFE7,128,9931,1,26150,14065,13035
9203142,9203138,TXFE7,128,9932,1,26151,14066,13036
9203167,9203158,TXFE7,128,9931,1,26152,14067,13037
9203167,9203163,TXFE7,128,9931,1,26153,14068,13038
9203179,9203177,TXFE7,128,9932,1,26154,14069,13039
9203192,9203188,TXFE7,128,9931,10,26164,14072,13040
9203204,9203193,TXFE7,128,9931,1,26165,14073,13041
9203242,9203230,TXFE7,128,9931,2,26167,14074,13042
9203242,9203239,TXFE7,128,9931,1,26168,14075,13043
9203242,9203241,TXFE7,128,9931,1,26169,14076,13044
9203254,9203242,TXFE7,128,9931,1,26170,14077,13045
9203254,9203248,TXFE7,128,9931,1,26171,14078,13046
9203267,9203263,TXFE7,128,9931,1,26172,14079,13047
9203292,9203279,TXFE7,128,9931,1,26173,14080,13048
9203354,9203348,TXFE7,128,9932,2,26175,14081,13049
9203367,9203355,TXFE7,129,9931,9,26200,14089,13050
9203367,9203355,TXFE7,129,9930,16,26200,14089,13050
9203379,9203367,TXFE7,128,9931,1,26201,14090,13051
9203379,9203367,TXFE7,128,9931,1,26202,14091,13052
9203379,9203369,TXFE7,128,9931,1,26203,14092,13053
9203392,9203379,TXFE7,128,9931,1,26204,14093,13054
9203404,9203400,TXFE7,128,9931,1,26205,14094,13055
9203404,9203404,TXFE7,128,9930,2,26207,14096,13056
9203417,9203413,TXFE7,128,9931,1,26208,14097,13057
9203417,9203414,TXFE7,128,9931,1,26209,14098,13058
9203429,9203418,TXFE7,128,9931,1,26210,14099,13059
9203429,9203418,TXFE7,128,9931,1,26211,14100,13060
9203467,9203464,TXFE7,128,9931,1,26212,14101,13061
9203517,9203511,TXFE7,128,9931,1,26213,14102,13062
9203542,9203530,TXFE7,128,9931,1,26214,14103,13063
9203542,9203530,TXFE7,128,9931,1,26215,14104,13064
9203542,9203541,TXFE7,128,9931,2,26217,14105,13065
9203579,9203578,TXFE7,128,9931,2,26219,14106,13066
9203667,9203661,TXFE7,128,9931,1,26220,14107,13067
9203679,9203673,TXFE7,128,9931,1,26221,14108,13068
9203742,9203734,TXFE7,128,9932,18,26239,14109,13079
9203754,9203754,TXFE7,128,9933,1,26240,14110,13080
9203792,9203788,TXFE7,128,9933,1,26241,14111,13081
9203842,9203830,TXFE7,128,9933,1,26242,14112,13082
9203867,9203855,TXFE7,128,9932,2,26244,14114,13083
9203867,9203863,TXFE7,128,9932,3,26247,14116,13084
9203942,9203939,TXFE7,128,9932,2,26249,14117,13085
9203967,9203959,TXFE7,128,9933,1,26250,14118,13086
9204017,9204015,TXFE7,128,9932,1,26251,14119,13087
9204029,9204019,TXFE7,128,9932,1,26252,14120,13088
9204092,9204084,TXFE7,128,9933,1,26253,14121,13089
9204117,9204113,TXFE7,128,9932,1,26254,14122,13090
9204329,9204328,TXFE7,128,9932,2,26256,14123,13091
9204342,9204338,TXFE7,128,9932,1,26257,14124,13092
9204354,9204342,TXFE7,128,9932,1,26258,14125,13093
9204467,9204455,TXFE7,128,9932,1,26259,14126,13094
9204467,9204460,TXFE7,128,9932,1,26260,14127,13095
9204492,9204480,TXFE7,128,9932,7,26267,14128,13098
9204492,9204483,TXFE7,128,9931,1,26268,14129,13099
9204492,9204490,TXFE7,128,9931,1,26269,14130,13100
9204642,9204632,TXFE7,128,9932,2,26271,14131,13101
9204654,9204643,TXFE7,128,9932,1,26272,14132,13102
9204879,9204876,TXFE7,129,9932,3,26278,14138,13103
9204879,9204876,TXFE7,129,9931,3,26278,14138,13103
9204929,9204926,TXFE7,128,9932,1,26279,14139,13104
9205004,9204997,TXFE7,128,9932,1,26280,14140,13105
9205204,9205200,TXFE7,128,9932,1,26281,14141,13106
9205242,9205230,TXFE7,128,9932,1,26282,14142,13107
9205392,9205391,TXFE7,128,9931,5,26287,14146,13108
9205404,9205396,TXFE7,128,9932,1,26288,14147,13109
9205467,9205461,TXFE7,128,9931,1,26289,14148,13110
9205467,9205463,TXFE7,128,9932,3,26292,14149,13111
9205492,9205482,TXFE7,128,9932,1,26293,14150,13112
9205504,9205494,TXFE7,128,9931,1,26294,14151,13113
9205542,9205537,TXFE7,128,9931,5,26299,14156,13114
9205604,9205603,TXFE7,128,9931,1,26300,14157,13115
9205629,9205625,TXFE7,128,9931,5,26305,14158,13116
9205654,9205650,TXFE7,128,9931,6,26311,14161,13117
9205742,9205735,TXFE7,128,9931,1,26312,14162,13118
9205817,9205814,TXFE7,128,9931,5,26317,14167,13119
9205829,9205826,TXFE7,128,9932,1,26318,14168,13120
9205942,9205937,TXFE7,128,9931,1,26319,14169,13121
9210004,9205994,TXFE7,128,9931,1,26320,14170,13122
9210029,9210028,TXFE7,128,9931,1,26321,14171,13123
9210042,9210040,TXFE7,128,9932,1,26322,14172,13124
9210054,9210043,TXFE7,128,9931,4,26326,14175,13125
9210067,9210063,TXFE7,128,9931,2,26328,14177,13126
9210079,9210067,TXFE7,128,9931,1,26329,14178,13127
9210104,9210102,TXFE7,128,9930,1,26330,14179,13128
9210167,9210164,TXFE7,128,9931,2,26332,14180,13129
9210192,9210182,TXFE7,128,9931,1,26333,14181,13130
9210217,9210216,TXFE7,128,9932,2,26335,14182,13132
9210242,9210232,TXFE7,128,9932,37,26372,14183,13155
9210254,9210242,TXFE7,129,9932,1,26377,14186,13156
9210254,9210242,TXFE7,129,9931,4,26377,14186,13156
9210279,9210274,TXFE7,128,9932,1,26378,14187,13157
9210279,9210277,TXFE7,128,9932,1,26379,14188,13158
9210292,9210286,TXFE7,128,9932,2,26381,14190,13159
9210304,9210296,TXFE7,128,9932,1,26382,14191,13160
9210317,9210311,TXFE7,128,9932,1,26383,14192,13161
9210379,9210372,TXFE7,128,9932,1,26384,14193,13162
9210417,9210415,TXFE7,128,9932,1,26385,14194,13163
9210429,9210420,TXFE7,128,9932,1,26386,14195,13164
9210429,9210420,TXFE7,128,9932,1,26387,14196,13165
9210479,9210474,TXFE7,128,9933,1,26388,14197,13166
9210579,9210569,TXFE7,128,9933,2,26390,14198,13168
9210592,9210590,TXFE7,128,9932,1,26391,14199,13169
9210592,9210591,TXFE7,128,9932,1,26392,14200,13170
9210629,9210628,TXFE7,128,9932,1,26393,14201,13171
9210679,9210667,TXFE7,128,9933,2,26395,14202,13172
9210767,9210767,TXFE7,128,9932,1,26396,14203,13173
9210992,9210982,TXFE7,128,9932,4,26400,14205,13174
9211067,9211059,TXFE7,128,9932,1,26401,14206,13175
9211092,9211084,TXFE7,128,9932,1,26402,14207,13176
9211129,9211127,TXFE7,128,9932,2,26404,14208,13177
9211167,9211157,TXFE7,128,9932,1,26405,14209,13178
9211204,9211201,TXFE7,128,9932,10,26415,14216,13179
9211317,9211307,TXFE7,128,9932,2,26417,14217,13180
9211317,9211316,TXFE7,128,9932,5,26422,14218,13181
9211342,9211337,TXFE7,128,9931,1,26423,14219,13182
9211429,9211418,TXFE7,128,9931,1,26424,14220,13183
9211642,9211631,TXFE7,128,9931,1,26425,14221,13184
9211654,9211650,TXFE7,128,9931,2,26427,14223,13185
9211704,9211703,TXFE7,128,9932,1,26428,14224,13186
9211929,9211917,TXFE7,128,9931,6,26434,14228,13187
9211942,9211937,TXFE7,128,9931,3,26437,14230,13188
9211954,9211944,TXFE7,128,9932,1,26438,14231,13189
9212054,9212048,TXFE7,128,9931,1,26439,14232,13190
9212092,9212080,TXFE7,128,9931,1,26440,14233,13191
9212092,9212083,TXFE7,128,9931,1,26441,14234,13192
9212129,9212117,TXFE7,128,9932,49,26490,14235,13206
9212167,9212158,TXFE7,128,9932,1,26491,14236,13207
9212179,9212169,TXFE7,128,9932,3,26494,14238,13208
9212242,9212235,TXFE7,128,9933,1,26495,14239,13209
9212242,9212240,TXFE7,128,9932,1,26496,14240,13210
9212304,9212294,TXFE7,128,9933,2,26498,14241,13211
9212354,9212347,TXFE7,128,9932,1,26499,14242,13212
9212429,9212423,TXFE7,128,9932,2,26501,14243,13213
9212442,9212433,TXFE7,128,9933,1,26502,14244,13214
9212567,9212556,TXFE7,128,9933,2,26504,14245,13216
9212617,9212608,TXFE7,128,9932,1,26505,14246,13217
9212779,9212771,TXFE7,128,9932,1,26506,14247,13218
9212929,9212927,TXFE7,128,9932,1,26507,14248,13219
9213142,9213135,TXFE7,128,9933,1,26508,14249,13220
9213154,9213150,TXFE7,128,9932,1,26509,14250,13221
9213267,9213257,TXFE7,128,9933,1,26510,14251,13222
9213267,9213262,TXFE7,128,9932,1,26511,14252,13223
9213392,9213389,TXFE7,128,9932,3,26514,14254,13224
9213442,9213441,TXFE7,128,9932,1,26515,14255,13225
9213517,9213513,TXFE7,128,9933,1,26516,14256,13226
9213529,9213524,TXFE7,128,9933,1,26517,14257,13227
9213592,9213588,TXFE7,128,9933,5,26522,14258,13228
9213717,9213714,TXFE7,128,9932,2,26524,14260,13229
9213842,9213838,TXFE7,128,9933,1,26525,14261,13230
9214017,9214010,TXFE7,128,9932,5,26530,14266,13231
9214104,9214104,TXFE7,128,9933,1,26531,14267,13232
9214142,9214140,TXFE7,128,9933,3,26534,14268,13233
9214154,9214146,TXFE7,128,9932,1,26535,14269,13234
9214417,9214409,TXFE7,128,9932,1,26536,14270,13235
9214629,9214625,TXFE7,128,9932,1,26537,14271,13236
9214817,9214815,TXFE7,128,9932,2,26539,14273,13237
9214854,9214851,TXFE7,128,9933,1,26540,14274,13238
9214854,9214854,TXFE7,128,9932,1,26541,14275,13239
9214867,9214857,TXFE7,128,9932,1,26542,14276,13240
9214904,9214903,TXFE7,128,9932,5,26547,14280,13241
9214917,9214905,TXFE7,128,9932,1,26548,14281,13242
9214917,9214906,TXFE7,128,9932,1,26549,14282,13243
9214929,9214917,TXFE7,128,9932,2,26551,14283,13244
9215242,9215239,TXFE7,128,9933,1,26552,14284,13245
9215392,9215388,TXFE7,128,9932,1,26553,14285,13246
9215392,9215391,TXFE7,128,9932,1,26554,14286,13247
9215454,9215453,TXFE7,128,9932,3,26557,14288,13248
9215592,9215590,TXFE7,128,9932,1,26558,14289,13249
9215617,9215614,TXFE7,128,9932,1,26559,14290,13250
9215704,9215693,TXFE7,128,9932,1,26560,14291,13251
9215867,9215855,TXFE7,128,9933,100,26660,14292,13276
9215867,9215855,TXFE7,128,9933,2,26662,14293,13277
9215867,9215855,TXFE7,128,9933,26,26688,14294,13280
9215867,9215861,TXFE7,128,9933,5,26693,14295,13281
9215879,9215867,TXFE7,128,9933,8,26701,14296,13286
9215879,9215867,TXFE7,129,9933,1,26704,14299,13287
9215879,9215867,TXFE7,129,9932,2,26704,14299,13287
9215879,9215867,TXFE7,128,9934,5,26709,14300,13289
9215879,9215867,TXFE7,128,9934,8,26717,14301,13294
9215879,9215867,TXFE7,128,9934,10,26727,14302,13300
9215879,9215867,TXFE7,128,9934,1,26728,14303,13301
9215879,9215871,TXFE7,128,9934,1,26729,14304,13302
9215892,9215879,TXFE7,128,9934,7,26736,14305,13308
9215892,9215880,TXFE7,128,9935,4,26740,14306,13309
9215904,9215892,TXFE7,128,9935,1,26741,14307,13310
9215904,9215893,TXFE7,128,9935,1,26742,14308,13311
9215904,9215894,TXFE7,128,9934,1,26743,14309,13312
9215904,9215903,TXFE7,128,9935,6,26749,14310,13316
9215929,9215918,TXFE7,128,9934,1,26750,14311,13317
9215929,9215925,TXFE7,128,9935,2,26752,14312,13318
9215954,9215943,TXFE7,128,9934,1,26753,14313,13319
9215954,9215952,TXFE7,128,9935,1,26754,14314,13320
9220004,9215999,TXFE7,128,9935,1,26755,14315,13321
9220004,9220002,TXFE7,128,9935,1,26756,14316,13322
9220004,9220003,TXFE7,128,9934,1,26757,14317,13323
9220004,9220003,TXFE7,128,9934,4,26761,14319,13324
9220017,9220010,TXFE7,128,9934,1,26762,14320,13325
9220042,9220041,TXFE7,128,9934,4,26766,14321,13326
9220067,9220059,TXFE7,128,9934,1,26767,14322,13327
9220167,9220166,TXFE7,128,9935,1,26768,14323,13328
9220279,9220272,TXFE7,128,9935,1,26769,14324,13329
9220329,9220323,TXFE7,128,9934,1,26770,14325,13330
9220442,9220432,TXFE7,128,9935,1,26771,14326,13331
9220504,9220493,TXFE7,128,9935,1,26772,14327,13332
9220554,9220549,TXFE7,128,9935,1,26773,14328,13333
9220629,9220628,TXFE7,128,9935,1,26774,14329,13334
9220692,9220682,TXFE7,128,9935,1,26775,14330,13335
9220692,9220688,TXFE7,128,9934,1,26776,14331,13336
9220717,9220708,TXFE7,128,9935,20,26796,14332,13348
9220729,9220717,TXFE7,128,9935,4,26800,14333,13352
9220779,9220775,TXFE7,128,9935,1,26801,14334,13353
9220792,9220787,TXFE7,128,9935,5,26806,14335,13358
9220804,9220792,TXFE7,128,9935,1,26807,14336,13359
9220817,9220805,TXFE7,128,9935,1,26808,14337,13360
9220829,9220818,TXFE7,128,9935,1,26809,14338,13361
9220842,9220831,TXFE7,128,9935,2,26811,14339,13362
9220842,9220835,TXFE7,128,9935,1,26812,14340,13363
9220842,9220839,TXFE7,128,9935,5,26817,14341,13367
9220842,9220839,TXFE7,128,9935,5,26822,14342,13372
9220867,9220863,TXFE7,128,9936,1,26823,14343,13373
9220879,9220879,TXFE7,128,9935,1,26824,14344,13374
9220904,9220892,TXFE7,128,9936,5,26829,14345,13378
9220904,9220896,TXFE7,128,9936,1,26830,14346,13379
9220904,9220902,TXFE7,128,9936,4,26834,14347,13382
9220929,9220917,TXFE7,128,9935,2,26836,14349,13383
9220942,9220931,TXFE7,128,9936,2,26838,14350,13385
9220942,9220940,TXFE7,128,9936,2,26840,14351,13386
9220967,9220955,TXFE7,128,9936,1,26841,14352,13387
9220979,9220969,TXFE7,128,9936,1,26842,14353,13388
9221042,9221038,TXFE7,128,9936,1,26843,14354,13389
9221079,9221070,TXFE7,128,9936,2,26845,14355,13390
9221079,9221076,TXFE7,128,9935,1,26846,14356,13391
9221104,9221096,TXFE7,128,9935,1,26847,14357,13392
9221104,9221102,TXFE7,128,9935,1,26848,14358,13393
9221192,9221181,TXFE7,128,9936,1,26849,14359,13394
9221192,9221189,TXFE7,128,9936,3,26852,14360,13395
9221192,9221191,TXFE7,128,9936,1,26853,14361,13396
9221267,9221258,TXFE7,128,9935,1,26854,14362,13397
9221279,9221278,TXFE7,128,9936,1,26855,14363,13398
9221329,9221324,TXFE7,128,9936,1,26856,14364,13399
9221329,9221327,TXFE7,128,9935,1,26857,14365,13400
9221354,9221354,TXFE7,128,9935,2,26859,14366,13401
9221404,9221393,TXFE7,128,9935,1,26860,14367,13402
9221404,9221402,TXFE7,128,9935,2,26862,14368,13403
9221417,9221407,TXFE7,128,9936,1,26863,14369,13404
9221429,9221421,TXFE7,128,9936,1,26864,14370,13405
9221492,9221487,TXFE7,128,9935,1,26865,14371,13406
9221517,9221506,TXFE7,128,9936,2,26867,14372,13408
9221517,9221516,TXFE7,128,9935,1,26868,14373,13409
9221542,9221533,TXFE7,128,9936,1,26869,14374,13410
9221592,9221591,TXFE7,128,9936,1,26870,14375,13411
9221604,9221604,TXFE7,128,9936,1,26871,14376,13412
9221617,9221606,TXFE7,128,9935,1,26872,14377,13413
9221667,9221656,TXFE7,128,9935,1,26873,14378,13414
9221667,9221658,TXFE7,128,9935,1,26874,14379,13415
9221679,9221677,TXFE7,128,9935,1,26875,14380,13416
9221704,9221694,TXFE7,128,9936,1,26876,14381,13417
9221742,9221735,TXFE7,128,9935,1,26877,14382,13418
9221767,9221759,TXFE7,128,9936,1,26878,14383,13419
9221767,9221764,TXFE7,128,9936,1,26879,14384,13420
9221779,9221768,TXFE7,128,9935,1,26880,14385,13421
9221792,9221780,TXFE7,128,9936,1,26881,14386,13422
9221804,9221802,TXFE7,128,9935,1,26882,14387,13423
9221817,9221809,TXFE7,128,9936,1,26883,14388,13424
9221842,9221832,TXFE7,128,9936,1,26884,14389,13425
9221854,9221845,TXFE7,128,9935,7,26891,14394,13426
9221879,9221870,TXFE7,128,9935,1,26892,14395,13427
9221892,9221889,TXFE7,128,9935,1,26893,14396,13428
9221929,9221918,TXFE7,128,9936,2,26895,14397,13429
9221929,9221920,TXFE7,128,9935,1,26896,14398,13430
9221942,9221930,TXFE7,128,9936,1,26897,14399,13431
9221992,9221991,TXFE7,128,9935,1,26898,14400,13432
9222092,9222082,TXFE7,128,9935,1,26899,14401,13433
9222092,9222089,TXFE7,128,9936,1,26900,14402,13434
9222104,9222093,TXFE7,128,9936,1,26901,14403,13435
9222104,9222096,TXFE7,128,9935,4,26905,14407,13436
9222104,9222100,TXFE7,128,9936,1,26906,14408,13437
9222104,9222102,TXFE7,128,9935,1,26907,14409,13438
9222117,9222105,TXFE7,128,9935,1,26908,14410,13439
9222142,9222136,TXFE7,128,9935,1,26909,14411,13440
9222154,9222150,TXFE7,128,9935,1,26910,14412,13441
9222179,9222171,TXFE7,128,9935,6,26916,14413,13446
9222204,9222194,TXFE7,128,9934,1,26917,14414,13447
9222204,9222201,TXFE7,128,9935,1,26918,14415,13448
9222217,9222209,TXFE7,128,9935,1,26919,14416,13449
9222329,9222317,TXFE7,128,9935,1,26920,14417,13450
9222329,9222317,TXFE7,128,9935,1,26921,14418,13451
9222329,9222318,TXFE7,128,9935,1,26922,14419,13452
9222342,9222337,TXFE7,128,9935,1,26923,14420,13453
9222442,9222431,TXFE7,128,9935,1,26924,14421,13454
9222454,9222445,TXFE7,128,9935,1,26925,14422,13455
9222454,9222451,TXFE7,128,9935,2,26927,14423,13456
9222567,9222564,TXFE7,128,9935,1,26928,14424,13457
9222579,9222567,TXFE7,128,9935,25,26953,14425,13470
9222592,9222579,TXFE7,128,9935,1,26954,14426,13471
9222592,9222584,TXFE7,128,9935,1,26955,14427,13472
9222654,9222646,TXFE7,128,9935,1,26956,14428,13473
9222667,9222654,TXFE7,128,9935,1,26957,14429,13474
9222692,9222688,TXFE7,128,9935,1,26958,14430,13475
9222742,9222740,TXFE7,128,9935,1,26959,14431,13476
9222804,9222793,TXFE7,128,9935,1,26960,14432,13477
9222829,9222825,TXFE7,128,9935,2,26962,14433,13478
9222854,9222847,TXFE7,128,9934,1,26963,14434,13479
9222854,9222852,TXFE7,128,9935,1,26964,14435,13480
9222867,9222858,TXFE7,128,9934,1,26965,14436,13481
9222904,9222896,TXFE7,128,9934,2,26967,14438,13482
9222992,9222984,TXFE7,128,9934,1,26968,14439,13483
9223104,9223103,TXFE7,128,9935,1,26969,14440,13484
9223142,9223139,TXFE7,128,9935,1,26970,14441,13485
9223154,9223154,TXFE7,128,9934,1,26971,14442,13486
9223204,9223203,TXFE7,128,9934,4,26975,14444,13487
9223292,9223285,TXFE7,128,9934,2,26977,14445,13488
9223292,9223286,TXFE7,128,9935,2,26979,14446,13489
9223367,9223358,TXFE7,128,9935,3,26982,14447,13490
9223379,9223373,TXFE7,128,9935,3,26985,14448,13491
9223404,9223394,TXFE7,128,9935,19,27004,14449,13509
9223504,9223498,TXFE7,128,9935,1,27005,14450,13510
9223629,9223627,TXFE7,128,9935,1,27006,14451,13511
9223629,9223628,TXFE7,128,9935,1,27007,14452,13512
9223642,9223632,TXFE7,128,9935,1,27008,14453,13513
9223779,9223772,TXFE7,128,9935,1,27009,14454,13514
9223792,9223791,TXFE7,128,9936,5,27014,14455,13515
9223804,9223799,TXFE7,128,9935,2,27016,14456,13516
9223854,9223844,TXFE7,128,9935,1,27017,14457,13517
9223879,9223873,TXFE7,128,9935,2,27019,14458,13518
9223967,9223963,TXFE7,128,9935,1,27020,14459,13519
9223979,9223968,TXFE7,128,9936,2,27022,14460,13520
9223979,9223975,TXFE7,128,9935,3,27025,14462,13521
9224004,9224003,TXFE7,128,9935,1,27026,14463,13522
9224017,9224009,TXFE7,128,9936,2,27028,14464,13523
9224029,9224029,TXFE7,128,9935,1,27029,14465,13524
9224054,9224048,TXFE7,128,9936,1,27030,14466,13525
9224067,9224055,TXFE7,128,9936,65,27095,14467,13567
9224067,9224066,TXFE7,128,9936,1,27096,14468,13568
9224079,9224067,TXFE7,128,9936,1,27097,14469,13569
9224154,9224142,TXFE7,128,9936,1,27098,14470,13570
9224179,9224170,TXFE7,128,9936,1,27099,14471,13571
9224192,9224180,TXFE7,128,9935,2,27101,14472,13572
9224192,9224190,TXFE7,128,9936,1,27102,14473,13573
9224242,9224238,TXFE7,128,9935,3,27105,14476,13574
9224267,9224257,TXFE7,128,9935,1,27106,14477,13575
9224342,9224331,TXFE7,128,9935,3,27109,14478,13576
9224504,9224503,TXFE7,128,9936,1,27110,14479,13577
9224554,9224547,TXFE7,128,9936,1,27111,14480,13578
9224592,9224591,TXFE7,128,9936,1,27112,14481,13579
9224629,9224627,TXFE7,128,9935,1,27113,14482,13580
9224754,9224747,TXFE7,128,9935,8,27121,14483,13581
9224754,9224747,TXFE7,128,9935,5,27126,14487,13582
9224767,9224757,TXFE7,128,9935,2,27128,14489,13583
9224779,9224767,TXFE7,128,9935,1,27129,14490,13584
9224779,9224767,TXFE7,128,9935,7,27136,14497,13585
9224779,9224770,TXFE7,128,9936,5,27141,14498,13588
9224779,9224770,TXFE7,128,9934,1,27142,14499,13589
9224792,9224780,TXFE7,128,9935,5,27147,14500,13592
9224817,9224816,TXFE7,128,9935,1,27148,14501,13593
9224829,9224822,TXFE7,128,9934,2,27150,14503,13594
9224854,9224848,TXFE7,128,9934,1,27151,14504,13595
9224917,9224911,TXFE7,128,9935,2,27153,14505,13596
9224979,9224969,TXFE7,128,9935,1,27154,14506,13597
9224992,9224987,TXFE7,128,9934,2,27156,14508,13598
9225029,9225018,TXFE7,128,9935,1,27157,14509,13599
9225104,9225092,TXFE7,128,9935,1,27158,14510,13600
9225142,9225141,TXFE7,128,9935,1,27159,14511,13601
9225192,9225188,TXFE7,128,9934,10,27169,14516,13602
9225242,9225234,TXFE7,128,9934,19,27188,14526,13603
9225354,9225342,TXFE7,128,9933,4,27192,14527,13604
9225367,9225363,TXFE7,128,9934,1,27193,14528,13605
9225379,9225373,TXFE7,128,9933,2,27195,14529,13606
9225392,9225386,TXFE7,128,9933,1,27196,14530,13607
9225392,9225391,TXFE7,128,9934,1,27197,14531,13608
9225442,9225431,TXFE7,128,9933,1,27198,14532,13609
9225479,9225476,TXFE7,128,9933,3,27201,14535,13610
9225504,9225502,TXFE7,128,9934,1,27202,14536,13611
9225542,9225541,TXFE7,128,9934,1,27203,14537,13612
9225567,9225559,TXFE7,128,9933,1,27204,14538,13613
9225742,9225740,TXFE7,128,9933,1,27205,14539,13614
9225779,9225774,TXFE7,128,9934,1,27206,14540,13615
9225817,9225815,TXFE7,128,9933,1,27207,14541,13616
9225829,9225823,TXFE7,128,9933,1,27208,14542,13617
9225992,9225985,TXFE7,128,9933,1,27209,14543,13618
9230004,9230003,TXFE7,128,9933,1,27210,14544,13619
9230029,9230017,TXFE7,128,9933,1,27211,14545,13620
9230042,9230036,TXFE7,128,9933,1,27212,14546,13621
9230054,9230048,TXFE7,128,9934,1,27213,14547,13622
9230092,9230084,TXFE7,128,9933,1,27214,14548,13623
9230092,9230086,TXFE7,128,9932,1,27215,14549,13624
9230104,9230104,TXFE7,128,9933,1,27216,14550,13625
9230154,9230151,TXFE7,128,9932,1,27217,14551,13626
9230217,9230210,TXFE7,128,9933,2,27219,14552,13628
9230254,9230244,TXFE7,128,9932,1,27220,14553,13629
9230304,9230300,TXFE7,128,9933,1,27221,14554,13630
9230304,9230303,TXFE7,128,9933,2,27223,14555,13631
9230554,9230543,TXFE7,128,9932,1,27224,14556,13632
9230679,9230677,TXFE7,128,9932,1,27225,14557,13633
9230854,9230844,TXFE7,128,9933,1,27226,14558,13634
9230879,9230878,TXFE7,128,9932,5,27231,14560,13635
9230904,9230892,TXFE7,128,9933,2,27233,14561,13636
9231017,9231008,TXFE7,128,9933,1,27234,14562,13637
9231142,9231135,TXFE7,128,9933,1,27235,14563,13638
9231217,9231208,TXFE7,128,9933,1,27236,14564,13639
9231229,9231225,TXFE7,128,9932,2,27238,14565,13640
9231317,9231306,TXFE7,128,9932,1,27239,14566,13641
9231354,9231342,TXFE7,128,9933,1,27240,14567,13642
9231817,9231812,TXFE7,128,9932,1,27241,14568,13643
9231829,9231826,TXFE7,128,9932,1,27242,14569,13644
9231842,9231842,TXFE7,128,9932,1,27243,14570,13645
9231854,9231849,TXFE7,128,9932,1,27244,14571,13646
9231867,9231855,TXFE7,128,9932,1,27245,14572,13647
9231879,9231869,TXFE7,128,9932,1,27246,14573,13648
9231879,9231878,TXFE7,128,9932,11,27257,14581,13649
9231892,9231879,TXFE7,128,9932,8,27265,14589,13650
9231892,9231880,TXFE7,128,9932,6,27271,14593,13651
9231904,9231896,TXFE7,128,9932,1,27272,14594,13652
9231954,9231954,TXFE7,128,9932,1,27273,14595,13653
9231979,9231970,TXFE7,128,9931,1,27274,14596,13654
9231979,9231976,TXFE7,128,9931,3,27277,14599,13655
9232067,9232057,TXFE7,128,9932,5,27282,14600,13657
9232067,9232064,TXFE7,128,9931,2,27284,14602,13658
9232067,9232067,TXFE7,128,9931,1,27285,14603,13659
9232092,9232087,TXFE7,128,9931,2,27287,14604,13660
9232142,9232131,TXFE7,128,9931,1,27288,14605,13661
9232217,9232209,TXFE7,128,9931,1,27289,14606,13662
9232304,9232294,TXFE7,128,9931,2,27291,14608,13663
9232404,9232395,TXFE7,128,9931,1,27292,14609,13664
9232529,9232528,TXFE7,128,9931,3,27295,14610,13665
9232617,9232605,TXFE7,128,9932,1,27296,14611,13666
9232617,9232605,TXFE7,128,9931,1,27297,14612,13667
9232679,9232671,TXFE7,128,9932,1,27298,14613,13668
9232754,9232748,TXFE7,128,9932,1,27299,14614,13669
9232829,9232822,TXFE7,128,9932,1,27300,14615,13670
9232854,9232844,TXFE7,128,9931,1,27301,14616,13671
9233042,9233031,TXFE7,128,9931,1,27302,14617,13672
9233067,9233054,TXFE7,128,9932,1,27303,14618,13673
9233104,9233104,TXFE7,128,9932,1,27304,14619,13674
9233292,9233283,TXFE7,128,9932,1,27305,14620,13675
9233304,9233303,TXFE7,128,9931,1,27306,14621,13676
9233417,9233406,TXFE7,128,9931,1,27307,14622,13677
9233542,9233536,TXFE7,128,9932,5,27312,14623,13682
9233554,9233550,TXFE7,128,9931,3,27315,14626,13683
9233567,9233556,TXFE7,128,9931,5,27320,14630,13684
9233592,9233581,TXFE7,128,9932,1,27321,14631,13685
9233679,9233678,TXFE7,128,9931,1,27322,14632,13686
9233729,9233725,TXFE7,128,9931,1,27323,14633,13687
9233754,9233751,TXFE7,128,9932,1,27324,14634,13688
9233867,9233857,TXFE7,128,9931,1,27325,14635,13689
9233954,9233945,TXFE7,128,9932,1,27326,14636,13690
9233954,9233946,TXFE7,128,9932,2,27328,14637,13692
9233954,9233952,TXFE7,128,9932,1,27329,14638,13693
9233979,9233973,TXFE7,128,9932,1,27330,14639,13694
9233992,9233989,TXFE7,128,9931,1,27331,14640,13695
9234042,9234033,TXFE7,128,9932,1,27332,14641,13696
9234167,9234163,TXFE7,128,9932,2,27334,14642,13698
9234204,9234203,TXFE7,128,9932,1,27335,14643,13699
9234392,9234385,TXFE7,128,9932,1,27336,14644,13700
9234429,9234426,TXFE7,128,9932,1,27337,14645,13701
9234429,9234426,TXFE7,128,9932,4,27341,14646,13703
9234467,9234465,TXFE7,128,9931,5,27346,14647,13704
9234542,9234539,TXFE7,128,9931,1,27347,14648,13705
9234704,9234698,TXFE7,128,9932,1,27348,14649,13706
9234779,9234772,TXFE7,128,9931,1,27349,14650,13707
9235067,9235058,TXFE7,128,9932,1,27350,14651,13708
9235329,9235328,TXFE7,128,9932,1,27351,14652,13709
9235367,9235366,TXFE7,128,9931,1,27352,14653,13710
9235379,9235379,TXFE7,128,9932,2,27354,14654,13712
9235392,9235386,TXFE7,128,9932,2,27356,14655,13713
9235392,9235390,TXFE7,128,9931,2,27358,14657,13714
9235404,9235402,TXFE7,128,9932,4,27362,14658,13716
9235479,9235470,TXFE7,128,9932,1,27363,14659,13717
9235629,9235628,TXFE7,128,9932,1,27364,14660,13718
9235654,9235643,TXFE7,128,9932,1,27365,14661,13719
9235704,9235695,TXFE7,128,9932,2,27367,14662,13720
9235717,9235704,TXFE7,128,9932,2,27369,14663,13722
9240904,9240903,TXFE7,128,9933,1,27370,14664,13723
9240929,9240917,TXFE7,128,9932,1,27371,14665,13724
9241067,9241057,TXFE7,128,9932,1,27372,14666,13725
9241079,9241073,TXFE7,128,9933,1,27373,14667,13726
9241204,9241199,TXFE7,128,9932,1,27374,14668,13727
9241454,9241446,TXFE7,128,9933,1,27375,14669,13728
9241542,9241532,TXFE7,128,9932,2,27377,14671,13729
9241654,9241646,TXFE7,128,9932,1,27378,14672,13730
9241854,9241844,TXFE7,128,9932,5,27383,14674,13731
9241879,9241873,TXFE7,128,9932,1,27384,14675,13732
9242279,9242268,TXFE7,128,9932,5,27389,14678,13733
9242417,9242405,TXFE7,128,9932,2,27391,14679,13734
9242479,9242470,TXFE7,128,9932,1,27392,14680,13735
9242479,9242473,TXFE7,128,9933,1,27393,14681,13736
9242554,9242551,TXFE7,128,9932,1,27394,14682,13737
9242654,9242646,TXFE7,128,9933,12,27406,14683,13742
9242704,9242695,TXFE7,128,9933,12,27418,14684,13750
9242717,9242704,TXFE7,128,9933,1,27419,14685,13751
9242717,9242704,TXFE7,128,9933,7,27426,14686,13757
9242717,9242704,TXFE7,128,9933,3,27429,14687,13759
9242729,9242724,TXFE7,128,9933,1,27430,14688,13760
9242729,9242724,TXFE7,128,9933,2,27432,14690,13761
9242729,9242725,TXFE7,129,9933,2,27470,14711,13762
9242729,9242725,TXFE7,129,9932,36,27470,14711,13762
9242742,9242733,TXFE7,128,9933,1,27471,14712,13763
9242992,9242987,TXFE7,128,9933,10,27481,14713,13766
9243004,9242992,TXFE7,128,9933,1,27482,14714,13767
9243017,9243015,TXFE7,128,9934,3,27485,14715,13769
9243117,9243113,TXFE7,128,9934,1,27486,14716,13770
9243142,9243137,TXFE7,128,9934,2,27488,14717,13772
9243192,9243186,TXFE7,128,9934,25,27513,14718,13780
9243242,9243233,TXFE7,128,9934,1,27514,14719,13781
9243267,9243258,TXFE7,128,9934,1,27515,14720,13782
9243429,9243427,TXFE7,128,9934,1,27516,14721,13783
9243479,9243470,TXFE7,128,9934,3,27519,14722,13786
9243479,9243477,TXFE7,128,9934,1,27520,14723,13787
9243492,9243491,TXFE7,128,9934,1,27521,14724,13788
9243554,9243554,TXFE7,128,9934,10,27531,14725,13790
9243579,9243567,TXFE7,128,9934,2,27533,14726,13792
9243642,9243630,TXFE7,128,9935,1,27534,14727,13793
9243667,9243654,TXFE7,128,9934,2,27536,14729,13794
9243679,9243670,TXFE7,128,9934,2,27538,14730,13795
9243692,9243682,TXFE7,128,9934,2,27540,14731,13796
9243692,9243687,TXFE7,128,9935,1,27541,14732,13797
9243704,9243696,TXFE7,128,9934,2,27543,14733,13798
9243704,9243697,TXFE7,128,9935,1,27544,14734,13799
9243704,9243703,TXFE7,128,9934,6,27550,14736,13800
9243729,9243717,TXFE7,128,9934,2,27552,14737,13801
9243742,9243736,TXFE7,128,9934,1,27553,14738,13802
9243742,9243737,TXFE7,128,9933,1,27554,14739,13803
9243804,9243798,TXFE7,128,9934,1,27555,14740,13804
9243817,9243815,TXFE7,128,9933,2,27557,14741,13805
9243829,9243817,TXFE7,128,9933,7,27564,14745,13806
9243879,9243869,TXFE7,128,9933,1,27565,14746,13807
9243879,9243870,TXFE7,128,9934,1,27566,14747,13808
9243917,9243907,TXFE7,128,9934,2,27568,14748,13810
9243929,9243922,TXFE7,128,9934,3,27571,14749,13811
9244042,9244034,TXFE7,128,9933,1,27572,14750,13812
9244342,9244331,TXFE7,128,9933,11,27583,14756,13813
9244354,9244349,TXFE7,128,9933,1,27584,14757,13814
9244367,9244361,TXFE7,128,9933,1,27585,14758,13815
9244367,9244361,TXFE7,128,9933,1,27586,14759,13816
9244442,9244440,TXFE7,128,9933,1,27587,14760,13817
9244504,9244496,TXFE7,128,9933,1,27588,14761,13818
9244517,9244513,TXFE7,128,9932,1,27589,14762,13819
9244529,9244518,TXFE7,128,9932,13,27602,14769,13820
9244579,9244573,TXFE7,128,9932,1,27603,14770,13821
9244579,9244574,TXFE7,128,9932,1,27604,14771,13822
9244579,9244575,TXFE7,128,9932,1,27605,14772,13823
9244592,9244579,TXFE7,128,9932,2,27607,14773,13824
9244592,9244580,TXFE7,128,9932,1,27608,14774,13825
9244604,9244598,TXFE7,128,9932,1,27609,14775,13826
9244654,9244648,TXFE7,128,9933,1,27610,14776,13827
9244754,9244748,TXFE7,128,9932,1,27611,14777,13828
9244779,9244767,TXFE7,128,9932,4,27615,14778,13829
9244917,9244910,TXFE7,128,9933,1,27616,14779,13830
9245467,9245464,TXFE7,128,9932,1,27617,14780,13831
9245679,9245677,TXFE7,128,9932,1,27618,14781,13832
9245754,9245752,TXFE7,128,9933,3,27621,14782,13834
9245804,9245792,TXFE7,128,9932,1,27622,14783,13835
9245842,9245832,TXFE7,128,9932,1,27623,14784,13836
9245929,9245927,TXFE7,128,9932,1,27624,14785,13837
9250067,9250058,TXFE7,128,9933,9,27633,14786,13843
9250079,9250076,TXFE7,128,9932,7,27640,14792,13844
9250092,9250083,TXFE7,128,9932,1,27641,14793,13845
9250092,9250085,TXFE7,128,9932,28,27669,14804,13846
9250117,9250104,TXFE7,128,9932,1,27670,14805,13847
9250117,9250112,TXFE7,128,9931,1,27671,14806,13848
9250142,9250131,TXFE7,128,9931,1,27672,14807,13849
9250142,9250134,TXFE7,128,9931,1,27673,14808,13850
9250154,9250153,TXFE7,128,9931,52,27725,14842,13851
9250167,9250154,TXFE7,128,9931,6,27731,14847,13852
9250167,9250154,TXFE7,128,9931,4,27735,14849,13853
9250167,9250154,TXFE7,128,9931,2,27737,14850,13854
9250167,9250154,TXFE7,128,9931,2,27739,14851,13855
9250167,9250154,TXFE7,128,9931,1,27740,14852,13856
9250167,9250156,TXFE7,128,9932,1,27741,14853,13857
9250167,9250157,TXFE7,128,9931,9,27750,14860,13858
9250167,9250160,TXFE7,128,9932,2,27752,14861,13859
9250179,9250170,TXFE7,128,9930,1,27753,14862,13860
9250192,9250184,TXFE7,128,9930,2,27755,14864,13861
9250192,9250184,TXFE7,128,9930,9,27764,14871,13862
9250192,9250190,TXFE7,128,9930,3,27767,14874,13863
9250204,9250198,TXFE7,128,9931,1,27768,14875,13864
9250217,9250209,TXFE7,128,9931,1,27769,14876,13865
9250229,9250223,TXFE7,128,9930,1,27770,14877,13866
9250242,9250236,TXFE7,128,9930,1,27771,14878,13867
9250392,9250391,TXFE7,128,9930,1,27778,14883,13872
9250404,9250398,TXFE7,128,9930,1,27779,14884,13873
9250429,9250419,TXFE7,128,9930,1,27780,14885,13874
9250479,9250473,TXFE7,128,9930,1,27781,14886,13875
9250642,9250630,TXFE7,128,9931,1,27787,14891,13880
9250754,9250752,TXFE7,128,9931,2,27789,14892,13881
9250792,9250787,TXFE7,128,9931,1,27790,14893,13882
9250804,9250800,TXFE7,128,9931,5,27795,14894,13886
9250804,9250802,TXFE7,128,9930,1,27796,14895,13887
9250804,9250803,TXFE7,128,9932,1,27797,14896,13888
9250842,9250831,TXFE7,128,9930,10,27807,14904,13889
9250854,9250850,TXFE7,128,9931,4,27811,14905,13893
9250867,9250855,TXFE7,128,9931,1,27812,14906,13894
9250917,9250907,TXFE7,128,9931,4,27816,14907,13896
9250929,9250919,TXFE7,128,9931,1,27817,14908,13897
9250954,9250947,TXFE7,128,9932,1,27818,14909,13898
9251079,9251077,TXFE7,128,9930,5,27823,14914,13899
9251092,9251088,TXFE7,128,9931,1,27824,14915,13900
9251254,9251247,TXFE7,128,9930,2,27826,14917,13901
9251254,9251249,TXFE7,128,9930,11,27837,14923,13902
9251267,9251259,TXFE7,128,9930,20,27857,14936,13903
9251267,9251265,TXFE7,128,9931,1,27858,14937,13904
9251367,9251364,TXFE7,128,9930,1,27859,14938,13905
9251367,9251366,TXFE7,128,9930,1,27860,14939,13906
9251392,9251390,TXFE7,128,9930,4,27864,14943,13907
9251404,9251399,TXFE7,128,9930,1,27865,14944,13908
9251417,9251405,TXFE7,128,9931,2,27867,14945,13910
9251429,9251422,TXFE7,128,9930,2,27869,14946,13911
9251467,9251457,TXFE7,128,9930,4,27873,14948,13912
9251467,9251463,TXFE7,128,9930,1,27874,14949,13913
9251479,9251469,TXFE7,128,9930,1,27875,14950,13914
9251492,9251486,TXFE7,128,9930,3,27878,14951,13915
9251517,9251510,TXFE7,128,9930,1,27879,14952,13916
9251529,9251517,TXFE7,128,9930,1,27880,14953,13917
9251542,9251535,TXFE7,128,9929,2,27882,14954,13918
9251554,9251543,TXFE7,128,9929,5,27887,14957,13919
9251554,9251544,TXFE7,128,9929,2,27889,14958,13920
9251554,9251550,TXFE7,128,9929,3,27892,14960,13921
9251567,9251556,TXFE7,128,9929,2,27894,14962,13922
9251567,9251556,TXFE7,128,9929,5,27899,14966,13923
9251567,9251558,TXFE7,128,9929,1,27900,14967,13924
9251579,9251567,TXFE7,128,9929,1,27901,14968,13925
9251579,9251577,TXFE7,128,9929,1,27902,14969,13926
9251579,9251577,TXFE7,128,9929,1,27903,14970,13927
9251592,9251580,TXFE7,128,9929,1,27904,14971,13928
9251592,9251581,TXFE7,128,9929,28,27932,14990,13929
9251604,9251592,TXFE7,128,9929,1,27933,14991,13930
9251604,9251592,TXFE7,128,9929,1,27934,14992,13931
9251604,9251592,TXFE7,128,9929,1,27935,14993,13932
9251617,9251604,TXFE7,128,9929,2,27937,14995,13933
9251617,9251604,TXFE7,128,9928,2,27939,14996,13934
9251629,9251625,TXFE7,128,9928,1,27940,14997,13935
9251629,9251625,TXFE7,128,9928,2,27942,14998,13936
9251629,9251627,TXFE7,128,9928,3,27945,15000,13937
9251642,9251631,TXFE7,128,9929,2,27947,15001,13938
9251642,9251635,TXFE7,128,9928,9,27956,15003,13939
9251654,9251642,TXFE7,128,9929,2,27958,15004,13941
9251654,9251650,TXFE7,128,9928,1,27959,15005,13942
9251679,9251679,TXFE7,128,9929,4,27963,15006,13945
9251692,9251684,TXFE7,128,9928,30,27993,15025,13946
9251692,9251685,TXFE7,128,9928,1,27994,15026,13947
9251717,9251707,TXFE7,128,9928,5,27999,15028,13948
9251717,9251716,TXFE7,128,9928,1,28000,15029,13949
9251729,9251726,TXFE7,128,9928,8,28008,15032,13950
9251729,9251729,TXFE7,128,9929,2,28010,15033,13951
9251742,9251730,TXFE7,128,9929,1,28011,15034,13952
9251742,9251731,TXFE7,128,9928,1,28012,15035,13953
9251742,9251740,TXFE7,128,9929,1,28013,15036,13954
9251767,9251766,TXFE7,128,9928,2,28015,15038,13955
9251779,9251769,TXFE7,128,9928,1,28016,15039,13956
9251804,9251795,TXFE7,128,9928,2,28018,15041,13957
9251817,9251808,TXFE7,128,9929,1,28019,15042,13958
9251817,9251808,TXFE7,128,9928,1,28020,15043,13959
9251817,9251813,TXFE7,128,9928,1,28021,15044,13960
9251829,9251822,TXFE7,128,9928,1,28022,15045,13961
9251829,9251824,TXFE7,128,9928,1,28023,15046,13962
9251879,9251876,TXFE7,128,9928,1,28024,15047,13963
9251892,9251885,TXFE7,128,9929,1,28025,15048,13964
9251892,9251888,TXFE7,128,9928,2,28027,15050,13965
9251917,9251906,TXFE7,128,9928,1,28028,15051,13966
9251942,9251932,TXFE7,128,9928,2,28030,15052,13967
9252017,9252011,TXFE7,128,9928,1,28031,15053,13968
9252017,9252013,TXFE7,128,9928,10,28041,15054,13969
9252017,9252017,TXFE7,128,9928,1,28042,15055,13970
9252042,9252030,TXFE7,128,9929,1,28043,15056,13971
9252079,9252072,TXFE7,128,9928,5,28048,15058,13972
9252092,9252079,TXFE7,128,9928,2,28050,15059,13973
9252092,9252082,TXFE7,128,9928,2,28052,15060,13974
9252142,9252131,TXFE7,128,9928,1,28053,15061,13975
9252142,9252133,TXFE7,128,9928,1,28054,15062,13976
9252154,9252148,TXFE7,128,9928,5,28059,15067,13977
9252154,9252152,TXFE7,128,9929,2,28061,15068,13978
9252167,9252156,TXFE7,128,9929,1,28062,15069,13979
9252192,9252187,TXFE7,128,9928,1,28063,15070,13980
9252204,9252193,TXFE7,128,9928,1,28064,15071,13981
9252217,9252206,TXFE7,128,9928,1,28065,15072,13982
9252242,9252236,TXFE7,128,9928,1,28066,15073,13983
9252254,9252244,TXFE7,128,9929,1,28067,15074,13984
9252279,9252270,TXFE7,128,9929,1,28068,15075,13985
9252317,9252304,TXFE7,128,9929,1,28069,15076,13986
9252317,9252307,TXFE7,128,9929,1,28070,15077,13987
9252379,9252369,TXFE7,128,9929,1,28071,15078,13988
9252392,9252389,TXFE7,128,9929,9,28080,15079,13996
9252404,9252399,TXFE7,128,9929,1,28081,15080,13997
9252417,9252407,TXFE7,128,9929,1,28082,15081,13998
9252417,9252407,TXFE7,128,9929,1,28083,15082,13999
9252442,9252435,TXFE7,128,9929,3,28086,15083,14000
9252467,9252459,TXFE7,128,9929,1,28087,15084,14001
9252542,9252542,TXFE7,128,9929,1,28088,15085,14002
9252629,9252619,TXFE7,128,9930,1,28089,15086,14003
9252654,9252649,TXFE7,128,9929,3,28092,15087,14004
9252667,9252660,TXFE7,128,9930,1,28093,15088,14005
9252667,9252664,TXFE7,128,9929,1,28094,15089,14006
9252679,9252671,TXFE7,128,9929,1,28095,15090,14007
9252704,9252696,TXFE7,128,9929,1,28096,15091,14008
9252704,9252700,TXFE7,128,9930,1,28097,15092,14009
9252779,9252773,TXFE7,128,9929,1,28098,15093,14010
9252817,9252809,TXFE7,128,9929,1,28099,15094,14011
9252867,9252855,TXFE7,128,9929,8,28107,15095,14012
9252879,9252867,TXFE7,128,9929,2,28109,15097,14013
9252904,9252896,TXFE7,128,9929,1,28110,15098,14014
9252942,9252933,TXFE7,129,9929,2,28114,15102,14015
9252942,9252933,TXFE7,129,9928,2,28114,15102,14015
9252979,9252975,TXFE7,128,9928,1,28115,15103,14016
9253017,9253008,TXFE7,128,9928,1,28116,15104,14017
9253029,9253024,TXFE7,128,9929,2,28118,15105,14019
9253054,9253054,TXFE7,128,9929,1,28119,15106,14020
9253104,9253096,TXFE7,128,9928,1,28120,15107,14021
9253154,9253152,TXFE7,128,9928,4,28124,15111,14022
9253167,9253158,TXFE7,128,9929,2,28126,15112,14023
9253204,9253196,TXFE7,128,9929,1,28127,15113,14024
9253204,9253202,TXFE7,128,9929,1,28128,15114,14025
9253242,9253239,TXFE7,128,9928,1,28129,15115,14026
9253279,9253278,TXFE7,128,9929,1,28130,15116,14027
9253317,9253311,TXFE7,128,9929,1,28131,15117,14028
9253354,9253352,TXFE7,128,9928,1,28132,15118,14029
9253367,9253356,TXFE7,128,9928,1,28133,15119,14030
9253367,9253361,TXFE7,128,9929,2,28135,15120,14031
9253379,9253376,TXFE7,128,9929,2,28137,15121,14032
9253392,9253391,TXFE7,128,9929,2,28139,15122,14033
9253417,9253404,TXFE7,128,9929,2,28141,15123,14034
9253429,9253417,TXFE7,128,9929,2,28143,15124,14036
9253442,9253432,TXFE7,128,9929,2,28145,15125,14037
9253442,9253437,TXFE7,128,9928,1,28146,15126,14038
9253454,9253450,TXFE7,128,9928,1,28147,15127,14039
9253467,9253464,TXFE7,128,9928,1,28148,15128,14040
9253479,9253468,TXFE7,128,9928,1,28149,15129,14041
9253567,9253559,TXFE7,128,9928,1,28150,15130,14042
9253567,9253559,TXFE7,128,9929,1,28151,15131,14043
9253579,9253576,TXFE7,128,9928,1,28152,15132,14044
9253579,9253579,TXFE7,128,9928,1,28153,15133,14045
9253604,9253596,TXFE7,128,9928,1,28154,15134,14046
9253629,9253625,TXFE7,128,9928,1,28155,15135,14047
9253629,9253628,TXFE7,128,9928,1,28156,15136,14048
9253642,9253629,TXFE7,128,9928,1,28157,15137,14049
9253667,9253658,TXFE7,128,9928,1,28158,15138,14050
9253679,9253679,TXFE7,128,9928,1,28159,15139,14051
9253704,9253693,TXFE7,128,9928,1,28160,15140,14052
9253704,9253697,TXFE7,129,9928,5,28166,15141,14055
9253704,9253697,TXFE7,129,9929,1,28166,15141,14055
9253704,9253700,TXFE7,128,9927,1,28167,15142,14056
9253717,9253707,TXFE7,128,9928,1,28168,15143,14057
9253717,9253712,TXFE7,128,9928,3,28171,15145,14058
9253717,9253712,TXFE7,128,9928,1,28172,15146,14059
9253729,9253718,TXFE7,128,9928,1,28173,15147,14060
9253729,9253723,TXFE7,128,9928,1,28174,15148,14061
9253729,9253729,TXFE7,128,9928,1,28175,15149,14062
9253742,9253733,TXFE7,128,9928,1,28176,15150,14063
9253742,9253735,TXFE7,128,9928,1,28177,15151,14064
9253779,9253769,TXFE7,128,9928,1,28178,15152,14065
9253792,9253788,TXFE7,128,9928,1,28179,15153,14066
9253804,9253803,TXFE7,128,9928,1,28180,15154,14067
9253817,9253813,TXFE7,128,9928,2,28182,15155,14068
9253817,9253816,TXFE7,128,9928,1,28183,15156,14069
9253867,9253855,TXFE7,128,9928,1,28184,15157,14070
9253867,9253863,TXFE7,128,9928,1,28185,15158,14071
9253892,9253888,TXFE7,128,9928,1,28186,15159,14072
9253917,9253907,TXFE7,128,9928,1,28187,15160,14073
9253929,9253923,TXFE7,128,9928,1,28188,15161,14074
9254004,9253998,TXFE7,128,9928,1,28189,15162,14075
9254017,9254012,TXFE7,128,9928,1,28190,15163,14076
9254042,9254040,TXFE7,128,9929,3,28193,15164,14079
9254067,9254054,TXFE7,128,9929,1,28194,15165,14080
9254067,9254066,TXFE7,128,9928,1,28195,15166,14081
9254092,9254090,TXFE7,128,9928,1,28196,15167,14082
9254254,9254245,TXFE7,128,9928,1,28197,15168,14083
9254267,9254258,TXFE7,128,9928,1,28198,15169,14084
9254329,9254327,TXFE7,128,9928,1,28199,15170,14085
9254354,9254344,TXFE7,128,9929,1,28200,15171,14086
9254379,9254369,TXFE7,128,9929,1,28201,15172,14087
9254417,9254407,TXFE7,128,9929,3,28204,15173,14090
9254429,9254420,TXFE7,128,9929,4,28208,15174,14092
9254442,9254437,TXFE7,128,9929,1,28209,15175,14093
9254504,9254493,TXFE7,128,9929,2,28211,15177,14094
9254542,9254535,TXFE7,128,9929,3,28214,15178,14095
9254654,9254647,TXFE7,128,9929,1,28215,15179,14096
9254829,9254818,TXFE7,128,9930,1,28216,15180,14097
9254917,9254915,TXFE7,128,9930,1,28217,15181,14098
9254929,9254928,TXFE7,128,9929,1,28218,15182,14099
9254979,9254972,TXFE7,128,9929,2,28220,15184,14100
9255117,9255113,TXFE7,128,9929,1,28221,15185,14101
9255154,9255142,TXFE7,128,9929,2,28223,15187,14102
9255167,9255154,TXFE7,128,9929,3,28226,15190,14103
9255167,9255159,TXFE7,128,9929,1,28227,15191,14104
9255229,9255226,TXFE7,128,9929,1,28228,15192,14105
9255267,9255264,TXFE7,128,9928,1,28229,15193,14106
9255317,9255308,TXFE7,128,9929,1,28230,15194,14107
9255329,9255318,TXFE7,128,9928,1,28231,15195,14108
9255329,9255321,TXFE7,128,9929,5,28236,15196,14110
9255367,9255363,TXFE7,128,9928,1,28237,15197,14111
9255567,9255558,TXFE7,128,9929,2,28239,15198,14112
9255579,9255567,TXFE7,128,9928,1,28240,15199,14113
9255592,9255591,TXFE7,128,9928,1,28241,15200,14114
9255629,9255620,TXFE7,128,9928,1,28242,15201,14115
9255642,9255639,TXFE7,128,9928,1,28243,15202,14116
9255679,9255675,TXFE7,128,9928,1,28244,15203,14117
9255742,9255732,TXFE7,128,9929,1,28245,15204,14118
9255917,9255911,TXFE7,128,9928,2,28247,15205,14119
9255929,9255921,TXFE7,128,9928,1,28248,15206,14120
9255929,9255923,TXFE7,128,9928,1,28249,15207,14121
9255929,9255925,TXFE7,128,9928,1,28250,15208,14122
9255942,9255931,TXFE7,128,9928,3,28253,15210,14123
9260029,9260017,TXFE7,128,9928,1,28254,15211,14124
9260067,9260055,TXFE7,128,9929,1,28255,15212,14125
9260067,9260065,TXFE7,128,9928,1,28256,15213,14126
9260079,9260076,TXFE7,128,9928,1,28257,15214,14127
9260104,9260094,TXFE7,128,9928,1,28258,15215,14128
9260142,9260139,TXFE7,128,9928,1,28259,15216,14129
9260217,9260216,TXFE7,128,9928,1,28260,15217,14130
9260342,9260336,TXFE7,128,9928,1,28261,15218,14131
9260342,9260337,TXFE7,128,9929,1,28262,15219,14132
9260392,9260383,TXFE7,128,9928,1,28263,15220,14133
9260517,9260508,TXFE7,128,9928,1,28264,15221,14134
9260517,9260510,TXFE7,128,9928,1,28265,15222,14135
9260517,9260512,TXFE7,128,9928,1,28266,15223,14136
9260542,9260539,TXFE7,128,9928,2,28268,15225,14137
9260567,9260557,TXFE7,128,9929,1,28269,15226,14138
9260567,9260560,TXFE7,128,9929,1,28270,15227,14139
9260667,9260658,TXFE7,128,9929,1,28271,15228,14140
9260792,9260790,TXFE7,128,9929,2,28273,15229,14141
9260879,9260869,TXFE7,128,9928,1,28274,15230,14142
9260917,9260909,TXFE7,128,9929,2,28276,15231,14143
9261067,9261060,TXFE7,128,9929,1,28277,15232,14144
9261117,9261108,TXFE7,128,9929,1,28278,15233,14145
9261142,9261134,TXFE7,128,9929,2,28280,15234,14146
9261167,9261155,TXFE7,128,9929,1,28281,15235,14147
9261279,9261278,TXFE7,128,9929,25,28306,15236,14158
9261292,9261279,TXFE7,128,9929,8,28314,15237,14162
9261292,9261279,TXFE7,128,9929,1,28315,15238,14163
9261292,9261279,TXFE7,128,9929,4,28319,15239,14167
9261292,9261279,TXFE7,128,9929,1,28320,15240,14168
9261292,9261279,TXFE7,128,9929,8,28328,15241,14172
9261317,9261313,TXFE7,128,9929,1,28329,15242,14173
9261342,9261338,TXFE7,128,9929,1,28330,15243,14174
9261417,9261410,TXFE7,128,9930,2,28332,15244,14175
9261417,9261415,TXFE7,128,9929,1,28333,15245,14176
9261454,9261443,TXFE7,128,9929,1,28334,15246,14177
9261454,9261443,TXFE7,128,9929,1,28335,15247,14178
9261654,9261654,TXFE7,128,9929,1,28336,15248,14179
9261817,9261808,TXFE7,128,9930,1,28337,15249,14180
9261954,9261954,TXFE7,128,9929,30,28367,15264,14181
9262004,9262001,TXFE7,128,9930,1,28368,15265,14182
9262242,9262230,TXFE7,128,9929,1,28369,15266,14183
9262292,9262284,TXFE7,128,9929,4,28373,15269,14184
9262492,9262480,TXFE7,128,9929,1,28374,15270,14185
9262767,9262763,TXFE7,128,9929,2,28376,15271,14186
9262792,9262779,TXFE7,128,9930,1,28377,15272,14187
9262942,9262935,TXFE7,128,9929,1,28378,15273,14188
9263054,9263047,TXFE7,128,9929,1,28379,15274,14189
9263129,9263129,TXFE7,128,9930,1,28380,15275,14190
9263154,9263147,TXFE7,128,9930,1,28381,15276,14191
9263154,9263150,TXFE7,128,9929,1,28382,15277,14192
9263167,9263163,TXFE7,128,9929,1,28383,15278,14193
9263204,9263204,TXFE7,128,9929,1,28384,15279,14194
9263242,9263230,TXFE7,128,9929,3,28387,15281,14195
9263454,9263452,TXFE7,128,9929,1,28388,15282,14196
9263542,9263530,TXFE7,128,9929,1,28389,15283,14197
9263567,9263557,TXFE7,128,9930,5,28394,15284,14198
9263654,9263644,TXFE7,128,9930,11,28405,15285,14206
9263704,9263696,TXFE7,128,9930,10,28415,15286,14212
9263729,9263722,TXFE7,128,9930,2,28417,15287,14213
9263779,9263777,TXFE7,128,9930,1,28418,15288,14214
9263792,9263789,TXFE7,128,9930,1,28419,15289,14215
9263804,9263793,TXFE7,128,9930,1,28420,15290,14216
9263817,9263812,TXFE7,128,9930,2,28422,15291,14218
9263829,9263817,TXFE7,128,9930,1,28423,15292,14219
9263829,9263819,TXFE7,128,9930,1,28424,15293,14220
9263842,9263829,TXFE7,128,9930,2,28426,15294,14222
9263842,9263836,TXFE7,128,9930,1,28427,15295,14223
9264054,9264050,TXFE7,128,9931,2,28429,15296,14224
9264067,9264066,TXFE7,128,9931,1,28430,15297,14225
9264154,9264147,TXFE7,128,9931,1,28431,15298,14226
9264179,9264179,TXFE7,128,9931,2,28433,15299,14228
9264354,9264349,TXFE7,128,9931,2,28435,15300,14230
9264392,9264382,TXFE7,128,9931,1,28436,15301,14231
9264442,9264432,TXFE7,128,9930,6,28442,15307,14232
9264454,9264451,TXFE7,128,9930,1,28443,15308,14233
9264567,9264558,TXFE7,128,9930,1,28444,15309,14234
9264592,9264581,TXFE7,128,9930,1,28445,15310,14235
9264617,9264605,TXFE7,128,9930,3,28448,15311,14238
9264642,9264636,TXFE7,128,9930,1,28449,15312,14239
9264729,9264724,TXFE7,128,9930,1,28450,15313,14240
9264854,9264845,TXFE7,128,9930,1,28451,15314,14241
9264967,9264965,TXFE7,128,9930,1,28452,15315,14242
9265042,9265036,TXFE7,128,9930,1,28453,15316,14243
9265067,9265062,TXFE7,128,9929,3,28456,15319,14244
9265092,9265080,TXFE7,128,9930,3,28459,15320,14247
9265104,9265092,TXFE7,128,9930,3,28462,15322,14248
9265129,9265120,TXFE7,128,9930,1,28463,15323,14249
9265154,9265149,TXFE7,128,9930,1,28464,15324,14250
9265167,9265157,TXFE7,128,9930,1,28465,15325,14251
9265267,9265263,TXFE7,128,9930,2,28467,15326,14253
9265442,9265437,TXFE7,128,9930,1,28468,15327,14254
9265567,9265555,TXFE7,128,9930,5,28473,15328,14257
9265604,9265602,TXFE7,128,9929,4,28477,15331,14258
9265867,9265855,TXFE7,128,9930,1,28478,15332,14259
9265904,9265892,TXFE7,128,9929,10,28488,15340,14260
9265942,9265935,TXFE7,128,9930,1,28489,15341,14261
9265942,9265936,TXFE7,128,9929,1,28490,15342,14262
9265967,9265955,TXFE7,128,9930,1,28491,15343,14263
9270079,9270075,TXFE7,128,9929,1,28492,15344,14264
9270142,9270137,TXFE7,128,9929,1,28493,15345,14265
9270154,9270148,TXFE7,128,9929,1,28494,15346,14266
9270154,9270151,TXFE7,128,9930,11,28505,15347,14271
9270167,9270163,TXFE7,128,9929,1,28506,15348,14272
9270179,9270170,TXFE7,128,9930,1,28507,15349,14273
9270267,9270260,TXFE7,128,9929,1,28508,15350,14274
9270292,9270280,TXFE7,128,9929,1,28509,15351,14275
9270317,9270311,TXFE7,128,9929,1,28510,15352,14276
9270617,9270609,TXFE7,128,9929,1,28511,15353,14277
9270704,9270702,TXFE7,128,9930,1,28512,15354,14278
9270729,9270721,TXFE7,128,9929,1,28513,15355,14279
9270729,9270723,TXFE7,128,9929,1,28514,15356,14280
9270742,9270730,TXFE7,128,9929,1,28515,15357,14281
9270742,9270741,TXFE7,128,9930,1,28516,15358,14282
9270767,9270758,TXFE7,128,9929,1,28517,15359,14283
9270779,9270773,TXFE7,128,9929,1,28518,15360,14284
9270804,9270798,TXFE7,128,9929,1,28519,15361,14285
9270804,9270801,TXFE7,128,9930,1,28520,15362,14286
9270829,9270818,TXFE7,128,9931,2,28522,15363,14288
9271192,9271182,TXFE7,128,9930,1,28523,15364,14289
9271404,9271404,TXFE7,128,9930,1,28524,15365,14290
9271554,9271544,TXFE7,128,9931,1,28525,15366,14291
9272004,9271993,TXFE7,128,9930,1,28526,15367,14292
9272392,9272388,TXFE7,128,9931,3,28529,15368,14295
9272542,9272539,TXFE7,128,9930,2,28531,15369,14296
9272554,9272551,TXFE7,128,9931,1,28532,15370,14297
9272604,9272592,TXFE7,128,9930,1,28533,15371,14298
9272704,9272694,TXFE7,128,9930,1,28534,15372,14299
9272817,9272805,TXFE7,128,9931,1,28535,15373,14300
9272854,9272845,TXFE7,128,9931,2,28537,15374,14302
9272879,9272871,TXFE7,128,9930,2,28539,15375,14303
9272904,9272896,TXFE7,128,9931,2,28541,15376,14304
9272929,9272918,TXFE7,128,9930,1,28542,15377,14305
9272979,9272979,TXFE7,128,9930,1,28543,15378,14306
9272992,9272985,TXFE7,128,9931,5,28548,15379,14307
9273067,9273058,TXFE7,128,9931,1,28549,15380,14308
9273117,9273110,TXFE7,128,9930,1,28550,15381,14309
9273142,9273134,TXFE7,128,9931,1,28551,15382,14310
9273354,9273348,TXFE7,128,9931,1,28552,15383,14311
9273379,9273378,TXFE7,128,9931,1,28553,15384,14312
9273404,9273395,TXFE7,128,9931,1,28554,15385,14313
9273467,9273464,TXFE7,128,9931,1,28555,15386,14314
9273579,9273578,TXFE7,128,9931,1,28556,15387,14315
9273754,9273752,TXFE7,128,9931,1,28557,15388,14316
9273892,9273889,TXFE7,128,9931,1,28558,15389,14317
9273954,9273944,TXFE7,128,9930,1,28559,15390,14318
9273979,9273972,TXFE7,128,9931,1,28560,15391,14319
9274029,9274019,TXFE7,128,9931,2,28562,15392,14321
9274104,9274103,TXFE7,128,9931,10,28572,15393,14330
9274142,9274140,TXFE7,128,9931,5,28577,15394,14332
9274179,9274178,TXFE7,128,9931,3,28580,15395,14333
9274192,9274190,TXFE7,128,9931,1,28581,15396,14334
9274204,9274197,TXFE7,128,9931,1,28582,15397,14335
9274217,9274215,TXFE7,128,9931,1,28583,15398,14336
9274242,9274234,TXFE7,128,9931,1,28584,15399,14337
9274279,9274268,TXFE7,128,9931,1,28585,15400,14338
9274292,9274283,TXFE7,128,9931,1,28586,15401,14339
9274304,9274304,TXFE7,128,9931,1,28587,15402,14340
9274317,9274316,TXFE7,128,9931,2,28589,15403,14342
9274442,9274436,TXFE7,128,9931,4,28593,15404,14344
9274554,9274553,TXFE7,128,9931,1,28594,15405,14345
9274567,9274555,TXFE7,128,9931,1,28595,15406,14346
9274579,9274569,TXFE7,129,9931,3,28625,15407,14360
9274579,9274569,TXFE7,129,9932,27,28625,15407,14360
9274592,9274579,TXFE7,128,9931,1,28626,15408,14361
9274604,9274595,TXFE7,128,9932,1,28627,15409,14362
9274629,9274619,TXFE7,128,9931,1,28628,15410,14363
9274667,9274667,TXFE7,128,9932,1,28629,15411,14364
9274779,9274778,TXFE7,128,9931,1,28630,15412,14365
9274829,9274826,TXFE7,128,9932,1,28631,15413,14366
9274854,9274851,TXFE7,128,9932,1,28632,15414,14367
9274979,9274971,TXFE7,128,9932,2,28634,15415,14369
9275104,9275096,TXFE7,128,9932,1,28635,15416,14370
9275267,9275256,TXFE7,128,9932,1,28636,15417,14371
9275367,9275360,TXFE7,128,9932,1,28637,15418,14372
9275467,9275464,TXFE7,128,9932,1,28638,15419,14373
9275667,9275662,TXFE7,128,9932,2,28640,15420,14374
9275842,9275836,TXFE7,128,9932,3,28643,15421,14375
9275854,9275845,TXFE7,128,9932,2,28645,15422,14377
9275904,9275893,TXFE7,128,9932,10,28655,15423,14385
9275917,9275909,TXFE7,128,9932,2,28657,15424,14387
9275917,9275909,TXFE7,128,9932,6,28663,15425,14389
9275917,9275909,TXFE7,128,9932,4,28667,15426,14392
9275917,9275909,TXFE7,128,9932,5,28672,15427,14395
9280029,9280019,TXFE7,128,9932,1,28673,15428,14396
9280092,9280083,TXFE7,128,9933,2,28675,15429,14397
9280092,9280087,TXFE7,128,9932,1,28676,15430,14398
9280104,9280097,TXFE7,128,9933,1,28677,15431,14399
9280117,9280116,TXFE7,128,9932,1,28678,15432,14400
9280167,9280161,TXFE7,128,9933,1,28679,15433,14401
9280229,9280219,TXFE7,128,9933,1,28680,15434,14402
9280254,9280254,TXFE7,128,9932,1,28681,15435,14403
9280342,9280331,TXFE7,128,9932,2,28683,15436,14404
9280404,9280401,TXFE7,128,9932,1,28684,15437,14405
9280429,9280422,TXFE7,128,9932,2,28686,15438,14406
9280517,9280505,TXFE7,128,9932,1,28687,15439,14407
9280617,9280616,TXFE7,128,9931,20,28707,15451,14408
9280629,9280617,TXFE7,128,9931,1,28708,15452,14409
9280629,9280628,TXFE7,128,9932,1,28709,15453,14410
9280704,9280692,TXFE7,128,9932,1,28710,15454,14411
9280717,9280711,TXFE7,128,9931,17,28727,15466,14412
9280792,9280790,TXFE7,128,9931,1,28728,15467,14413
9280804,9280796,TXFE7,128,9930,1,28729,15468,14414
9280854,9280847,TXFE7,128,9930,1,28730,15469,14415
9281142,9281129,TXFE7,128,9930,11,28741,15476,14416
9281192,9281182,TXFE7,128,9930,10,28751,15484,14417
9281192,9281190,TXFE7,128,9930,2,28753,15486,14418
9281417,9281414,TXFE7,128,9930,5,28758,15491,14419
9281479,9281478,TXFE7,128,9930,2,28760,15493,14420
9281579,9281570,TXFE7,128,9930,1,28761,15494,14421
9281617,9281613,TXFE7,128,9931,1,28762,15495,14422
9281817,9281808,TXFE7,128,9931,11,28773,15496,14430
9281829,9281829,TXFE7,128,9931,2,28775,15497,14431
9281979,9281968,TXFE7,128,9930,2,28777,15498,14432
9282017,9282014,TXFE7,128,9930,1,28778,15499,14433
9282179,9282170,TXFE7,128,9930,2,28780,15500,14434
9282292,9282284,TXFE7,128,9930,1,28781,15501,14435
9282404,9282397,TXFE7,128,9930,1,28782,15502,14436
9282479,9282469,TXFE7,128,9930,1,28783,15503,14437
9282729,9282721,TXFE7,128,9930,1,28784,15504,14438
9282729,9282727,TXFE7,128,9930,4,28788,15505,14439
9282779,9282768,TXFE7,128,9930,1,28789,15506,14440
9282792,9282783,TXFE7,128,9930,2,28791,15508,14441
9282879,9282876,TXFE7,128,9930,1,28792,15509,14442
9282904,9282893,TXFE7,128,9930,1,28793,15510,14443
9282929,9282918,TXFE7,128,9930,1,28794,15511,14444
9282929,9282928,TXFE7,128,9930,23,28817,15530,14445
9282942,9282935,TXFE7,128,9929,1,28818,15531,14446
9282942,9282936,TXFE7,128,9929,1,28819,15532,14447
9282954,9282943,TXFE7,128,9930,1,28820,15533,14448
9282979,9282970,TXFE7,128,9930,1,28821,15534,14449
9283104,9283097,TXFE7,128,9930,1,28822,15535,14450
9283104,9283101,TXFE7,128,9929,1,28823,15536,14451
9283192,9283189,TXFE7,128,9930,2,28825,15537,14452
9283392,9283392,TXFE7,128,9930,3,28828,15538,14455
9283467,9283456,TXFE7,128,9930,1,28829,15539,14456
9283492,9283480,TXFE7,128,9929,1,28830,15540,14457
9283617,9283615,TXFE7,128,9930,1,28831,15541,14458
9283704,9283696,TXFE7,128,9929,3,28834,15542,14459
9283717,9283709,TXFE7,128,9930,2,28836,15543,14461
9283804,9283803,TXFE7,128,9929,1,28837,15544,14462
9284267,9284256,TXFE7,128,9930,1,28838,15545,14463
9284529,9284522,TXFE7,128,9930,1,28839,15546,14464
9284679,9284667,TXFE7,128,9929,1,28840,15547,14465
9284767,9284764,TXFE7,128,9929,1,28841,15548,14466
9284792,9284782,TXFE7,128,9930,5,28846,15549,14467
9284792,9284783,TXFE7,128,9929,1,28847,15550,14468
9284792,9284783,TXFE7,128,9929,8,28855,15551,14469
9284792,9284783,TXFE7,128,9929,74,28929,15586,14470
9284792,9284786,TXFE7,128,9928,1,28930,15587,14471
9284804,9284792,TXFE7,128,9928,6,28936,15588,14472
9284804,9284792,TXFE7,128,9928,6,28942,15589,14473
9284804,9284792,TXFE7,128,9928,6,28948,15590,14474
9284804,9284792,TXFE7,128,9928,2,28950,15592,14475
9284804,9284792,TXFE7,128,9928,6,28956,15596,14476
9284804,9284794,TXFE7,128,9928,2,28958,15597,14477
9284804,9284796,TXFE7,128,9928,6,28964,15598,14478
9284817,9284804,TXFE7,128,9928,4,28968,15599,14479
9284817,9284804,TXFE7,128,9928,1,28969,15600,14480
9284817,9284804,TXFE7,128,9928,8,28977,15605,14481
9284817,9284804,TXFE7,128,9928,1,28978,15606,14482
9284817,9284804,TXFE7,128,9928,1,28979,15607,14483
9284817,9284804,TXFE7,128,9928,4,28983,15611,14484
9284817,9284804,TXFE7,128,9928,4,28987,15613,14485
9284817,9284804,TXFE7,128,9928,6,28993,15617,14486
9284817,9284804,TXFE7,128,9928,4,28997,15620,14487
9284817,9284804,TXFE7,128,9928,1,28998,15621,14488
9284817,9284804,TXFE7,128,9928,1,28999,15622,14489
9284817,9284804,TXFE7,128,9928,2,29001,15624,14490
9284817,9284804,TXFE7,128,9928,1,29002,15625,14491
9284817,9284804,TXFE7,128,9928,1,29003,15626,14492
9284817,9284804,TXFE7,128,9928,7,29010,15632,14493
9284817,9284804,TXFE7,128,9928,5,29015,15637,14494
9284817,9284805,TXFE7,128,9928,1,29016,15638,14495
9284817,9284805,TXFE7,128,9927,2,29018,15639,14496
9284817,9284810,TXFE7,128,9927,1,29019,15640,14497
9284829,9284820,TXFE7,128,9927,10,29029,15648,14498
9284842,9284829,TXFE7,128,9927,5,29034,15649,14499
9284842,9284840,TXFE7,128,9927,10,29044,15656,14500
9284854,9284846,TXFE7,128,9927,3,29047,15657,14501
9284854,9284852,TXFE7,128,9928,1,29048,15658,14502
9284892,9284881,TXFE7,128,9927,1,29049,15659,14503
9284904,9284894,TXFE7,128,9928,3,29052,15660,14505
9284917,9284905,TXFE7,128,9927,11,29063,15669,14506
9284917,9284913,TXFE7,128,9927,11,29074,15675,14507
9284929,9284922,TXFE7,128,9927,1,29075,15676,14508
9284929,9284922,TXFE7,128,9927,3,29078,15678,14509
9284942,9284934,TXFE7,128,9928,1,29079,15679,14510
9284967,9284958,TXFE7,128,9927,1,29080,15680,14511
9284979,9284971,TXFE7,128,9927,1,29081,15681,14512
9284979,9284973,TXFE7,128,9928,1,29082,15682,14513
9284992,9284985,TXFE7,128,9927,3,29085,15684,14514
9285004,9284993,TXFE7,128,9927,2,29087,15686,14515
9285004,9284994,TXFE7,128,9927,4,29091,15688,14516
9285004,9284998,TXFE7,128,9927,1,29092,15689,14517
9285042,9285032,TXFE7,128,9927,3,29095,15690,14518
9285079,9285073,TXFE7,128,9926,3,29098,15692,14519
9285092,9285084,TXFE7,128,9926,1,29099,15693,14520
9285092,9285084,TXFE7,128,9926,1,29100,15694,14521
9285092,9285085,TXFE7,128,9926,2,29102,15695,14522
9285092,9285087,TXFE7,128,9926,1,29103,15696,14523
9285092,9285087,TXFE7,128,9926,1,29104,15697,14524
9285092,9285089,TXFE7,128,9926,1,29105,15698,14525
9285092,9285089,TXFE7,128,9926,3,29108,15701,14526
9285092,9285091,TXFE7,128,9926,2,29110,15703,14527
9285104,9285096,TXFE7,128,9926,2,29112,15704,14528
9285104,9285102,TXFE7,128,9926,10,29122,15709,14529
9285104,9285104,TXFE7,128,9926,1,29123,15710,14530
9285117,9285106,TXFE7,128,9926,1,29124,15711,14531
9285117,9285113,TXFE7,128,9926,1,29125,15712,14532
9285142,9285136,TXFE7,128,9926,3,29128,15715,14533
9285167,9285156,TXFE7,128,9926,3,29131,15717,14534
9285167,9285163,TXFE7,128,9926,1,29132,15718,14535
9285179,9285175,TXFE7,128,9927,1,29133,15719,14536
9285179,9285175,TXFE7,128,9926,2,29135,15720,14537
9285192,9285184,TXFE7,128,9927,1,29136,15721,14538
9285192,9285184,TXFE7,128,9926,1,29137,15722,14539
9285192,9285188,TXFE7,128,9926,1,29138,15723,14540
9285204,9285203,TXFE7,128,9926,1,29139,15724,14541
9285217,9285205,TXFE7,128,9926,1,29140,15725,14542
9285217,9285206,TXFE7,128,9926,1,29141,15726,14543
9285217,9285209,TXFE7,128,9926,2,29143,15727,14544
9285217,9285214,TXFE7,128,9927,2,29145,15728,14545
9285229,9285227,TXFE7,128,9926,1,29146,15729,14546
9285229,9285229,TXFE7,128,9926,1,29147,15730,14547
9285254,9285243,TXFE7,129,9926,1,29151,15733,14548
9285254,9285243,TXFE7,129,9925,3,29151,15733,14548
9285267,9285257,TXFE7,128,9927,2,29153,15734,14550
9285279,9285274,TXFE7,128,9926,5,29158,15738,14551
9285279,9285275,TXFE7,128,9927,3,29161,15739,14552
9285292,9285281,TXFE7,128,9926,1,29162,15740,14553
9285292,9285284,TXFE7,128,9926,1,29163,15741,14554
9285292,9285289,TXFE7,128,9926,5,29168,15742,14555
9285304,9285294,TXFE7,128,9925,1,29169,15743,14556
9285304,9285304,TXFE7,128,9926,1,29170,15744,14557
9285317,9285309,TXFE7,128,9925,10,29180,15749,14558
9285317,9285314,TXFE7,128,9925,3,29183,15752,14559
9285317,9285314,TXFE7,128,9925,1,29184,15753,14560
9285317,9285316,TXFE7,128,9925,1,29185,15754,14561
9285329,9285320,TXFE7,128,9925,1,29186,15755,14562
9285329,9285329,TXFE7,128,9925,1,29187,15756,14563
9285342,9285330,TXFE7,128,9925,1,29188,15757,14564
9285342,9285332,TXFE7,128,9925,1,29189,15758,14565
9285354,9285346,TXFE7,128,9926,1,29190,15759,14566
9285354,9285346,TXFE7,128,9926,1,29191,15760,14567
9285392,9285379,TXFE7,128,9927,1,29192,15761,14568
9285404,9285404,TXFE7,128,9927,1,29193,15762,14569
9285417,9285404,TXFE7,128,9927,2,29195,15763,14570
9285417,9285405,TXFE7,128,9927,1,29196,15764,14571
9285454,9285444,TXFE7,128,9927,1,29197,15765,14572
9285504,9285498,TXFE7,128,9926,1,29198,15766,14573
9285529,9285519,TXFE7,128,9926,5,29203,15768,14574
9285529,9285529,TXFE7,128,9927,1,29204,15769,14575
9285542,9285538,TXFE7,128,9927,1,29205,15770,14576
9285554,9285551,TXFE7,128,9927,1,29206,15771,14577
9285592,9285580,TXFE7,128,9927,11,29217,15772,14581
9285604,9285592,TXFE7,128,9927,4,29221,15773,14585
9285604,9285592,TXFE7,128,9927,1,29222,15774,14586
9285617,9285604,TXFE7,128,9927,2,29224,15775,14588
9285617,9285604,TXFE7,128,9927,2,29226,15776,14589
9285617,9285615,TXFE7,128,9928,4,29230,15777,14591
9285642,9285632,TXFE7,128,9927,2,29232,15779,14592
9285654,9285644,TXFE7,128,9927,1,29233,15780,14593
9285667,9285657,TXFE7,128,9927,1,29234,15781,14594
9285717,9285716,TXFE7,128,9927,1,29235,15782,14595
9285879,9285877,TXFE7,128,9927,1,29236,15783,14596
9285904,9285896,TXFE7,129,9927,3,29261,15797,14597
9285904,9285896,TXFE7,129,9926,22,29261,15797,14597
9285917,9285913,TXFE7,128,9926,10,29271,15803,14598
9285979,9285968,TXFE7,128,9926,1,29272,15804,14599
9285979,9285977,TXFE7,128,9926,1,29273,15805,14600
9290042,9290030,TXFE7,128,9926,1,29274,15806,14601
9290054,9290048,TXFE7,128,9926,5,29279,15811,14602
9290079,9290068,TXFE7,128,9927,2,29281,15812,14604
9290079,9290068,TXFE7,128,9927,1,29282,15813,14605
9290079,9290071,TXFE7,128,9926,1,29283,15814,14606
9290092,9290083,TXFE7,128,9927,1,29284,15815,14607
9290092,9290089,TXFE7,128,9926,5,29289,15818,14608
9290104,9290092,TXFE7,128,9926,1,29290,15819,14609
9290104,9290098,TXFE7,128,9926,4,29294,15820,14610
9290117,9290110,TXFE7,128,9926,1,29295,15821,14611
9290129,9290123,TXFE7,128,9927,1,29296,15822,14612
9290129,9290124,TXFE7,128,9927,1,29297,15823,14613
9290142,9290130,TXFE7,128,9926,2,29299,15824,14614
9290167,9290160,TXFE7,128,9926,2,29301,15825,14615
9290167,9290164,TXFE7,128,9926,2,29303,15827,14616
9290217,9290210,TXFE7,128,9926,2,29305,15829,14617
9290229,9290222,TXFE7,128,9926,1,29306,15830,14618
9290229,9290222,TXFE7,128,9926,3,29309,15831,14620
9290279,9290267,TXFE7,128,9926,2,29311,15832,14621
9290279,9290267,TXFE7,128,9926,2,29313,15833,14622
9290304,9290292,TXFE7,128,9926,1,29314,15834,14623
9290342,9290334,TXFE7,128,9925,1,29315,15835,14624
9290367,9290356,TXFE7,129,9926,3,29323,15838,14625
9290367,9290356,TXFE7,129,9925,5,29323,15838,14625
9290367,9290357,TXFE7,128,9925,6,29329,15839,14626
9290367,9290363,TXFE7,128,9925,1,29330,15840,14627
9290367,9290367,TXFE7,128,9925,1,29331,15841,14628
9290379,9290373,TXFE7,128,9925,3,29334,15844,14629
9290429,9290423,TXFE7,128,9925,5,29339,15846,14630
9290429,9290425,TXFE7,128,9925,1,29340,15847,14631
9290479,9290475,TXFE7,128,9925,5,29345,15849,14632
9290492,9290480,TXFE7,128,9926,1,29346,15850,14633
9290492,9290483,TXFE7,128,9926,1,29347,15851,14634
9290517,9290505,TXFE7,128,9925,1,29348,15852,14635
9290517,9290512,TXFE7,128,9925,1,29349,15853,14636
9290517,9290513,TXFE7,128,9926,1,29350,15854,14637
9290517,9290514,TXFE7,128,9926,1,29351,15855,14638
9290529,9290522,TXFE7,128,9926,1,29352,15856,14639
9290542,9290531,TXFE7,128,9926,1,29353,15857,14640
9290567,9290554,TXFE7,128,9926,4,29357,15858,14641
9290567,9290554,TXFE7,128,9926,15,29372,15859,14648
9290579,9290573,TXFE7,128,9926,5,29377,15861,14649
9290604,9290599,TXFE7,128,9927,1,29378,15862,14650
9290667,9290659,TXFE7,128,9926,2,29380,15863,14651
9290667,9290660,TXFE7,128,9926,3,29383,15865,14652
9290679,9290676,TXFE7,128,9927,2,29385,15866,14654
9290817,9290807,TXFE7,128,9927,1,29386,15867,14655
9290854,9290848,TXFE7,128,9927,1,29387,15868,14656
9290879,9290870,TXFE7,128,9926,1,29388,15869,14657
9290904,9290899,TXFE7,128,9926,1,29389,15870,14658
9290979,9290977,TXFE7,128,9927,1,29390,15871,14659
9291017,9291011,TXFE7,128,9927,1,29391,15872,14660
9291029,9291026,TXFE7,128,9927,1,29392,15873,14661
9291029,9291026,TXFE7,128,9927,1,29393,15874,14662
9291092,9291085,TXFE7,128,9927,4,29397,15875,14664
9291129,9291120,TXFE7,128,9927,1,29398,15876,14665
9291129,9291122,TXFE7,128,9927,5,29403,15877,14666
9291317,9291306,TXFE7,128,9927,2,29405,15878,14668
9291342,9291330,TXFE7,128,9927,1,29406,15879,14669
9291367,9291359,TXFE7,128,9927,1,29407,15880,14670
9291392,9291388,TXFE7,128,9927,1,29408,15881,14671
9291479,9291467,TXFE7,128,9926,1,29409,15882,14672
9291554,9291545,TXFE7,128,9927,1,29410,15883,14673
9291579,9291573,TXFE7,128,9926,2,29412,15884,14674
9291654,9291643,TXFE7,128,9927,1,29413,15885,14675
9291667,9291667,TXFE7,128,9927,1,29414,15886,14676
9291679,9291671,TXFE7,128,9927,1,29415,15887,14677
9291704,9291701,TXFE7,128,9927,1,29416,15888,14678
9291792,9291788,TXFE7,128,9927,1,29417,15889,14679
9291929,9291924,TXFE7,128,9927,1,29418,15890,14680
9291992,9291985,TXFE7,128,9927,1,29419,15891,14681
9292029,9292018,TXFE7,128,9926,3,29422,15892,14682
9292079,9292078,TXFE7,128,9926,1,29423,15893,14683
9292092,9292088,TXFE7,128,9927,1,29424,15894,14684
9292179,9292178,TXFE7,128,9927,2,29426,15895,14685
9292204,9292195,TXFE7,128,9927,2,29428,15896,14687
9292217,9292211,TXFE7,128,9927,14,29442,15897,14692
9292242,9292234,TXFE7,128,9928,1,29443,15898,14693
9292254,9292243,TXFE7,128,9928,1,29444,15899,14694
9292304,9292298,TXFE7,128,9927,1,29445,15900,14695
9292304,9292302,TXFE7,128,9928,1,29446,15901,14696
9292317,9292305,TXFE7,128,9928,4,29450,15902,14700
9292317,9292315,TXFE7,128,9927,1,29451,15903,14701
9292329,9292323,TXFE7,128,9928,5,29456,15904,14704
9292367,9292356,TXFE7,128,9928,1,29457,15905,14705
9292367,9292359,TXFE7,128,9928,2,29459,15906,14706
9292367,9292366,TXFE7,128,9927,2,29461,15907,14707
9292379,9292379,TXFE7,128,9927,1,29462,15908,14708
9292404,9292399,TXFE7,128,9928,5,29467,15909,14711
9292417,9292406,TXFE7,128,9928,4,29471,15910,14713
9292442,9292442,TXFE7,128,9927,1,29472,15911,14714
9292454,9292450,TXFE7,128,9928,1,29473,15912,14715
9292467,9292458,TXFE7,128,9928,1,29474,15913,14716
9292479,9292479,TXFE7,128,9928,1,29475,15914,14717
9292529,9292520,TXFE7,128,9928,1,29476,15915,14718
9292529,9292528,TXFE7,128,9927,1,29477,15916,14719
9292704,9292692,TXFE7,128,9929,11,29488,15917,14724
9292729,9292723,TXFE7,128,9930,1,29489,15918,14725
9292754,9292743,TXFE7,128,9929,1,29490,15919,14726
9292767,9292759,TXFE7,128,9930,1,29491,15920,14727
9292804,9292800,TXFE7,128,9930,8,29499,15921,14732
9292804,9292801,TXFE7,128,9930,1,29500,15922,14733
9292842,9292829,TXFE7,128,9930,1,29501,15923,14734
9292904,9292903,TXFE7,128,9930,1,29502,15924,14735
9292917,9292916,TXFE7,128,9930,1,29503,15925,14736
9292929,9292929,TXFE7,128,9929,1,29504,15926,14737
9293042,9293035,TXFE7,128,9929,6,29510,15927,14738
9293154,9293145,TXFE7,128,9929,1,29511,15928,14739
9293242,9293232,TXFE7,128,9929,2,29513,15929,14740
9293279,9293274,TXFE7,128,9930,1,29514,15930,14741
9293379,9293374,TXFE7,128,9930,5,29519,15931,14746
9293454,9293447,TXFE7,128,9930,2,29521,15932,14747
9293542,9293536,TXFE7,128,9930,1,29522,15933,14748
9293642,9293639,TXFE7,128,9930,1,29523,15934,14749
9293804,9293800,TXFE7,128,9930,1,29524,15935,14750
9293817,9293809,TXFE7,128,9929,1,29525,15936,14751
9293854,9293843,TXFE7,128,9929,1,29526,15937,14752
9293879,9293871,TXFE7,128,9929,4,29530,15938,14753
9293979,9293967,TXFE7,128,9930,10,29540,15939,14758
9294354,9294347,TXFE7,128,9930,1,29541,15940,14759
9294417,9294408,TXFE7,128,9930,2,29543,15941,14761
9294442,9294440,TXFE7,128,9930,1,29544,15942,14762
9294479,9294468,TXFE7,128,9930,1,29545,15943,14763
9294542,9294535,TXFE7,128,9930,1,29546,15944,14764
9294617,9294613,TXFE7,128,9929,2,29548,15945,14765
9294642,9294637,TXFE7,128,9929,1,29549,15946,14766
9294754,9294753,TXFE7,128,9929,1,29550,15947,14767
9294867,9294862,TXFE7,128,9929,3,29553,15949,14768
9294992,9294982,TXFE7,128,9930,1,29554,15950,14769
9295092,9295084,TXFE7,128,9929,5,29559,15954,14770
9295117,9295112,TXFE7,128,9930,1,29560,15955,14771
9295217,9295207,TXFE7,128,9930,2,29562,15956,14773
9295242,9295242,TXFE7,128,9930,2,29564,15957,14775
9295342,9295338,TXFE7,128,9930,1,29565,15958,14776
9295467,9295461,TXFE7,128,9930,1,29566,15959,14777
9295492,9295483,TXFE7,128,9930,5,29571,15964,14782
9295692,9295683,TXFE7,128,9930,1,29572,15965,14783
9295692,9295689,TXFE7,128,9930,7,29579,15966,14788
9295929,9295923,TXFE7,128,9930,1,29580,15967,14789
9295954,9295950,TXFE7,128,9930,1,29581,15968,14790
9295954,9295953,TXFE7,128,9931,1,29582,15969,14791
9295979,9295979,TXFE7,128,9930,3,29585,15971,14792
9300029,9300017,TXFE7,128,9930,6,29591,15974,14793
9300029,9300018,TXFE7,128,9930,5,29596,15977,14794
9300029,9300018,TXFE7,128,9930,1,29597,15978,14795
9300029,9300018,TXFE7,128,9930,1,29598,15979,14796
9300054,9300049,TXFE7,128,9929,6,29604,15984,14797
9300092,9300079,TXFE7,128,9929,1,29605,15985,14798
9300104,9300099,TXFE7,128,9929,1,29606,15986,14799
9300154,9300143,TXFE7,128,9930,1,29607,15987,14800
9300192,9300180,TXFE7,128,9930,1,29608,15988,14801
9300192,9300184,TXFE7,128,9929,1,29609,15989,14802
9300204,9300196,TXFE7,128,9930,2,29611,15990,14803
9300204,9300202,TXFE7,128,9930,1,29612,15991,14804
9300217,9300207,TXFE7,128,9930,2,29614,15992,14805
9300217,9300212,TXFE7,128,9930,1,29615,15993,14806
9300217,9300216,TXFE7,128,9931,1,29616,15994,14807
9300242,9300232,TXFE7,128,9931,2,29618,15995,14809
9300242,9300237,TXFE7,128,9930,6,29624,15998,14810
9300267,9300262,TXFE7,128,9930,1,29625,15999,14811
9300267,9300267,TXFE7,128,9931,2,29627,16000,14813
9300279,9300272,TXFE7,128,9931,5,29632,16001,14817
9300279,9300272,TXFE7,128,9931,8,29640,16002,14821
9300292,9300279,TXFE7,128,9931,4,29644,16003,14823
9300292,9300280,TXFE7,128,9931,6,29650,16004,14829
9300354,9300354,TXFE7,128,9932,6,29656,16005,14834
9300367,9300354,TXFE7,128,9932,15,29671,16006,14844
9300367,9300354,TXFE7,128,9932,2,29673,16007,14845
9300367,9300355,TXFE7,128,9932,2,29675,16008,14847
9300367,9300366,TXFE7,128,9931,3,29678,16011,14848
9300379,9300370,TXFE7,128,9933,1,29679,16012,14849
9300379,9300372,TXFE7,128,9932,1,29680,16013,14850
9300392,9300380,TXFE7,128,9933,3,29683,16014,14852
9300392,9300385,TXFE7,128,9933,1,29684,16015,14853
9300404,9300404,TXFE7,128,9933,1,29685,16016,14854
9300429,9300428,TXFE7,128,9933,5,29690,16017,14857
9300429,9300429,TXFE7,128,9933,1,29691,16018,14858
9300442,9300429,TXFE7,128,9933,16,29707,16019,14874
9300442,9300436,TXFE7,128,9933,1,29708,16020,14875
9300454,9300454,TXFE7,128,9933,1,29709,16021,14876
9300467,9300462,TXFE7,128,9933,2,29711,16022,14877
9300467,9300465,TXFE7,128,9933,6,29717,16023,14879
9300492,9300481,TXFE7,128,9933,2,29719,16024,14880
9300504,9300496,TXFE7,128,9933,1,29720,16025,14881
9300504,9300503,TXFE7,128,9933,2,29722,16026,14882
9300517,9300505,TXFE7,128,9933,1,29723,16027,14883
9300542,9300538,TXFE7,128,9934,2,29725,16028,14885
9300554,9300548,TXFE7,128,9934,1,29726,16029,14886
9300567,9300554,TXFE7,128,9934,12,29738,16030,14891
9300567,9300557,TXFE7,128,9933,1,29739,16031,14892
9300567,9300565,TXFE7,128,9934,5,29744,16032,14895
9300579,9300567,TXFE7,128,9934,2,29746,16033,14897
9300579,9300567,TXFE7,128,9934,21,29767,16034,14912
9300592,9300591,TXFE7,128,9934,1,29768,16035,14913
9300629,9300618,TXFE7,128,9935,1,29769,16036,14914
9300642,9300632,TXFE7,128,9935,1,29770,16037,14915
9300642,9300639,TXFE7,128,9935,9,29779,16038,14923
9300654,9300648,TXFE7,128,9935,2,29781,16039,14925
9300667,9300663,TXFE7,128,9935,1,29782,16040,14926
9300679,9300668,TXFE7,128,9935,1,29783,16041,14927
9300679,9300670,TXFE7,128,9935,2,29785,16042,14929
9300679,9300671,TXFE7,128,9935,1,29786,16043,14930
9300679,9300672,TXFE7,128,9935,1,29787,16044,14931
9300679,9300678,TXFE7,128,9935,5,29792,16045,14936
9300692,9300683,TXFE7,128,9935,2,29794,16046,14937
9300692,9300691,TXFE7,128,9934,1,29795,16047,14938
9300692,9300691,TXFE7,128,9935,5,29800,16048,14939
9300704,9300694,TXFE7,128,9935,1,29801,16049,14940
9300704,9300695,TXFE7,128,9935,1,29802,16050,14941
9300704,9300700,TXFE7,128,9934,2,29804,16051,14942
9300717,9300713,TXFE7,128,9935,1,29805,16052,14943
9300729,9300718,TXFE7,128,9935,1,29806,16053,14944
9300729,9300719,TXFE7,128,9935,5,29811,16054,14945
9300742,9300729,TXFE7,128,9935,1,29812,16055,14946
9300754,9300743,TXFE7,128,9935,1,29813,16056,14947
9300754,9300743,TXFE7,128,9935,8,29821,16057,14949
9300754,9300744,TXFE7,128,9934,1,29822,16058,14950
9300779,9300775,TXFE7,128,9935,1,29823,16059,14951
9300792,9300780,TXFE7,128,9935,1,29824,16060,14952
9300792,9300787,TXFE7,128,9934,1,29825,16061,14953
9300792,9300789,TXFE7,128,9935,2,29827,16062,14954
9300792,9300791,TXFE7,128,9935,16,29843,16063,14955
9300804,9300799,TXFE7,128,9935,1,29844,16064,14956
9300817,9300812,TXFE7,128,9935,1,29845,16065,14957
9300854,9300843,TXFE7,128,9935,5,29850,16066,14958
9300854,9300846,TXFE7,128,9935,5,29855,16067,14959
9300854,9300852,TXFE7,128,9935,5,29860,16068,14964
9300867,9300856,TXFE7,128,9935,3,29863,16069,14967
9300879,9300867,TXFE7,128,9935,10,29873,16070,14968
9300904,9300896,TXFE7,128,9935,10,29883,16071,14975
9300904,9300904,TXFE7,128,9934,2,29885,16073,14976
9300917,9300909,TXFE7,128,9935,1,29886,16074,14977
9300917,9300913,TXFE7,128,9935,1,29887,16075,14978
9300929,9300922,TXFE7,128,9935,10,29897,16076,14986
9300929,9300929,TXFE7,128,9935,1,29898,16077,14987
9300954,9300943,TXFE7,129,9935,4,29908,16078,14995
9300954,9300943,TXFE7,129,9936,6,29908,16078,14995
9300954,9300945,TXFE7,128,9936,1,29909,16079,14996
9300967,9300957,TXFE7,128,9935,1,29910,16080,14997
9300967,9300957,TXFE7,128,9935,4,29914,16081,14998
9300967,9300960,TXFE7,128,9936,1,29915,16082,14999
9300967,9300964,TXFE7,128,9936,8,29923,16083,15003
9300967,9300964,TXFE7,128,9936,1,29924,16084,15004
9300967,9300966,TXFE7,128,9936,10,29934,16085,15010
9300979,9300967,TXFE7,128,9935,3,29937,16088,15011
9300979,9300967,TXFE7,128,9935,1,29938,16089,15012
9300979,9300968,TXFE7,128,9936,10,29948,16090,15016
9300979,9300969,TXFE7,128,9936,10,29958,16091,15017
9300979,9300970,TXFE7,128,9935,3,29961,16092,15018
9300992,9300987,TXFE7,128,9935,1,29962,16093,15019
9301004,9300994,TXFE7,128,9936,1,29963,16094,15020
9301004,9300996,TXFE7,128,9936,3,29966,16095,15021
9301004,9300997,TXFE7,128,9935,9,29975,16100,15022
9301004,9301001,TXFE7,128,9936,1,29976,16101,15023
9301004,9301001,TXFE7,128,9936,1,29977,16102,15024
9301017,9301007,TXFE7,128,9935,1,29978,16103,15025
9301017,9301011,TXFE7,128,9935,1,29979,16104,15026
9301029,9301017,TXFE7,128,9935,5,29984,16105,15027
9301029,9301017,TXFE7,128,9935,1,29985,16106,15028
9301054,9301047,TXFE7,128,9935,1,29986,16107,15029
9301067,9301054,TXFE7,128,9935,1,29987,16108,15030
9301079,9301070,TXFE7,128,9935,1,29988,16109,15031
9301079,9301071,TXFE7,128,9935,1,29989,16110,15032
9301079,9301076,TXFE7,128,9935,5,29994,16111,15034
9301092,9301080,TXFE7,128,9935,2,29996,16112,15035
9301104,9301100,TXFE7,128,9935,1,29997,16113,15036
9301104,9301100,TXFE7,128,9935,10,30007,16114,15042
9301104,9301103,TXFE7,128,9935,2,30009,16115,15043
9301142,9301131,TXFE7,128,9935,1,30010,16116,15044
9301142,9301142,TXFE7,128,9935,1,30011,16117,15045
9301179,9301168,TXFE7,128,9935,1,30012,16118,15046
9301179,9301170,TXFE7,128,9934,23,30035,16129,15047
9301204,9301192,TXFE7,128,9934,1,30036,16130,15048
9301204,9301192,TXFE7,128,9934,2,30038,16131,15049
9301204,9301202,TXFE7,128,9935,2,30040,16132,15051
9301217,9301213,TXFE7,128,9934,1,30041,16133,15052
9301254,9301244,TXFE7,128,9935,5,30046,16134,15054
9301304,9301299,TXFE7,128,9934,3,30049,16136,15055
9301317,9301308,TXFE7,128,9934,1,30050,16137,15056
9301317,9301309,TXFE7,128,9934,1,30051,16138,15057
9301329,9301320,TXFE7,128,9934,2,30053,16139,15058
9301329,9301321,TXFE7,128,9934,1,30054,16140,15059
9301342,9301334,TXFE7,128,9934,2,30056,16141,15060
9301354,9301348,TXFE7,128,9933,21,30077,16149,15061
9301367,9301354,TXFE7,128,9933,8,30085,16150,15062
9301367,9301354,TXFE7,128,9933,1,30086,16151,15063
9301367,9301354,TXFE7,128,9933,1,30087,16152,15064
9301367,9301354,TXFE7,128,9933,6,30093,16157,15065
9301367,9301354,TXFE7,128,9933,2,30095,16158,15066
9301367,9301354,TXFE7,128,9933,9,30104,16162,15067
9301367,9301362,TXFE7,128,9932,1,30105,16163,15068
9301392,9301384,TXFE7,128,9933,1,30106,16164,15069
9301417,9301407,TXFE7,128,9933,1,30107,16165,15070
9301417,9301416,TXFE7,128,9933,1,30108,16166,15071
9301492,9301490,TXFE7,128,9932,3,30111,16167,15072
9301604,9301600,TXFE7,128,9932,4,30115,16169,15073
9301742,9301733,TXFE7,128,9933,1,30116,16170,15074
9301779,9301778,TXFE7,128,9933,1,30117,16171,15075
9301804,9301798,TXFE7,128,9933,1,30118,16172,15076
9301817,9301815,TXFE7,128,9933,2,30120,16173,15078
9301817,9301817,TXFE7,128,9933,1,30121,16174,15079
9301829,9301821,TXFE7,128,9932,1,30122,16175,15080
9301829,9301822,TXFE7,129,9933,23,30147,16176,15095
9301829,9301822,TXFE7,129,9934,2,30147,16176,15095
9301854,9301842,TXFE7,128,9933,1,30148,16177,15096
9302004,9301997,TXFE7,128,9933,7,30155,16183,15097
9302054,9302053,TXFE7,128,9933,1,30156,16184,15098
9302129,9302126,TXFE7,128,9933,1,30157,16185,15099
9302167,9302156,TXFE7,128,9933,1,30158,16186,15100
9302204,9302195,TXFE7,128,9933,1,30159,16187,15101
9302204,9302202,TXFE7,128,9933,1,30160,16188,15102
9302229,9302220,TXFE7,128,9933,1,30161,16189,15103
9302267,9302264,TXFE7,128,9933,1,30162,16190,15104
9302317,9302306,TXFE7,128,9934,1,30163,16191,15105
9302329,9302326,TXFE7,128,9933,1,30164,16192,15106
9302379,9302371,TXFE7,128,9934,2,30166,16193,15107
9302442,9302429,TXFE7,128,9934,1,30167,16194,15108
9302492,9302491,TXFE7,128,9934,1,30168,16195,15109
9302504,9302494,TXFE7,128,9934,10,30178,16196,15117
9302517,9302505,TXFE7,128,9934,1,30179,16197,15118
9302517,9302506,TXFE7,128,9934,1,30180,16198,15119
9302517,9302507,TXFE7,128,9934,2,30182,16199,15120
9302542,9302534,TXFE7,128,9934,1,30183,16200,15121
9302542,9302536,TXFE7,128,9934,1,30184,16201,15122
9302542,9302537,TXFE7,128,9933,2,30186,16203,15123
9302579,9302576,TXFE7,128,9934,3,30189,16206,15124
9302592,9302581,TXFE7,128,9934,1,30190,16207,15125
9302604,9302596,TXFE7,128,9933,1,30191,16208,15126
9302617,9302615,TXFE7,128,9934,2,30193,16209,15127
9302629,9302621,TXFE7,128,9934,1,30194,16210,15128
9302642,9302640,TXFE7,128,9934,1,30195,16211,15129
9302642,9302641,TXFE7,128,9933,1,30196,16212,15130
9302692,9302691,TXFE7,128,9933,1,30197,16213,15131
9302704,9302692,TXFE7,128,9933,4,30201,16217,15132
9302742,9302729,TXFE7,128,9933,1,30202,16218,15133
9302742,9302739,TXFE7,128,9933,1,30203,16219,15134
9302804,9302795,TXFE7,128,9933,1,30204,16220,15135
9302817,9302815,TXFE7,128,9933,1,30205,16221,15136
9302879,9302874,TXFE7,128,9933,2,30207,16223,15137
9302879,9302879,TXFE7,128,9933,1,30208,16224,15138
9302954,9302945,TXFE7,128,9933,1,30209,16225,15139
9303042,9303041,TXFE7,128,9933,2,30211,16226,15140
9303104,9303101,TXFE7,128,9933,1,30212,16227,15141
9303117,9303107,TXFE7,128,9933,1,30213,16228,15142
9303167,9303167,TXFE7,128,9933,1,30214,16229,15143
9303342,9303330,TXFE7,128,9933,1,30215,16230,15144
9303342,9303340,TXFE7,128,9933,1,30216,16231,15145
9303404,9303398,TXFE7,128,9934,1,30217,16232,15146
9303529,9303517,TXFE7,128,9933,1,30218,16233,15147
9303579,9303576,TXFE7,128,9933,1,30219,16234,15148
9303654,9303652,TXFE7,128,9934,2,30221,16235,15149
9303679,9303674,TXFE7,128,9933,1,30222,16236,15150
9303717,9303715,TXFE7,128,9933,2,30224,16237,15151
9303717,9303715,TXFE7,128,9934,35,30259,16238,15169
9303804,9303799,TXFE7,128,9934,5,30264,16241,15170
9303929,9303918,TXFE7,128,9934,1,30265,16242,15171
9303929,9303928,TXFE7,128,9934,1,30266,16243,15172
9303954,9303944,TXFE7,128,9934,1,30267,16244,15173
9303992,9303982,TXFE7,128,9935,1,30268,16245,15174
9304054,9304054,TXFE7,128,9934,1,30269,16246,15175
9304054,9304054,TXFE7,128,9934,1,30270,16247,15176
9304067,9304063,TXFE7,128,9934,13,30283,16251,15177
9304092,9304081,TXFE7,128,9934,2,30285,16252,15178
9304104,9304096,TXFE7,128,9934,1,30286,16253,15179
9304142,9304130,TXFE7,128,9934,1,30287,16254,15180
9304154,9304146,TXFE7,128,9934,1,30288,16255,15181
9304179,9304169,TXFE7,128,9933,1,30289,16256,15182
9304242,9304235,TXFE7,128,9934,2,30291,16257,15184
9304304,9304292,TXFE7,128,9933,1,30292,16258,15185
9304329,9304321,TXFE7,128,9934,2,30294,16259,15187
9304342,9304335,TXFE7,128,9934,3,30297,16260,15190
9304354,9304344,TXFE7,128,9933,1,30298,16261,15191
9304392,9304390,TXFE7,128,9933,1,30299,16262,15192
9304417,9304405,TXFE7,128,9933,1,30300,16263,15193
9304479,9304473,TXFE7,128,9933,1,30301,16264,15194
9304492,9304489,TXFE7,128,9933,3,30304,16267,15195
9304567,9304566,TXFE7,128,9933,4,30308,16271,15196
9304692,9304687,TXFE7,128,9934,4,30312,16272,15197
9304729,9304723,TXFE7,128,9933,1,30313,16273,15198
9304779,9304770,TXFE7,128,9934,1,30314,16274,15199
9305092,9305084,TXFE7,128,9933,1,30315,16275,15200
9305117,9305112,TXFE7,128,9933,1,30316,16276,15201
9305129,9305120,TXFE7,128,9933,1,30317,16277,15202
9305129,9305122,TXFE7,128,9933,5,30322,16281,15203
9305142,9305137,TXFE7,128,9932,1,30323,16282,15204
9305154,9305142,TXFE7,128,9933,1,30324,16283,15205
9305167,9305155,TXFE7,128,9934,1,30325,16284,15206
9305179,9305169,TXFE7,128,9933,1,30326,16285,15207
9305179,9305176,TXFE7,128,9933,1,30327,16286,15208
9305192,9305179,TXFE7,128,9933,2,30329,16287,15209
9305192,9305179,TXFE7,128,9933,1,30330,16288,15210
9305254,9305248,TXFE7,128,9933,1,30331,16289,15211
9305379,9305372,TXFE7,128,9932,1,30332,16290,15212
9305379,9305379,TXFE7,128,9933,1,30333,16291,15213
9305392,9305392,TXFE7,128,9932,1,30334,16292,15214
9305454,9305446,TXFE7,128,9932,2,30336,16293,15215
9305454,9305451,TXFE7,128,9932,1,30337,16294,15216
9305479,9305471,TXFE7,128,9933,1,30338,16295,15217
9305492,9305491,TXFE7,128,9932,1,30339,16296,15218
9305542,9305540,TXFE7,128,9932,1,30340,16297,15219
9305629,9305619,TXFE7,128,9932,2,30342,16299,15220
9305692,9305679,TXFE7,128,9932,1,30343,16300,15221
9305742,9305736,TXFE7,128,9932,1,30344,16301,15222
9305842,9305837,TXFE7,128,9932,1,30345,16302,15223
9305842,9305841,TXFE7,128,9932,2,30347,16304,15224
9305929,9305924,TXFE7,128,9932,1,30348,16305,15225
9305954,9305947,TXFE7,128,9933,1,30349,16306,15226
9305992,9305984,TXFE7,128,9932,2,30351,16308,15227
9310054,9310047,TXFE7,128,9932,1,30352,16309,15228
9310067,9310059,TXFE7,128,9932,1,30353,16310,15229
9310067,9310062,TXFE7,128,9932,2,30355,16311,15230
9310104,9310094,TXFE7,128,9932,1,30356,16312,15231
9310154,9310148,TXFE7,128,9932,2,30358,16313,15232
9310154,9310150,TXFE7,128,9932,1,30359,16314,15233
9310217,9310214,TXFE7,128,9932,1,30360,16315,15234
9310279,9310270,TXFE7,128,9933,1,30361,16316,15235
9310317,9310310,TXFE7,128,9932,1,30362,16317,15236
9310329,9310320,TXFE7,128,9932,2,30364,16318,15237
9310404,9310395,TXFE7,128,9932,1,30365,16319,15238
9310404,9310402,TXFE7,128,9932,1,30366,16320,15239
9310542,9310538,TXFE7,128,9932,1,30367,16321,15240
9310567,9310564,TXFE7,128,9933,1,30368,16322,15241
9310579,9310571,TXFE7,128,9932,1,30369,16323,15242
9310617,9310604,TXFE7,128,9933,1,30370,16324,15243
9310717,9310706,TXFE7,128,9932,1,30371,16325,15244
9310742,9310737,TXFE7,128,9933,7,30378,16326,15250
9310754,9310742,TXFE7,128,9933,4,30382,16327,15253
9310754,9310742,TXFE7,128,9933,2,30384,16328,15255
9310754,9310747,TXFE7,128,9933,1,30385,16329,15256
9310792,9310790,TXFE7,128,9933,1,30386,16330,15257
9310842,9310836,TXFE7,128,9933,1,30387,16331,15258
9310904,9310893,TXFE7,128,9933,1,30388,16332,15259
9310942,9310935,TXFE7,128,9933,1,30389,16333,15260
9311079,9311068,TXFE7,128,9933,1,30390,16334,15261
9311079,9311070,TXFE7,128,9934,1,30391,16335,15262
9311079,9311076,TXFE7,128,9933,1,30392,16336,15263
9311142,9311134,TXFE7,128,9934,1,30393,16337,15264
9311154,9311153,TXFE7,128,9933,18,30411,16346,15265
9311204,9311194,TXFE7,128,9933,13,30424,16347,15267
9311242,9311238,TXFE7,128,9933,1,30425,16348,15268
9311267,9311255,TXFE7,128,9934,2,30427,16349,15270
9311492,9311480,TXFE7,128,9934,1,30428,16350,15271
9311492,9311489,TXFE7,128,9934,2,30430,16351,15272
9311504,9311504,TXFE7,128,9934,1,30431,16352,15273
9311579,9311568,TXFE7,128,9934,1,30432,16353,15274
9311604,9311598,TXFE7,128,9934,44,30476,16354,15299
9311654,9311654,TXFE7,128,9934,1,30477,16355,15300
9311667,9311657,TXFE7,128,9935,3,30480,16356,15302
9311667,9311658,TXFE7,128,9935,4,30484,16357,15303
9311679,9311672,TXFE7,128,9934,1,30485,16358,15304
9311692,9311686,TXFE7,128,9934,6,30491,16362,15305
9311729,9311727,TXFE7,128,9935,1,30492,16363,15306
9311742,9311731,TXFE7,128,9934,1,30493,16364,15307
9311754,9311754,TXFE7,128,9935,1,30494,16365,15308
9311767,9311756,TXFE7,128,9935,77,30571,16366,15349
9311779,9311771,TXFE7,128,9936,8,30579,16367,15353
9311779,9311771,TXFE7,128,9936,6,30585,16368,15357
9311779,9311771,TXFE7,128,9936,2,30587,16369,15359
9311779,9311771,TXFE7,128,9936,4,30591,16370,15360
9311779,9311771,TXFE7,128,9936,1,30592,16371,15361
9311779,9311771,TXFE7,128,9936,1,30593,16372,15362
9311779,9311771,TXFE7,128,9936,2,30595,16373,15364
9311779,9311771,TXFE7,128,9936,2,30597,16374,15366
9311779,9311771,TXFE7,128,9936,1,30598,16375,15367
9311779,9311771,TXFE7,128,9936,2,30600,16376,15369
9311779,9311771,TXFE7,128,9936,2,30602,16377,15370
9311779,9311772,TXFE7,128,9936,3,30605,16378,15372
9311779,9311772,TXFE7,128,9936,1,30606,16379,15373
9311779,9311776,TXFE7,128,9936,1,30607,16380,15374
9311792,9311779,TXFE7,128,9936,5,30612,16381,15378
9311792,9311779,TXFE7,128,9936,1,30613,16382,15379
9311792,9311779,TXFE7,128,9936,1,30614,16383,15380
9311792,9311779,TXFE7,128,9936,1,30615,16384,15381
9311792,9311779,TXFE7,128,9936,12,30627,16385,15388
9311792,9311779,TXFE7,128,9936,2,30629,16386,15390
9311792,9311779,TXFE7,128,9936,4,30633,16387,15392
9311792,9311779,TXFE7,128,9936,4,30637,16388,15396
9311792,9311779,TXFE7,128,9936,1,30638,16389,15397
9311792,9311780,TXFE7,128,9937,12,30650,16390,15409
9311792,9311780,TXFE7,128,9937,10,30660,16391,15417
9311804,9311792,TXFE7,128,9937,6,30666,16392,15422
9311804,9311792,TXFE7,128,9937,7,30673,16393,15428
9311804,9311794,TXFE7,128,9937,1,30674,16394,15429
9311804,9311797,TXFE7,128,9937,1,30675,16395,15430
9311804,9311799,TXFE7,128,9936,2,30677,16396,15431
9311817,9311805,TXFE7,128,9937,1,30678,16397,15432
9311817,9311808,TXFE7,128,9937,1,30679,16398,15433
9311817,9311809,TXFE7,128,9937,2,30681,16399,15434
9311817,9311809,TXFE7,128,9937,1,30682,16400,15435
9311817,9311810,TXFE7,128,9937,3,30685,16401,15438
9311817,9311813,TXFE7,128,9937,1,30686,16402,15439
9311817,9311814,TXFE7,128,9937,1,30687,16403,15440
9311817,9311815,TXFE7,128,9937,1,30688,16404,15441
9311817,9311817,TXFE7,128,9937,1,30689,16405,15442
9311829,9311820,TXFE7,128,9937,1,30690,16406,15443
9311829,9311820,TXFE7,128,9937,2,30692,16407,15445
9311829,9311823,TXFE7,128,9936,3,30695,16408,15446
9311829,9311825,TXFE7,128,9937,1,30696,16409,15447
9311829,9311827,TXFE7,128,9936,1,30697,16410,15448
9311842,9311831,TXFE7,128,9937,1,30698,16411,15449
9311842,9311835,TXFE7,128,9937,3,30701,16412,15452
9311842,9311837,TXFE7,128,9937,1,30702,16413,15453
9311842,9311838,TXFE7,128,9937,2,30704,16414,15454
9311854,9311843,TXFE7,128,9937,1,30705,16415,15455
9311854,9311852,TXFE7,128,9937,1,30706,16416,15456
9311867,9311864,TXFE7,128,9937,1,30707,16417,15457
9311867,9311864,TXFE7,128,9937,2,30709,16418,15458
9311879,9311867,TXFE7,128,9936,6,30715,16420,15459
9311892,9311883,TXFE7,128,9937,4,30719,16421,15460
9311904,9311894,TXFE7,128,9937,1,30720,16422,15461
9311917,9311905,TXFE7,128,9937,1,30721,16423,15462
9311917,9311913,TXFE7,128,9936,1,30722,16424,15463
9311954,9311945,TXFE7,128,9937,1,30723,16425,15464
9311954,9311953,TXFE7,128,9937,1,30724,16426,15465
9311967,9311954,TXFE7,128,9937,2,30726,16427,15466
9311979,9311967,TXFE7,128,9937,1,30727,16428,15467
9311979,9311970,TXFE7,128,9936,1,30728,16429,15468
9311979,9311972,TXFE7,128,9937,1,30729,16430,15469
9311979,9311979,TXFE7,128,9936,1,30730,16431,15470
9312004,9312003,TXFE7,128,9936,10,30740,16436,15471
9312017,9312004,TXFE7,128,9936,4,30744,16440,15472
9312017,9312007,TXFE7,128,9935,1,30745,16441,15473
9312017,9312009,TXFE7,128,9936,1,30746,16442,15474
9312042,9312030,TXFE7,128,9936,2,30748,16443,15475
9312042,9312033,TXFE7,128,9936,1,30749,16444,15476
9312042,9312034,TXFE7,128,9935,2,30751,16446,15477
9312042,9312034,TXFE7,128,9935,2,30753,16448,15478
9312042,9312037,TXFE7,128,9936,1,30754,16449,15479
9312042,9312040,TXFE7,128,9936,1,30755,16450,15480
9312054,9312042,TXFE7,128,9935,1,30756,16451,15481
9312054,9312042,TXFE7,128,9935,2,30758,16453,15482
9312092,9312081,TXFE7,128,9935,1,30759,16454,15483
9312092,9312084,TXFE7,128,9934,1,30760,16455,15484
9312104,9312096,TXFE7,128,9935,1,30761,16456,15485
9312104,9312097,TXFE7,128,9935,1,30762,16457,15486
9312117,9312106,TXFE7,128,9935,2,30764,16458,15487
9312142,9312133,TXFE7,128,9936,1,30765,16459,15488
9312179,9312175,TXFE7,128,9935,1,30766,16460,15489
9312204,9312198,TXFE7,128,9935,1,30767,16461,15490
9312254,9312254,TXFE7,128,9936,2,30769,16462,15492
9312267,9312256,TXFE7,128,9936,3,30772,16463,15494
9312367,9312362,TXFE7,128,9935,1,30773,16464,15495
9312417,9312414,TXFE7,128,9936,2,30775,16465,15496
9312429,9312424,TXFE7,128,9936,3,30778,16466,15497
9312492,9312480,TXFE7,128,9935,2,30780,16468,15498
9312517,9312515,TXFE7,129,9936,4,30786,16469,15503
9312517,9312515,TXFE7,129,9937,2,30786,16469,15503
9312542,9312537,TXFE7,128,9937,1,30787,16470,15504
9312567,9312561,TXFE7,129,9936,1,30789,16471,15506
9312567,9312561,TXFE7,129,9937,1,30789,16471,15506
9312604,9312602,TXFE7,128,9936,2,30791,16472,15507
9312617,9312606,TXFE7,128,9937,1,30792,16473,15508
9312629,9312618,TXFE7,128,9937,5,30797,16474,15513
9312704,9312697,TXFE7,128,9937,1,30798,16475,15514
9312704,9312698,TXFE7,128,9937,2,30800,16476,15516
9312704,9312699,TXFE7,128,9937,3,30803,16477,15519
9312729,9312719,TXFE7,128,9937,1,30804,16478,15520
9312729,9312725,TXFE7,128,9937,1,30805,16479,15521
9312729,9312728,TXFE7,128,9936,1,30806,16480,15522
9312754,9312742,TXFE7,128,9937,19,30825,16481,15531
9312754,9312751,TXFE7,128,9937,1,30826,16482,15532
9312779,9312774,TXFE7,128,9937,1,30827,16483,15533
9312792,9312781,TXFE7,128,9937,4,30831,16484,15534
9312792,9312789,TXFE7,129,9937,1,30837,16487,15535
9312792,9312789,TXFE7,129,9936,5,30837,16487,15535
9312804,9312803,TXFE7,128,9937,1,30838,16488,15536
9312817,9312814,TXFE7,128,9936,1,30839,16489,15537
9312817,9312816,TXFE7,128,9936,1,30840,16490,15538
9312829,9312817,TXFE7,128,9937,2,30842,16491,15540
9312829,9312819,TXFE7,128,9937,5,30847,16492,15544
9312829,9312828,TXFE7,128,9937,1,30848,16493,15545
9312842,9312835,TXFE7,128,9937,18,30866,16494,15554
9312867,9312861,TXFE7,128,9937,1,30867,16495,15555
9312892,9312890,TXFE7,128,9936,1,30868,16496,15556
9312917,9312915,TXFE7,128,9937,10,30878,16497,15559
9312929,9312922,TXFE7,128,9936,1,30879,16498,15560
9312929,9312925,TXFE7,128,9937,1,30880,16499,15561
9312929,9312927,TXFE7,128,9937,1,30881,16500,15562
9312967,9312957,TXFE7,128,9936,1,30882,16501,15563
9313017,9313010,TXFE7,128,9937,1,30883,16502,15564
9313042,9313034,TXFE7,128,9937,1,30884,16503,15565
9313092,9313091,TXFE7,128,9937,1,30885,16504,15566
9313117,9313105,TXFE7,128,9937,3,30888,16505,15567
9313129,9313128,TXFE7,128,9937,1,30889,16506,15568
9313142,9313132,TXFE7,128,9937,1,30890,16507,15569
9313142,9313133,TXFE7,128,9937,1,30891,16508,15570
9313142,9313139,TXFE7,128,9937,1,30892,16509,15571
9313154,9313153,TXFE7,128,9937,1,30893,16510,15572
9313317,9313306,TXFE7,128,9937,1,30894,16511,15573
9313317,9313307,TXFE7,128,9937,1,30895,16512,15574
9313342,9313340,TXFE7,128,9937,1,30896,16513,15575
9313392,9313391,TXFE7,128,9937,1,30897,16514,15576
9313404,9313401,TXFE7,128,9936,1,30898,16515,15577
9313429,9313429,TXFE7,128,9937,1,30899,16516,15578
9313454,9313444,TXFE7,128,9937,1,30900,16517,15579
9313454,9313448,TXFE7,128,9936,2,30902,16519,15580
9313454,9313449,TXFE7,128,9937,3,30905,16520,15582
9313517,9313513,TXFE7,128,9937,1,30906,16521,15583
9313529,9313527,TXFE7,128,9936,1,30907,16522,15584
9313542,9313530,TXFE7,128,9936,59,30966,16542,15585
9313554,9313546,TXFE7,128,9935,2,30968,16544,15586
9313554,9313553,TXFE7,128,9936,10,30978,16545,15589
9313567,9313566,TXFE7,128,9936,2,30980,16546,15590
9313579,9313570,TXFE7,128,9936,1,30981,16547,15591
9313592,9313587,TXFE7,128,9936,1,30982,16548,15592
9313604,9313594,TXFE7,128,9936,1,30983,16549,15593
9313742,9313730,TXFE7,128,9936,1,30984,16550,15594
9313754,9313753,TXFE7,128,9936,1,30985,16551,15595
9313842,9313842,TXFE7,128,9935,2,30987,16553,15596
9313867,9313865,TXFE7,128,9935,21,31008,16562,15597
9313879,9313867,TXFE7,128,9935,18,31026,16567,15598
9313942,9313936,TXFE7,128,9934,1,31027,16568,15599
9314042,9314029,TXFE7,128,9935,1,31028,16569,15600
9314129,9314122,TXFE7,128,9935,2,31030,16570,15601
9314179,9314169,TXFE7,128,9935,2,31032,16571,15603
9314242,9314239,TXFE7,128,9935,1,31033,16572,15604
9314367,9314354,TXFE7,128,9936,1,31034,16573,15605
9314379,9314378,TXFE7,128,9936,1,31035,16574,15606
9314392,9314387,TXFE7,128,9935,2,31037,16576,15607
9314479,9314479,TXFE7,128,9936,1,31038,16577,15608
9314492,9314488,TXFE7,128,9935,1,31039,16578,15609
9314504,9314497,TXFE7,128,9935,4,31043,16580,15610
9314529,9314526,TXFE7,128,9935,3,31046,16581,15611
9314604,9314593,TXFE7,128,9935,1,31047,16582,15612
9314604,9314594,TXFE7,128,9936,3,31050,16583,15615
9314717,9314716,TXFE7,128,9936,1,31051,16584,15616
9314842,9314830,TXFE7,128,9936,1,31052,16585,15617
9314854,9314845,TXFE7,128,9935,1,31053,16586,15618
9314867,9314860,TXFE7,128,9936,11,31064,16587,15624
9314879,9314879,TXFE7,128,9935,1,31065,16588,15625
9314892,9314883,TXFE7,128,9936,1,31066,16589,15626
9314904,9314899,TXFE7,128,9935,1,31067,16590,15627
9314917,9314915,TXFE7,128,9935,1,31068,16591,15628
9314929,9314920,TXFE7,128,9935,1,31069,16592,15629
9315067,9315060,TXFE7,128,9935,2,31071,16594,15630
9315129,9315127,TXFE7,128,9935,1,31072,16595,15631
9315142,9315131,TXFE7,128,9936,1,31073,16596,15632
9315167,9315162,TXFE7,128,9936,2,31075,16597,15634
9315217,9315215,TXFE7,128,9936,4,31079,16598,15638
9315292,9315285,TXFE7,128,9936,1,31080,16599,15639
9315342,9315331,TXFE7,128,9936,1,31081,16600,15640
9315417,9315405,TXFE7,128,9935,1,31082,16601,15641
9315442,9315433,TXFE7,128,9936,6,31088,16602,15645
9315554,9315554,TXFE7,128,9936,1,31089,16603,15646
9315642,9315632,TXFE7,128,9936,3,31092,16604,15647
9315679,9315674,TXFE7,128,9936,10,31102,16605,15650
9315717,9315705,TXFE7,128,9935,4,31106,16608,15651
9315879,9315878,TXFE7,128,9936,1,31107,16609,15652
9315929,9315918,TXFE7,128,9935,1,31108,16610,15653
9315929,9315925,TXFE7,128,9935,38,31146,16626,15654
9315992,9315989,TXFE7,128,9934,2,31148,16627,15655
9320042,9320031,TXFE7,128,9935,1,31149,16628,15656
9320067,9320054,TXFE7,128,9935,1,31150,16629,15657
9320092,9320085,TXFE7,128,9934,4,31154,16630,15658
9320117,9320112,TXFE7,128,9935,1,31155,16631,15659
9320117,9320114,TXFE7,128,9934,9,31164,16638,15660
9320117,9320114,TXFE7,128,9935,2,31166,16639,15661
9320129,9320122,TXFE7,128,9935,1,31167,16640,15662
9320179,9320173,TXFE7,128,9935,1,31168,16641,15663
9320242,9320231,TXFE7,128,9934,32,31200,16659,15664
9320254,9320242,TXFE7,128,9934,1,31201,16660,15665
9320279,9320274,TXFE7,128,9934,1,31202,16661,15666
9320317,9320306,TXFE7,128,9934,1,31203,16662,15667
9320367,9320359,TXFE7,128,9934,1,31204,16663,15668
9320379,9320371,TXFE7,128,9933,2,31206,16665,15669
9320379,9320372,TXFE7,128,9934,1,31207,16666,15670
9320379,9320377,TXFE7,128,9933,1,31208,16667,15671
9320417,9320406,TXFE7,128,9934,1,31209,16668,15672
9320554,9320542,TXFE7,128,9934,1,31210,16669,15673
9320567,9320560,TXFE7,128,9934,1,31211,16670,15674
9320604,9320600,TXFE7,128,9934,5,31216,16671,15677
9320642,9320637,TXFE7,128,9934,1,31217,16672,15678
9320754,9320745,TXFE7,128,9933,5,31222,16673,15679
9320929,9320917,TXFE7,128,9934,1,31223,16674,15680
9320954,9320942,TXFE7,128,9934,1,31224,16675,15681
9321004,9320994,TXFE7,128,9934,1,31225,16676,15682
9321029,9321018,TXFE7,128,9934,1,31226,16677,15683
9321029,9321023,TXFE7,128,9934,4,31230,16678,15684
9321054,9321043,TXFE7,128,9934,1,31231,16679,15685
9321167,9321155,TXFE7,128,9934,1,31232,16680,15686
9321379,9321369,TXFE7,128,9934,1,31233,16681,15687
9321442,9321441,TXFE7,128,9934,4,31237,16682,15691
9321454,9321442,TXFE7,128,9934,1,31238,16683,15692
9321454,9321442,TXFE7,128,9934,1,31239,16684,15693
9321454,9321442,TXFE7,128,9934,1,31240,16685,15694
9321479,9321476,TXFE7,128,9934,4,31244,16686,15695
9321479,9321478,TXFE7,128,9934,1,31245,16687,15696
9321667,9321660,TXFE7,128,9934,1,31246,16688,15697
9321854,9321849,TXFE7,128,9934,1,31247,16689,15698
9322029,9322029,TXFE7,128,9933,5,31252,16694,15699
9322054,9322052,TXFE7,128,9933,5,31257,16696,15700
9322054,9322054,TXFE7,128,9933,1,31258,16697,15701
9322067,9322058,TXFE7,128,9933,27,31285,16714,15702
9322104,9322102,TXFE7,128,9932,5,31290,16719,15703
9322129,9322122,TXFE7,128,9932,3,31293,16722,15704
9322129,9322127,TXFE7,128,9933,1,31294,16723,15705
9322154,9322142,TXFE7,128,9932,5,31299,16724,15706
9322217,9322215,TXFE7,128,9932,2,31301,16725,15707
9322267,9322263,TXFE7,128,9932,2,31303,16727,15708
9322317,9322310,TXFE7,128,9932,2,31305,16728,15709
9322342,9322335,TXFE7,128,9933,3,31308,16729,15711
9322354,9322347,TXFE7,128,9933,1,31309,16730,15712
9322392,9322380,TXFE7,128,9933,1,31310,16731,15713
9322429,9322428,TXFE7,128,9933,3,31313,16732,15716
9322442,9322429,TXFE7,128,9933,2,31315,16733,15718
9322479,9322477,TXFE7,128,9933,1,31316,16734,15719
9322629,9322619,TXFE7,128,9933,5,31321,16737,15720
9322642,9322630,TXFE7,128,9933,2,31323,16739,15721
9322654,9322650,TXFE7,128,9933,2,31325,16740,15722
9322654,9322650,TXFE7,128,9933,1,31326,16741,15723
9322792,9322785,TXFE7,128,9932,1,31327,16742,15724
9322992,9322980,TXFE7,128,9932,2,31329,16744,15725
9323142,9323138,TXFE7,128,9933,1,31330,16745,15726
9323354,9323348,TXFE7,128,9932,1,31331,16746,15727
9323504,9323497,TXFE7,128,9933,1,31332,16747,15728
9323779,9323774,TXFE7,128,9932,1,31333,16748,15729
9323792,9323779,TXFE7,128,9932,6,31339,16753,15730
9323842,9323834,TXFE7,128,9933,4,31343,16754,15731
9323967,9323966,TXFE7,128,9933,3,31346,16755,15733
9323992,9323986,TXFE7,128,9932,2,31348,16757,15734
9324042,9324041,TXFE7,128,9932,2,31350,16758,15735
9324067,9324064,TXFE7,128,9932,1,31351,16759,15736
9324117,9324108,TXFE7,128,9932,1,31352,16760,15737
9324117,9324114,TXFE7,128,9932,2,31354,16762,15738
9324129,9324117,TXFE7,128,9932,2,31356,16764,15739
9324129,9324127,TXFE7,128,9932,5,31361,16766,15740
9324142,9324130,TXFE7,128,9933,1,31362,16767,15741
9324142,9324131,TXFE7,128,9932,1,31363,16768,15742
9324167,9324162,TXFE7,128,9932,2,31365,16769,15743
9324167,9324163,TXFE7,128,9932,1,31366,16770,15744
9324179,9324176,TXFE7,128,9932,2,31368,16771,15745
9324204,9324198,TXFE7,128,9932,1,31369,16772,15746
9324204,9324199,TXFE7,128,9932,1,31370,16773,15747
9324229,9324218,TXFE7,128,9932,1,31371,16774,15748
9324292,9324284,TXFE7,128,9933,3,31374,16775,15749
9324292,9324284,TXFE7,128,9932,1,31375,16776,15750
9324317,9324311,TXFE7,128,9932,2,31377,16777,15751
9324342,9324336,TXFE7,128,9932,1,31378,16778,15752
9324342,9324340,TXFE7,128,9932,2,31380,16780,15753
9324417,9324409,TXFE7,128,9932,1,31381,16781,15754
9324442,9324437,TXFE7,128,9932,1,31382,16782,15755
9324454,9324442,TXFE7,128,9932,2,31384,16784,15756
9324454,9324454,TXFE7,128,9932,6,31390,16789,15757
9324467,9324466,TXFE7,128,9931,4,31394,16791,15758
9324479,9324470,TXFE7,128,9931,2,31396,16792,15759
9324479,9324476,TXFE7,128,9931,3,31399,16794,15760
9324492,9324483,TXFE7,128,9932,1,31400,16795,15761
9324492,9324490,TXFE7,128,9931,2,31402,16796,15762
9324517,9324513,TXFE7,128,9931,1,31403,16797,15763
9324567,9324560,TXFE7,128,9932,1,31404,16798,15764
9324604,9324594,TXFE7,128,9931,1,31405,16799,15765
9324617,9324607,TXFE7,128,9931,1,31406,16800,15766
9324642,9324637,TXFE7,128,9932,1,31407,16801,15767
9324679,9324669,TXFE7,128,9931,1,31408,16802,15768
9324679,9324670,TXFE7,128,9931,1,31409,16803,15769
9324704,9324692,TXFE7,129,9931,22,31434,16820,15770
9324704,9324692,TXFE7,129,9930,3,31434,16820,15770
9324704,9324701,TXFE7,128,9930,1,31435,16821,15771
9324717,9324709,TXFE7,128,9931,2,31437,16822,15773
9324792,9324780,TXFE7,128,9930,1,31438,16823,15774
9324842,9324836,TXFE7,128,9930,1,31439,16824,15775
9324867,9324861,TXFE7,128,9930,1,31440,16825,15776
9324892,9324882,TXFE7,128,9930,1,31441,16826,15777
9324929,9324922,TXFE7,128,9931,3,31444,16827,15778
9324979,9324975,TXFE7,128,9930,1,31445,16828,15779
9325067,9325064,TXFE7,128,9930,1,31446,16829,15780
9325092,9325081,TXFE7,128,9930,2,31448,16831,15781
9325129,9325123,TXFE7,128,9930,1,31449,16832,15782
9325142,9325141,TXFE7,128,9931,5,31454,16833,15786
9325167,9325156,TXFE7,128,9930,3,31457,16836,15787
9325279,9325273,TXFE7,128,9930,2,31459,16837,15788
9325329,9325321,TXFE7,128,9930,10,31469,16842,15789
9325354,9325342,TXFE7,128,9930,7,31476,16848,15790
9325392,9325380,TXFE7,128,9930,1,31477,16849,15791
9325417,9325411,TXFE7,128,9930,1,31478,16850,15792
9325479,9325476,TXFE7,128,9930,1,31479,16851,15793
9325492,9325483,TXFE7,128,9930,1,31480,16852,15794
9325529,9325528,TXFE7,128,9930,4,31484,16856,15795
9325592,9325591,TXFE7,128,9930,2,31486,16857,15796
9325629,9325617,TXFE7,128,9931,1,31487,16858,15797
9325629,9325618,TXFE7,128,9931,1,31488,16859,15798
9325742,9325729,TXFE7,128,9931,4,31492,16860,15800
9325742,9325729,TXFE7,128,9931,10,31502,16861,15805
9325767,9325755,TXFE7,128,9931,1,31503,16862,15806
9325767,9325762,TXFE7,128,9931,1,31504,16863,15807
9325854,9325852,TXFE7,128,9931,1,31505,16864,15808
9330067,9330066,TXFE7,128,9932,1,31506,16865,15809
9330104,9330101,TXFE7,128,9931,6,31512,16867,15810
9330117,9330108,TXFE7,128,9931,3,31515,16868,15811
9330142,9330131,TXFE7,128,9932,2,31517,16869,15813
9330167,9330167,TXFE7,129,9932,1,31521,16870,15817
9330167,9330167,TXFE7,129,9933,3,31521,16870,15817
9330342,9330339,TXFE7,128,9933,1,31522,16871,15818
9330367,9330355,TXFE7,128,9931,1,31523,16872,15819
9330367,9330360,TXFE7,128,9933,1,31524,16873,15820
9330517,9330508,TXFE7,128,9932,1,31525,16874,15821
9330579,9330576,TXFE7,128,9931,1,31526,16875,15822
9330642,9330635,TXFE7,128,9931,1,31527,16876,15823
9330704,9330703,TXFE7,128,9931,3,31530,16879,15824
9330717,9330705,TXFE7,128,9931,7,31537,16882,15825
9330904,9330904,TXFE7,128,9931,1,31538,16883,15826
9330917,9330912,TXFE7,128,9931,1,31539,16884,15827
9330967,9330959,TXFE7,128,9930,3,31542,16887,15828
9330979,9330971,TXFE7,128,9931,2,31544,16888,15829
9330992,9330991,TXFE7,128,9931,1,31545,16889,15830
9331079,9331074,TXFE7,128,9930,1,31546,16890,15831
9331104,9331094,TXFE7,128,9931,1,31547,16891,15832
9331117,9331111,TXFE7,128,9931,1,31548,16892,15833
9331129,9331118,TXFE7,128,9931,1,31549,16893,15834
9331142,9331138,TXFE7,128,9930,4,31553,16894,15835
9331242,9331235,TXFE7,128,9931,1,31554,16895,15836
9331267,9331262,TXFE7,128,9930,1,31555,16896,15837
9331267,9331262,TXFE7,128,9930,1,31556,16897,15838
9331267,9331262,TXFE7,128,9930,1,31557,16898,15839
9331267,9331263,TXFE7,128,9931,1,31558,16899,15840
9331279,9331267,TXFE7,128,9930,57,31615,16923,15841
9331279,9331275,TXFE7,128,9929,2,31617,16925,15842
9331292,9331284,TXFE7,128,9929,2,31619,16927,15843
9331292,9331284,TXFE7,128,9929,40,31659,16951,15844
9331317,9331304,TXFE7,128,9928,16,31675,16960,15845
9331317,9331316,TXFE7,128,9928,1,31676,16961,15846
9331329,9331317,TXFE7,128,9928,1,31677,16962,15847
9331329,9331317,TXFE7,128,9928,2,31679,16964,15848
9331329,9331317,TXFE7,128,9928,6,31685,16967,15849
9331329,9331317,TXFE7,128,9928,6,31691,16972,15850
9331329,9331317,TXFE7,128,9928,2,31693,16974,15851
9331329,9331317,TXFE7,128,9928,6,31699,16979,15852
9331329,9331317,TXFE7,128,9928,6,31705,16984,15853
9331329,9331320,TXFE7,128,9928,5,31710,16989,15854
9331329,9331320,TXFE7,128,9928,6,31716,16990,15855
9331329,9331323,TXFE7,128,9928,5,31721,16991,15856
9331329,9331324,TXFE7,128,9928,5,31726,16992,15857
9331329,9331326,TXFE7,128,9928,2,31728,16993,15858
9331329,9331327,TXFE7,128,9928,5,31733,16998,15859
9331329,9331329,TXFE7,128,9928,5,31738,17001,15860
9331329,9331329,TXFE7,128,9928,2,31740,17003,15861
9331342,9331329,TXFE7,128,9927,5,31745,17007,15862
9331342,9331330,TXFE7,128,9927,7,31752,17011,15863
9331342,9331330,TXFE7,128,9927,1,31753,17012,15864
9331342,9331333,TXFE7,128,9927,1,31754,17013,15865
9331342,9331339,TXFE7,128,9927,1,31755,17014,15866
9331342,9331341,TXFE7,128,9927,1,31756,17015,15867
9331354,9331343,TXFE7,128,9927,1,31757,17016,15868
9331354,9331345,TXFE7,128,9927,1,31758,17017,15869
9331354,9331347,TXFE7,128,9927,1,31759,17018,15870
9331354,9331349,TXFE7,128,9927,1,31760,17019,15871
9331354,9331349,TXFE7,128,9927,1,31761,17020,15872
9331354,9331350,TXFE7,128,9927,1,31762,17021,15873
9331367,9331356,TXFE7,128,9928,1,31763,17022,15874
9331367,9331360,TXFE7,128,9928,1,31764,17023,15875
9331367,9331360,TXFE7,128,9927,2,31766,17025,15876
9331367,9331366,TXFE7,128,9927,1,31767,17026,15877
9331367,9331366,TXFE7,128,9927,1,31768,17027,15878
9331379,9331370,TXFE7,128,9927,2,31770,17028,15879
9331379,9331372,TXFE7,128,9927,1,31771,17029,15880
9331379,9331374,TXFE7,128,9927,3,31774,17032,15881
9331392,9331381,TXFE7,128,9927,2,31776,17034,15882
9331392,9331386,TXFE7,128,9927,1,31777,17035,15883
9331392,9331390,TXFE7,128,9928,3,31780,17036,15885
9331404,9331395,TXFE7,128,9927,5,31785,17041,15886
9331417,9331412,TXFE7,128,9927,1,31786,17042,15887
9331442,9331431,TXFE7,128,9927,2,31788,17044,15888
9331442,9331431,TXFE7,128,9927,1,31789,17045,15889
9331442,9331433,TXFE7,128,9928,1,31790,17046,15890
9331454,9331442,TXFE7,128,9928,1,31791,17047,15891
9331467,9331460,TXFE7,128,9927,8,31799,17051,15892
9331479,9331468,TXFE7,128,9927,1,31800,17052,15893
9331479,9331475,TXFE7,128,9927,2,31802,17054,15894
9331554,9331542,TXFE7,128,9928,1,31803,17055,15895
9331554,9331549,TXFE7,128,9927,7,31810,17062,15896
9331554,9331550,TXFE7,128,9927,2,31812,17064,15897
9331579,9331572,TXFE7,128,9928,1,31813,17065,15898
9331604,9331601,TXFE7,128,9928,1,31814,17066,15899
9331617,9331612,TXFE7,128,9928,3,31817,17067,15902
9331617,9331615,TXFE7,128,9928,1,31818,17068,15903
9331667,9331663,TXFE7,128,9928,1,31819,17069,15904
9331679,9331672,TXFE7,128,9928,1,31820,17070,15905
9331704,9331695,TXFE7,128,9928,1,31821,17071,15906
9331717,9331704,TXFE7,128,9928,1,31822,17072,15907
9331717,9331706,TXFE7,128,9929,1,31823,17073,15908
9331742,9331737,TXFE7,128,9928,2,31825,17074,15909
9331742,9331737,TXFE7,128,9928,2,31827,17075,15910
9331742,9331741,TXFE7,128,9928,2,31829,17077,15911
9331804,9331797,TXFE7,128,9928,1,31830,17078,15912
9331829,9331817,TXFE7,128,9928,2,31832,17080,15913
9331829,9331817,TXFE7,128,9928,1,31833,17081,15914
9331854,9331843,TXFE7,128,9928,1,31834,17082,15915
9331854,9331845,TXFE7,128,9928,2,31836,17083,15916
9331867,9331854,TXFE7,128,9928,4,31840,17084,15917
9331867,9331855,TXFE7,128,9927,1,31841,17085,15918
9331879,9331867,TXFE7,128,9928,4,31845,17086,15920
9331879,9331871,TXFE7,128,9928,2,31847,17087,15921
9331892,9331879,TXFE7,128,9928,1,31848,17088,15922
9331917,9331910,TXFE7,128,9929,2,31850,17089,15923
9331992,9331987,TXFE7,128,9929,3,31853,17090,15925
9332067,9332058,TXFE7,128,9929,1,31854,17091,15926
9332067,9332066,TXFE7,128,9929,1,31855,17092,15927
9332079,9332067,TXFE7,128,9929,1,31856,17093,15928
9332142,9332136,TXFE7,128,9929,1,31857,17094,15929
9332154,9332142,TXFE7,128,9929,1,31858,17095,15930
9332229,9332219,TXFE7,128,9929,2,31860,17096,15932
9332254,9332250,TXFE7,128,9929,1,31861,17097,15933
9332279,9332278,TXFE7,128,9929,1,31862,17098,15934
9332329,9332321,TXFE7,128,9930,6,31868,17099,15937
9332329,9332321,TXFE7,128,9930,2,31870,17100,15938
9332342,9332329,TXFE7,128,9930,2,31872,17101,15940
9332342,9332329,TXFE7,128,9930,1,31873,17102,15941
9332342,9332334,TXFE7,128,9930,2,31875,17103,15942
9332454,9332447,TXFE7,128,9929,1,31876,17104,15943
9332479,9332470,TXFE7,128,9929,2,31878,17105,15944
9332492,9332486,TXFE7,128,9930,1,31879,17106,15945
9332729,9332719,TXFE7,128,9930,8,31887,17107,15948
9332942,9332938,TXFE7,128,9930,1,31888,17108,15949
9332992,9332981,TXFE7,128,9930,1,31889,17109,15950
9332992,9332990,TXFE7,128,9929,4,31893,17112,15951
9333054,9333052,TXFE7,128,9930,3,31896,17113,15954
9333204,9333201,TXFE7,128,9930,2,31898,17114,15955
9333317,9333313,TXFE7,128,9929,1,31899,17115,15956
9333429,9333421,TXFE7,128,9929,19,31918,17124,15957
9333429,9333426,TXFE7,128,9928,10,31928,17130,15958
9333442,9333437,TXFE7,128,9929,1,31929,17131,15959
9333467,9333464,TXFE7,128,9929,1,31930,17132,15960
9333479,9333470,TXFE7,128,9929,1,31931,17133,15961
9333479,9333477,TXFE7,128,9929,1,31932,17134,15962
9333617,9333609,TXFE7,128,9929,3,31935,17135,15963
9333617,9333610,TXFE7,128,9929,1,31936,17136,15964
9333617,9333614,TXFE7,128,9928,1,31937,17137,15965
9333642,9333634,TXFE7,128,9929,2,31939,17138,15967
9333654,9333648,TXFE7,128,9929,2,31941,17139,15969
9333842,9333830,TXFE7,128,9929,19,31960,17140,15973
9333854,9333842,TXFE7,128,9929,2,31962,17141,15974
9333942,9333930,TXFE7,128,9930,2,31964,17142,15975
9333954,9333942,TXFE7,128,9929,1,31965,17143,15976
9333954,9333943,TXFE7,128,9929,1,31966,17144,15977
9333954,9333945,TXFE7,128,9929,1,31967,17145,15978
9334067,9334060,TXFE7,128,9929,7,31974,17147,15979
9334092,9334089,TXFE7,128,9929,1,31975,17148,15980
9334129,9334118,TXFE7,128,9929,1,31976,17149,15981
9334142,9334135,TXFE7,128,9928,1,31977,17150,15982
9334354,9334354,TXFE7,128,9929,1,31978,17151,15983
9334392,9334383,TXFE7,128,9929,1,31979,17152,15984
9334479,9334478,TXFE7,128,9928,3,31982,17155,15985
9334479,9334479,TXFE7,128,9928,1,31983,17156,15986
9334492,9334485,TXFE7,128,9929,2,31985,17157,15987
9334504,9334492,TXFE7,128,9929,1,31986,17158,15988
9334554,9334550,TXFE7,128,9929,1,31987,17159,15989
9334554,9334553,TXFE7,128,9928,1,31988,17160,15990
9334579,9334579,TXFE7,128,9929,2,31990,17161,15991
9334717,9334708,TXFE7,128,9928,2,31992,17163,15992
9335067,9335058,TXFE7,128,9928,1,31993,17164,15993
9335079,9335077,TXFE7,128,9928,1,31994,17165,15994
9335292,9335284,TXFE7,128,9929,3,31997,17166,15997
9335304,9335292,TXFE7,128,9929,1,31998,17167,15998
9335404,9335396,TXFE7,128,9929,1,31999,17168,15999
9335404,9335404,TXFE7,128,9929,1,32000,17169,16000
9335417,9335404,TXFE7,128,9929,1,32001,17170,16001
9335429,9335417,TXFE7,128,9929,2,32003,17171,16003
9335442,9335429,TXFE7,128,9929,2,32005,17172,16005
9335454,9335442,TXFE7,128,9929,2,32007,17173,16006
9335454,9335443,TXFE7,128,9929,1,32008,17174,16007
9335467,9335454,TXFE7,128,9929,3,32011,17175,16008
9335467,9335464,TXFE7,128,9929,1,32012,17176,16009
9335492,9335488,TXFE7,128,9930,1,32013,17177,16010
9335504,9335501,TXFE7,128,9929,1,32014,17178,16011
9335504,9335504,TXFE7,128,9929,1,32015,17179,16012
9335792,9335785,TXFE7,128,9929,1,32016,17180,16013
9335829,9335826,TXFE7,128,9930,3,32019,17181,16014
9335842,9335833,TXFE7,128,9929,6,32025,17184,16015
9335879,9335877,TXFE7,128,9929,1,32026,17185,16016
9335967,9335960,TXFE7,128,9929,1,32027,17186,16017
9335979,9335967,TXFE7,128,9929,7,32034,17187,16019
9340042,9340040,TXFE7,128,9929,1,32035,17188,16020
9340129,9340124,TXFE7,129,9929,2,32045,17194,16021
9340129,9340124,TXFE7,129,9928,8,32045,17194,16021
9340167,9340161,TXFE7,128,9929,4,32049,17195,16024
9340179,9340167,TXFE7,128,9929,1,32050,17196,16025
9340229,9340217,TXFE7,128,9929,1,32051,17197,16026
9340354,9340342,TXFE7,128,9929,1,32052,17198,16027
9340454,9340453,TXFE7,128,9929,1,32053,17199,16028
9340454,9340453,TXFE7,128,9929,5,32058,17200,16030
9340454,9340453,TXFE7,128,9929,5,32063,17201,16032
9340467,9340461,TXFE7,128,9929,1,32064,17202,16033
9340542,9340538,TXFE7,128,9929,1,32065,17203,16034
9340542,9340540,TXFE7,128,9928,3,32068,17206,16035
9340729,9340723,TXFE7,128,9929,5,32073,17208,16036
9340792,9340790,TXFE7,128,9929,1,32074,17209,16037
9340792,9340791,TXFE7,128,9929,4,32078,17210,16038
9340892,9340879,TXFE7,128,9930,5,32083,17211,16042
9340892,9340879,TXFE7,128,9930,5,32088,17212,16046
9340892,9340879,TXFE7,128,9930,8,32096,17213,16048
9340892,9340880,TXFE7,128,9930,4,32100,17214,16052
9340967,9340956,TXFE7,128,9930,2,32102,17216,16053
9341104,9341092,TXFE7,128,9931,25,32127,17217,16063
9341117,9341115,TXFE7,128,9931,1,32128,17218,16064
9341129,9341123,TXFE7,128,9932,1,32129,17219,16065
9341167,9341161,TXFE7,128,9932,1,32130,17220,16066
9341204,9341204,TXFE7,128,9932,2,32132,17221,16068
9341254,9341245,TXFE7,128,9932,1,32133,17222,16069
9341304,9341303,TXFE7,128,9932,1,32134,17223,16070
9341317,9341315,TXFE7,128,9932,1,32135,17224,16071
9341342,9341331,TXFE7,128,9931,3,32138,17227,16072
9341429,9341424,TXFE7,128,9931,1,32139,17228,16073
9341454,9341446,TXFE7,128,9931,1,32140,17229,16074
9341467,9341458,TXFE7,128,9930,1,32141,17230,16075
9341567,9341555,TXFE7,128,9931,1,32142,17231,16076
9341579,9341568,TXFE7,128,9931,1,32143,17232,16077
9341704,9341699,TXFE7,128,9931,1,32144,17233,16078
9341917,9341907,TXFE7,128,9931,1,32145,17234,16079
9341967,9341959,TXFE7,128,9931,2,32147,17235,16080
9341979,9341975,TXFE7,128,9931,2,32149,17236,16081
9341992,9341980,TXFE7,128,9931,2,32151,17237,16083
9342004,9341992,TXFE7,128,9931,2,32153,17238,16084
9342067,9342061,TXFE7,128,9932,5,32158,17239,16089
9342079,9342072,TXFE7,128,9931,1,32159,17240,16090
9342092,9342086,TXFE7,128,9932,5,32164,17241,16094
9342229,9342221,TXFE7,128,9933,1,32165,17242,16095
9342229,9342221,TXFE7,128,9933,1,32166,17243,16096
9342229,9342222,TXFE7,128,9933,23,32189,17244,16110
9342229,9342225,TXFE7,128,9934,3,32192,17245,16112
9342317,9342313,TXFE7,128,9934,11,32203,17246,16117
9342342,9342335,TXFE7,128,9934,5,32208,17247,16118
9342354,9342351,TXFE7,128,9933,1,32209,17248,16119
9342404,9342400,TXFE7,128,9934,1,32210,17249,16120
9342404,9342402,TXFE7,128,9934,1,32211,17250,16121
9342454,9342449,TXFE7,128,9933,1,32212,17251,16122
9342467,9342454,TXFE7,128,9933,6,32218,17256,16123
9342467,9342454,TXFE7,128,9933,3,32221,17258,16124
9342479,9342473,TXFE7,128,9933,1,32222,17259,16125
9342504,9342495,TXFE7,128,9933,1,32223,17260,16126
9342542,9342533,TXFE7,128,9933,1,32224,17261,16127
9342542,9342533,TXFE7,128,9933,2,32226,17262,16128
9342542,9342533,TXFE7,128,9933,1,32227,17263,16129
9342542,9342541,TXFE7,128,9933,6,32233,17264,16131
9342554,9342542,TXFE7,128,9933,1,32234,17265,16132
9342554,9342542,TXFE7,128,9933,1,32235,17266,16133
9342554,9342545,TXFE7,128,9934,1,32236,17267,16134
9342642,9342638,TXFE7,128,9934,1,32237,17268,16135
9342667,9342655,TXFE7,128,9933,1,32238,17269,16136
9342692,9342691,TXFE7,128,9934,1,32239,17270,16137
9342742,9342736,TXFE7,128,9934,2,32241,17271,16138
9342742,9342739,TXFE7,128,9934,1,32242,17272,16139
9342817,9342812,TXFE7,128,9934,2,32244,17273,16141
9342904,9342894,TXFE7,128,9933,5,32249,17276,16142
9342942,9342940,TXFE7,128,9933,3,32252,17277,16143
9342992,9342990,TXFE7,128,9933,3,32255,17278,16144
9343017,9343007,TXFE7,128,9933,6,32261,17281,16145
9343042,9343033,TXFE7,128,9933,1,32262,17282,16146
9343042,9343042,TXFE7,128,9933,1,32263,17283,16147
9343054,9343049,TXFE7,128,9933,2,32265,17284,16148
9343092,9343084,TXFE7,128,9933,1,32266,17285,16149
9343329,9343326,TXFE7,128,9933,1,32267,17286,16150
9343342,9343329,TXFE7,128,9933,1,32268,17287,16151
9343342,9343335,TXFE7,128,9933,1,32269,17288,16152
9343342,9343341,TXFE7,128,9933,1,32270,17289,16153
9343354,9343342,TXFE7,128,9933,3,32273,17290,16154
9343504,9343496,TXFE7,128,9934,2,32277,17293,16157
9343579,9343574,TXFE7,128,9934,1,32278,17294,16158
9343617,9343605,TXFE7,128,9933,1,32279,17295,16159
9343629,9343622,TXFE7,128,9933,1,32280,17296,16160
9343629,9343623,TXFE7,128,9934,10,32290,17297,16168
9343729,9343725,TXFE7,128,9934,10,32300,17298,16170
9343804,9343802,TXFE7,128,9934,1,32301,17299,16171
9343854,9343844,TXFE7,128,9934,4,32305,17300,16172
9343917,9343911,TXFE7,128,9933,1,32306,17301,16173
9343942,9343931,TXFE7,128,9934,1,32307,17302,16174
9343942,9343941,TXFE7,128,9934,1,32308,17303,16175
9343954,9343953,TXFE7,128,9934,1,32309,17304,16176
9343967,9343965,TXFE7,128,9934,1,32310,17305,16177
9344117,9344107,TXFE7,128,9933,1,32311,17306,16178
9344167,9344162,TXFE7,128,9934,5,32316,17307,16180
9344217,9344211,TXFE7,128,9934,5,32321,17308,16182
9344242,9344233,TXFE7,128,9934,5,32326,17309,16183
9344267,9344254,TXFE7,128,9934,5,32331,17310,16184
9344279,9344270,TXFE7,128,9934,5,32336,17311,16188
9344329,9344323,TXFE7,128,9933,1,32337,17312,16189
9344392,9344383,TXFE7,128,9934,1,32338,17313,16190
9344492,9344487,TXFE7,128,9933,1,32339,17314,16191
9344517,9344507,TXFE7,128,9934,1,32340,17315,16192
9344567,9344560,TXFE7,128,9934,1,32341,17316,16193
9344742,9344730,TXFE7,128,9934,1,32342,17317,16194
9344842,9344833,TXFE7,128,9934,1,32343,17318,16195
9344892,9344888,TXFE7,128,9934,1,32344,17319,16196
9344929,9344924,TXFE7,128,9933,1,32345,17320,16197
9344979,9344974,TXFE7,128,9934,1,32346,17321,16198
9345054,9345051,TXFE7,128,9934,1,32347,17322,16199
9345067,9345054,TXFE7,128,9934,1,32348,17323,16200
9345267,9345260,TXFE7,128,9934,2,32350,17324,16202
9345279,9345278,TXFE7,128,9933,1,32351,17325,16203
9345417,9345408,TXFE7,128,9934,1,32352,17326,16204
9345754,9345745,TXFE7,128,9933,1,32353,17327,16205
9345804,9345796,TXFE7,128,9934,1,32354,17328,16206
9345854,9345848,TXFE7,128,9933,1,32355,17329,16207
9345867,9345867,TXFE7,128,9933,5,32360,17332,16208
9345879,9345867,TXFE7,128,9933,1,32361,17333,16209
9345892,9345885,TXFE7,128,9933,25,32386,17346,16210
9345904,9345892,TXFE7,128,9933,2,32388,17348,16211
9345904,9345892,TXFE7,128,9933,1,32389,17349,16212
9350417,9350407,TXFE7,128,9933,20,32409,17350,16221
9350429,9350417,TXFE7,128,9933,14,32423,17351,16230
9350429,9350429,TXFE7,128,9932,12,32435,17360,16231
9350442,9350434,TXFE7,128,9932,7,32442,17363,16232
9350454,9350452,TXFE7,128,9932,2,32444,17365,16233
9350517,9350511,TXFE7,128,9933,1,32445,17366,16234
9350754,9350748,TXFE7,128,9933,1,32446,17367,16235
9350767,9350758,TXFE7,128,9933,10,32456,17368,16241
9350854,9350851,TXFE7,128,9933,1,32457,17369,16242
9350904,9350902,TXFE7,128,9934,1,32458,17370,16243
9351042,9351029,TXFE7,128,9933,1,32459,17371,16244
9351242,9351241,TXFE7,128,9933,4,32463,17372,16245
9351329,9351319,TXFE7,128,9932,2,32465,17373,16246
9351392,9351380,TXFE7,128,9933,5,32470,17374,16250
9351504,9351498,TXFE7,128,9932,10,32480,17380,16251
9351604,9351602,TXFE7,128,9933,2,32482,17381,16252
9351617,9351614,TXFE7,128,9933,1,32483,17382,16253
9351629,9351617,TXFE7,128,9933,4,32487,17383,16256
9351629,9351617,TXFE7,128,9933,2,32489,17384,16258
9351642,9351640,TXFE7,128,9933,1,32490,17385,16259
9351704,9351699,TXFE7,128,9933,1,32491,17386,16260
9351892,9351879,TXFE7,128,9933,3,32494,17388,16261
9351904,9351897,TXFE7,128,9933,1,32495,17389,16262
9351979,9351972,TXFE7,128,9934,15,32510,17390,16272
9352004,9352001,TXFE7,128,9934,1,32511,17391,16273
9352042,9352034,TXFE7,128,9934,5,32516,17392,16277
9352092,9352082,TXFE7,128,9934,4,32520,17393,16280
9352217,9352207,TXFE7,128,9934,1,32521,17394,16281
9352317,9352313,TXFE7,128,9934,7,32528,17395,16284
9352329,9352317,TXFE7,128,9934,17,32545,17396,16296
9352404,9352403,TXFE7,128,9934,1,32546,17397,16297
9352454,9352442,TXFE7,128,9934,2,32548,17399,16298
9352454,9352442,TXFE7,128,9934,2,32550,17400,16299
9352454,9352446,TXFE7,128,9934,2,32552,17401,16300
9352754,9352750,TXFE7,128,9934,2,32554,17402,16302
9352804,9352797,TXFE7,128,9934,1,32555,17403,16303
9353154,9353142,TXFE7,128,9933,14,32569,17412,16304
9353154,9353142,TXFE7,128,9933,1,32570,17413,16305
9353167,9353157,TXFE7,128,9932,1,32571,17414,16306
9353192,9353181,TXFE7,128,9933,1,32572,17415,16307
9353467,9353456,TXFE7,128,9934,3,32575,17416,16309
9353479,9353467,TXFE7,128,9934,1,32576,17417,16310
9353554,9353542,TXFE7,128,9934,1,32577,17418,16311
9353567,9353556,TXFE7,128,9934,1,32578,17419,16312
9353629,9353626,TXFE7,128,9933,3,32581,17421,16313
9353829,9353829,TXFE7,128,9933,1,32582,17422,16314
9353842,9353836,TXFE7,128,9933,2,32584,17424,16315
9353992,9353985,TXFE7,128,9933,1,32585,17425,16316
9354004,9353992,TXFE7,128,9933,2,32587,17426,16317
9354104,9354094,TXFE7,128,9934,3,32590,17427,16319
9354317,9354305,TXFE7,128,9934,1,32591,17428,16320
9354342,9354337,TXFE7,128,9934,2,32593,17429,16322
9354417,9354417,TXFE7,128,9934,3,32596,17430,16325
9354442,9354439,TXFE7,128,9934,1,32597,17431,16326
9354467,9354463,TXFE7,128,9933,1,32598,17432,16327
9354479,9354471,TXFE7,128,9934,1,32599,17433,16328
9354504,9354500,TXFE7,128,9933,1,32600,17434,16329
9354517,9354515,TXFE7,128,9934,1,32601,17435,16330
9354542,9354536,TXFE7,128,9934,1,32602,17436,16331
9354542,9354538,TXFE7,128,9933,1,32603,17437,16332
9354554,9354542,TXFE7,128,9933,2,32605,17438,16333
9354604,9354601,TXFE7,128,9933,2,32607,17439,16334
9354617,9354610,TXFE7,128,9933,1,32608,17440,16335
9354667,9354664,TXFE7,128,9934,2,32610,17441,16337
9354742,9354730,TXFE7,128,9934,6,32616,17442,16338
9354767,9354762,TXFE7,128,9935,1,32617,17443,16339
9354867,9354860,TXFE7,128,9935,1,32618,17444,16340
9354929,9354917,TXFE7,128,9935,1,32619,17445,16341
9354942,9354929,TXFE7,128,9934,2,32621,17446,16342
9354942,9354930,TXFE7,128,9934,2,32623,17447,16343
9354979,9354971,TXFE7,128,9935,3,32626,17448,16345
9355004,9354997,TXFE7,128,9935,1,32627,17449,16346
9355104,9355099,TXFE7,128,9934,1,32628,17450,16347
9355142,9355140,TXFE7,128,9935,95,32723,17451,16392
9355154,9355142,TXFE7,128,9936,1,32724,17452,16393
9355154,9355142,TXFE7,128,9936,10,32734,17453,16398
9355154,9355152,TXFE7,128,9936,1,32735,17454,16399
9355167,9355154,TXFE7,128,9936,1,32736,17455,16400
9355167,9355154,TXFE7,128,9936,4,32740,17456,16404
9355167,9355154,TXFE7,128,9936,1,32741,17457,16405
9355167,9355154,TXFE7,128,9936,21,32762,17458,16423
9355167,9355155,TXFE7,128,9936,3,32765,17459,16426
9355167,9355155,TXFE7,128,9936,4,32769,17460,16429
9355167,9355155,TXFE7,128,9936,2,32771,17461,16431
9355167,9355155,TXFE7,128,9936,2,32773,17462,16433
9355167,9355159,TXFE7,128,9936,2,32775,17463,16435
9355167,9355159,TXFE7,128,9936,1,32776,17464,16436
9355167,9355159,TXFE7,128,9936,3,32779,17465,16437
9355167,9355159,TXFE7,128,9936,1,32780,17466,16438
9355167,9355159,TXFE7,128,9936,1,32781,17467,16439
9355167,9355159,TXFE7,128,9936,1,32782,17468,16440
9355167,9355159,TXFE7,128,9936,1,32783,17469,16441
9355167,9355159,TXFE7,128,9936,3,32786,17470,16444
9355167,9355159,TXFE7,128,9936,4,32790,17471,16445
9355167,9355159,TXFE7,128,9936,1,32791,17472,16446
9355167,9355159,TXFE7,128,9936,2,32793,17473,16448
9355167,9355159,TXFE7,128,9936,7,32800,17474,16455
9355167,9355160,TXFE7,128,9936,7,32807,17475,16459
9355167,9355164,TXFE7,128,9936,3,32810,17476,16462
9355167,9355165,TXFE7,128,9937,1,32811,17477,16463
9355179,9355167,TXFE7,128,9937,1,32812,17478,16464
9355179,9355167,TXFE7,128,9937,7,32819,17479,16467
9355179,9355178,TXFE7,128,9936,1,32820,17480,16468
9355179,9355179,TXFE7,128,9937,5,32825,17481,16473
9355192,9355185,TXFE7,128,9937,2,32827,17482,16475
9355204,9355201,TXFE7,128,9937,5,32832,17483,16476
9355204,9355203,TXFE7,128,9937,4,32836,17484,16477
9355229,9355217,TXFE7,128,9936,1,32837,17485,16478
9355229,9355217,TXFE7,128,9936,3,32840,17488,16479
9355229,9355221,TXFE7,128,9936,1,32841,17489,16480
9355229,9355221,TXFE7,128,9936,3,32844,17492,16481
9355229,9355223,TXFE7,128,9936,2,32846,17493,16482
9355229,9355228,TXFE7,128,9936,1,32847,17494,16483
9355229,9355229,TXFE7,128,9936,4,32851,17495,16485
9355242,9355238,TXFE7,128,9935,1,32852,17496,16486
9355242,9355238,TXFE7,128,9936,5,32857,17497,16489
9355242,9355239,TXFE7,128,9936,4,32861,17498,16492
9355242,9355241,TXFE7,128,9936,2,32863,17499,16493
9355267,9355257,TXFE7,128,9936,1,32864,17500,16494
9355267,9355259,TXFE7,128,9935,1,32865,17501,16495
9355267,9355261,TXFE7,128,9936,1,32866,17502,16496
9355267,9355263,TXFE7,128,9935,1,32867,17503,16497
9355279,9355269,TXFE7,128,9936,2,32869,17504,16498
9355279,9355271,TXFE7,128,9936,1,32870,17505,16499
9355292,9355284,TXFE7,128,9936,1,32871,17506,16500
9355292,9355287,TXFE7,128,9936,2,32873,17507,16502
9355304,9355299,TXFE7,128,9936,4,32877,17508,16503
9355329,9355325,TXFE7,128,9936,1,32878,17509,16504
9355342,9355336,TXFE7,128,9936,1,32879,17510,16505
9355342,9355338,TXFE7,128,9936,2,32881,17511,16506
9355354,9355352,TXFE7,129,9936,20,32911,17512,16517
9355354,9355352,TXFE7,129,9937,10,32911,17512,16517
9355367,9355354,TXFE7,128,9936,1,32912,17513,16518
9355367,9355357,TXFE7,128,9936,1,32913,17514,16519
9355367,9355357,TXFE7,128,9936,1,32914,17515,16520
9355379,9355367,TXFE7,128,9936,1,32915,17516,16521
9355429,9355424,TXFE7,128,9935,1,32916,17517,16522
9355442,9355434,TXFE7,128,9935,2,32918,17518,16523
9355479,9355476,TXFE7,128,9936,2,32920,17519,16524
9355492,9355480,TXFE7,128,9936,1,32921,17520,16525
9355504,9355496,TXFE7,128,9936,3,32924,17521,16528
9355579,9355572,TXFE7,128,9936,2,32926,17522,16530
9355579,9355573,TXFE7,128,9936,2,32928,17523,16531
9355579,9355573,TXFE7,128,9936,2,32930,17524,16532
9355579,9355573,TXFE7,128,9936,2,32932,17525,16534
9355579,9355576,TXFE7,128,9936,1,32933,17526,16535
9355579,9355577,TXFE7,128,9936,2,32935,17527,16536
9355579,9355578,TXFE7,128,9937,2,32937,17528,16537
9355579,9355578,TXFE7,128,9937,1,32938,17529,16538
9355592,9355580,TXFE7,128,9937,1,32939,17530,16539
9355592,9355581,TXFE7,128,9937,1,32940,17531,16540
9355592,9355581,TXFE7,128,9937,1,32941,17532,16541
9355592,9355583,TXFE7,128,9937,2,32943,17533,16542
9355592,9355584,TXFE7,128,9937,1,32944,17534,16543
9355592,9355586,TXFE7,128,9937,2,32946,17535,16544
9355592,9355587,TXFE7,128,9937,1,32947,17536,16545
9355592,9355588,TXFE7,128,9937,1,32948,17537,16546
9355592,9355590,TXFE7,128,9937,1,32949,17538,16547
9355592,9355590,TXFE7,128,9937,1,32950,17539,16548
9355592,9355591,TXFE7,128,9937,1,32951,17540,16549
9355604,9355592,TXFE7,128,9937,1,32952,17541,16550
9355604,9355594,TXFE7,128,9937,1,32953,17542,16551
9355617,9355614,TXFE7,128,9936,3,32956,17544,16552
9355617,9355616,TXFE7,128,9936,2,32958,17546,16553
9355642,9355636,TXFE7,128,9936,1,32959,17547,16554
9355667,9355661,TXFE7,128,9936,1,32960,17548,16555
9355704,9355692,TXFE7,128,9936,2,32962,17549,16556
9355729,9355729,TXFE7,128,9936,1,32963,17550,16557
9355742,9355734,TXFE7,128,9936,1,32964,17551,16558
9355792,9355789,TXFE7,128,9936,4,32968,17552,16560
9355804,9355795,TXFE7,128,9936,1,32969,17553,16561
9355817,9355804,TXFE7,128,9936,3,32972,17554,16564
9355817,9355805,TXFE7,128,9935,1,32973,17555,16565
9355829,9355820,TXFE7,128,9935,1,32974,17556,16566
9355854,9355842,TXFE7,128,9936,1,32975,17557,16567
9355854,9355854,TXFE7,128,9936,3,32978,17558,16568
9355867,9355854,TXFE7,128,9936,7,32985,17560,16569
9360017,9360005,TXFE7,128,9935,1,32986,17561,16570
9360017,9360006,TXFE7,128,9936,1,32987,17562,16571
9360029,9360017,TXFE7,128,9936,1,32988,17563,16572
9360042,9360038,TXFE7,128,9936,2,32990,17564,16573
9360067,9360057,TXFE7,128,9936,3,32993,17565,16574
9360079,9360071,TXFE7,128,9937,2,32995,17566,16575
9360079,9360071,TXFE7,128,9937,2,32997,17567,16576
9360079,9360073,TXFE7,128,9937,2,32999,17568,16577
9360079,9360076,TXFE7,128,9937,2,33001,17569,16578
9360079,9360076,TXFE7,128,9937,2,33003,17570,16579
9360092,9360080,TXFE7,128,9937,2,33005,17571,16580
9360092,9360081,TXFE7,128,9937,1,33006,17572,16581
9360092,9360083,TXFE7,128,9937,1,33007,17573,16582
9360092,9360085,TXFE7,128,9937,1,33008,17574,16583
9360104,9360097,TXFE7,128,9936,1,33009,17575,16584
9360154,9360150,TXFE7,128,9936,1,33010,17576,16585
9360167,9360159,TXFE7,128,9937,1,33011,17577,16586
9360167,9360164,TXFE7,128,9937,1,33012,17578,16587
9360167,9360165,TXFE7,128,9936,1,33013,17579,16588
9360229,9360222,TXFE7,128,9936,7,33020,17584,16589
9360254,9360254,TXFE7,128,9936,2,33022,17585,16591
9360267,9360262,TXFE7,128,9936,1,33023,17586,16592
9360304,9360299,TXFE7,128,9936,1,33024,17587,16593
9360317,9360309,TXFE7,128,9936,1,33025,17588,16594
9360317,9360315,TXFE7,128,9936,5,33030,17589,16596
9360329,9360321,TXFE7,128,9937,5,33035,17590,16597
9360367,9360355,TXFE7,129,9936,3,33040,17591,16599
9360367,9360355,TXFE7,129,9937,2,33040,17591,16599
9360392,9360381,TXFE7,128,9937,5,33045,17592,16600
9360404,9360392,TXFE7,128,9936,1,33046,17593,16601
9360404,9360393,TXFE7,128,9937,5,33051,17594,16602
9360429,9360424,TXFE7,128,9935,7,33058,17599,16603
9360429,9360428,TXFE7,128,9936,1,33059,17600,16604
9360479,9360470,TXFE7,128,9936,1,33060,17601,16605
9360479,9360471,TXFE7,128,9936,1,33061,17602,16606
9360479,9360471,TXFE7,128,9936,2,33063,17603,16607
9360479,9360471,TXFE7,128,9936,1,33064,17604,16608
9360479,9360477,TXFE7,128,9936,2,33066,17605,16609
9360479,9360477,TXFE7,128,9936,1,33067,17606,16610
9360492,9360480,TXFE7,128,9936,1,33068,17607,16611
9360504,9360504,TXFE7,128,9936,1,33069,17608,16612
9360529,9360518,TXFE7,128,9937,12,33081,17609,16613
9360529,9360518,TXFE7,128,9937,9,33090,17610,16614
9360529,9360519,TXFE7,128,9937,3,33093,17611,16615
9360542,9360532,TXFE7,128,9937,2,33095,17612,16616
9360542,9360532,TXFE7,128,9937,1,33096,17613,16617
9360567,9360559,TXFE7,128,9936,1,33097,17614,16618
9360579,9360574,TXFE7,128,9937,1,33098,17615,16619
9360629,9360618,TXFE7,128,9937,8,33106,17616,16624
9360629,9360621,TXFE7,128,9937,1,33107,17617,16625
9360654,9360646,TXFE7,128,9937,1,33108,17618,16626
9360667,9360665,TXFE7,128,9937,44,33152,17619,16652
9360679,9360668,TXFE7,128,9936,1,33153,17620,16653
9360692,9360679,TXFE7,128,9937,2,33155,17621,16655
9360692,9360679,TXFE7,128,9937,2,33157,17622,16657
9360692,9360679,TXFE7,128,9937,1,33158,17623,16658
9360717,9360709,TXFE7,128,9937,1,33159,17624,16659
9360754,9360749,TXFE7,128,9937,5,33164,17625,16663
9360767,9360762,TXFE7,128,9937,1,33165,17626,16664
9360779,9360767,TXFE7,128,9937,5,33170,17627,16668
9360792,9360780,TXFE7,128,9937,2,33172,17628,16670
9360792,9360781,TXFE7,128,9937,1,33173,17629,16671
9360792,9360788,TXFE7,128,9937,5,33178,17630,16674
9360792,9360790,TXFE7,128,9937,1,33179,17631,16675
9360817,9360814,TXFE7,128,9938,8,33187,17632,16679
9360829,9360817,TXFE7,128,9938,20,33207,17633,16695
9360829,9360817,TXFE7,128,9938,1,33208,17634,16696
9360829,9360818,TXFE7,128,9938,3,33211,17635,16698
9360829,9360819,TXFE7,128,9938,2,33213,17636,16699
9360829,9360820,TXFE7,128,9938,1,33214,17637,16700
9360829,9360820,TXFE7,128,9938,1,33215,17638,16701
9360829,9360820,TXFE7,128,9938,10,33225,17639,16705
9360829,9360821,TXFE7,128,9938,1,33226,17640,16706
9360829,9360821,TXFE7,128,9938,1,33227,17641,16707
9360829,9360822,TXFE7,128,9938,4,33231,17642,16710
9360829,9360822,TXFE7,128,9938,2,33233,17643,16712
9360829,9360823,TXFE7,128,9938,2,33235,17644,16714
9360829,9360824,TXFE7,128,9938,1,33236,17645,16715
9360829,9360824,TXFE7,128,9938,2,33238,17646,16716
9360829,9360828,TXFE7,128,9938,2,33240,17647,16717
9360829,9360829,TXFE7,128,9938,2,33242,17648,16718
9360842,9360829,TXFE7,128,9938,57,33299,17649,16761
9360842,9360833,TXFE7,128,9939,9,33308,17650,16767
9360842,9360835,TXFE7,128,9939,1,33309,17651,16768
9360842,9360835,TXFE7,128,9939,12,33321,17652,16770
9360842,9360840,TXFE7,128,9939,1,33322,17653,16771
9360854,9360842,TXFE7,128,9939,9,33331,17654,16775
9360854,9360842,TXFE7,128,9938,22,33353,17663,16776
9360854,9360843,TXFE7,128,9939,1,33354,17664,16777
9360854,9360843,TXFE7,128,9938,3,33357,17666,16778
9360854,9360845,TXFE7,128,9939,1,33358,17667,16779
9360854,9360845,TXFE7,128,9939,2,33360,17668,16781
9360854,9360845,TXFE7,128,9939,1,33361,17669,16782
9360854,9360847,TXFE7,128,9939,2,33363,17670,16784
9360854,9360847,TXFE7,128,9939,1,33364,17671,16785
9360854,9360847,TXFE7,128,9939,1,33365,17672,16786
9360854,9360848,TXFE7,128,9939,1,33366,17673,16787
9360854,9360851,TXFE7,128,9939,1,33367,17674,16788
9360854,9360853,TXFE7,128,9939,1,33368,17675,16789
9360867,9360855,TXFE7,128,9939,19,33387,17676,16798
9360867,9360855,TXFE7,128,9939,1,33388,17677,16799
9360867,9360856,TXFE7,128,9939,2,33390,17678,16800
9360867,9360857,TXFE7,128,9939,1,33391,17679,16801
9360867,9360858,TXFE7,128,9939,1,33392,17680,16802
9360867,9360859,TXFE7,128,9939,1,33393,17681,16803
9360867,9360859,TXFE7,128,9939,1,33394,17682,16804
9360867,9360860,TXFE7,128,9939,1,33395,17683,16805
9360879,9360868,TXFE7,128,9939,12,33407,17684,16810
9360879,9360875,TXFE7,128,9939,1,33408,17685,16811
9360892,9360884,TXFE7,128,9939,1,33409,17686,16812
9360892,9360886,TXFE7,128,9939,3,33412,17687,16813
9360892,9360890,TXFE7,128,9939,1,33413,17688,16814
9360904,9360900,TXFE7,128,9938,1,33414,17689,16815
9360904,9360901,TXFE7,128,9939,1,33415,17690,16816
9360917,9360906,TXFE7,128,9939,1,33416,17691,16817
9360929,9360929,TXFE7,128,9939,1,33417,17692,16818
9360942,9360931,TXFE7,128,9938,10,33427,17698,16819
9360942,9360931,TXFE7,128,9938,1,33428,17699,16820
9360942,9360931,TXFE7,128,9939,1,33429,17700,16821
9360942,9360941,TXFE7,128,9939,2,33431,17701,16823
9360954,9360942,TXFE7,128,9938,4,33435,17704,16824
9360954,9360944,TXFE7,128,9938,4,33439,17706,16825
9360954,9360950,TXFE7,128,9939,2,33441,17707,16826
9360967,9360954,TXFE7,128,9938,2,33443,17708,16827
9360967,9360959,TXFE7,128,9937,1,33444,17709,16828
9360967,9360961,TXFE7,128,9938,1,33445,17710,16829
9360967,9360964,TXFE7,128,9937,2,33447,17712,16830
9360979,9360975,TXFE7,128,9938,1,33448,17713,16831
9360979,9360979,TXFE7,128,9937,3,33451,17714,16832
9360992,9360984,TXFE7,128,9938,1,33452,17715,16833
9360992,9360984,TXFE7,128,9938,1,33453,17716,16834
9360992,9360985,TXFE7,128,9938,1,33454,17717,16835
9360992,9360986,TXFE7,128,9938,1,33455,17718,16836
9360992,9360987,TXFE7,128,9938,1,33456,17719,16837
9360992,9360990,TXFE7,128,9938,1,33457,17720,16838
9360992,9360990,TXFE7,128,9938,1,33458,17721,16839
9360992,9360990,TXFE7,128,9938,2,33460,17722,16840
9360992,9360991,TXFE7,128,9938,1,33461,17723,16841
9360992,9360992,TXFE7,128,9938,1,33462,17724,16842
9360992,9360992,TXFE7,128,9938,1,33463,17725,16843
9361004,9360994,TXFE7,128,9938,1,33464,17726,16844
9361004,9360994,TXFE7,128,9938,2,33466,17727,16845
9361004,9360996,TXFE7,128,9938,1,33467,17728,16846
9361004,9360996,TXFE7,128,9938,2,33469,17729,16847
9361004,9360998,TXFE7,128,9938,2,33471,17730,16848
9361004,9360998,TXFE7,128,9938,2,33473,17731,16850
9361004,9361000,TXFE7,128,9938,2,33475,17732,16852
9361004,9361001,TXFE7,129,9938,1,33477,17733,16854
9361004,9361001,TXFE7,129,9939,1,33477,17733,16854
9361004,9361002,TXFE7,128,9939,2,33479,17734,16856
9361004,9361003,TXFE7,128,9939,2,33481,17735,16857
9361004,9361003,TXFE7,128,9939,2,33483,17736,16858
9361017,9361005,TXFE7,128,9938,1,33484,17737,16859
9361017,9361009,TXFE7,128,9938,1,33485,17738,16860
9361017,9361015,TXFE7,128,9939,1,33486,17739,16861
9361042,9361034,TXFE7,128,9938,2,33488,17740,16862
9361067,9361056,TXFE7,128,9938,3,33491,17741,16863
9361067,9361059,TXFE7,128,9938,1,33492,17742,16864
9361079,9361074,TXFE7,128,9938,1,33493,17743,16865
9361092,9361084,TXFE7,129,9938,3,33514,17744,16876
9361092,9361084,TXFE7,129,9939,18,33514,17744,16876
9361092,9361088,TXFE7,128,9938,1,33515,17745,16877
9361092,9361089,TXFE7,128,9939,1,33516,17746,16878
9361104,9361092,TXFE7,128,9938,1,33517,17747,16879
9361104,9361094,TXFE7,129,9938,6,33538,17748,16892
9361104,9361094,TXFE7,129,9939,15,33538,17748,16892
9361104,9361102,TXFE7,128,9939,1,33539,17749,16893
9361117,9361113,TXFE7,128,9939,1,33540,17750,16894
9361129,9361127,TXFE7,128,9939,1,33541,17751,16895
9361142,9361132,TXFE7,128,9939,1,33542,17752,16896
9361142,9361136,TXFE7,128,9939,2,33544,17753,16898
9361142,9361136,TXFE7,128,9938,3,33547,17756,16899
9361154,9361152,TXFE7,128,9939,1,33548,17757,16900
9361167,9361155,TXFE7,128,9938,1,33549,17758,16901
9361167,9361162,TXFE7,128,9939,1,33550,17759,16902
9361192,9361183,TXFE7,128,9938,7,33557,17763,16903
9361192,9361190,TXFE7,128,9939,1,33558,17764,16904
9361204,9361194,TXFE7,128,9938,1,33559,17765,16905
9361204,9361194,TXFE7,128,9938,11,33570,17768,16906
9361204,9361199,TXFE7,128,9939,1,33571,17769,16907
9361217,9361205,TXFE7,128,9938,2,33573,17770,16909
9361217,9361207,TXFE7,128,9938,1,33574,17771,16910
9361229,9361217,TXFE7,128,9938,1,33575,17772,16911
9361242,9361238,TXFE7,128,9938,2,33577,17773,16912
9361267,9361257,TXFE7,128,9938,1,33578,17774,16913
9361267,9361262,TXFE7,128,9938,1,33579,17775,16914
9361267,9361264,TXFE7,128,9938,1,33580,17776,16915
9361279,9361275,TXFE7,128,9938,1,33581,17777,16916
9361304,9361294,TXFE7,128,9938,2,33583,17778,16917
9361317,9361311,TXFE7,128,9939,1,33584,17779,16918
9361342,9361334,TXFE7,128,9939,5,33589,17780,16921
9361379,9361367,TXFE7,128,9939,2,33591,17781,16922
9361429,9361418,TXFE7,128,9939,2,33593,17782,16923
9361429,9361420,TXFE7,128,9938,1,33594,17783,16924
9361442,9361430,TXFE7,128,9938,5,33599,17786,16925
9361467,9361462,TXFE7,128,9938,2,33601,17787,16927
9361467,9361465,TXFE7,128,9938,4,33605,17788,16929
9361492,9361491,TXFE7,128,9939,1,33606,17789,16930
9361492,9361491,TXFE7,128,9939,1,33607,17790,16931
9361504,9361493,TXFE7,128,9937,10,33617,17797,16932
9361504,9361493,TXFE7,128,9939,1,33618,17798,16933
9361504,9361493,TXFE7,128,9938,1,33619,17799,16934
9361504,9361493,TXFE7,128,9939,2,33621,17800,16936
9361504,9361494,TXFE7,128,9939,2,33623,17801,16937
9361504,9361496,TXFE7,128,9939,2,33625,17802,16938
9361529,9361517,TXFE7,128,9938,1,33626,17803,16939
9361542,9361529,TXFE7,128,9938,1,33627,17804,16940
9361554,9361548,TXFE7,128,9937,1,33628,17805,16941
9361567,9361559,TXFE7,128,9939,3,33631,17806,16944
9361579,9361578,TXFE7,128,9939,1,33632,17807,16945
9361604,9361595,TXFE7,128,9939,1,33633,17808,16946
9361617,9361615,TXFE7,128,9938,1,33634,17809,16947
9361617,9361617,TXFE7,128,9938,1,33635,17810,16948
9361629,9361618,TXFE7,128,9938,1,33636,17811,16949
9361642,9361631,TXFE7,128,9939,1,33637,17812,16950
9361667,9361664,TXFE7,128,9938,1,33638,17813,16951
9361692,9361688,TXFE7,128,9938,1,33639,17814,16952
9361717,9361709,TXFE7,128,9938,3,33642,17815,16954
9361792,9361784,TXFE7,128,9938,1,33643,17816,16955
9361792,9361787,TXFE7,128,9938,4,33647,17817,16958
9361854,9361842,TXFE7,129,9938,1,33657,17818,16963
9361854,9361842,TXFE7,129,9939,9,33657,17818,16963
9361854,9361846,TXFE7,128,9939,1,33658,17819,16964
9361867,9361855,TXFE7,128,9939,2,33660,17820,16965
9361942,9361929,TXFE7,128,9939,1,33661,17821,16966
9361942,9361931,TXFE7,128,9938,3,33664,17822,16967
9361954,9361954,TXFE7,128,9937,1,33665,17823,16968
9361979,9361976,TXFE7,128,9938,1,33666,17824,16969
9362004,9362000,TXFE7,128,9939,9,33675,17825,16970
9362054,9362042,TXFE7,128,9938,3,33678,17826,16971
9362067,9362062,TXFE7,128,9938,1,33679,17827,16972
9362142,9362135,TXFE7,128,9938,1,33680,17828,16973
9362142,9362141,TXFE7,128,9938,1,33681,17829,16974
9362154,9362146,TXFE7,128,9938,2,33683,17830,16976
9362217,9362209,TXFE7,128,9938,1,33684,17831,16977
9362229,9362222,TXFE7,128,9938,2,33686,17832,16978
9362229,9362226,TXFE7,128,9938,1,33687,17833,16979
9362254,9362248,TXFE7,128,9938,1,33688,17834,16980
9362317,9362313,TXFE7,128,9938,3,33691,17835,16983
9362367,9362358,TXFE7,128,9938,1,33692,17836,16984
9362392,9362386,TXFE7,128,9937,1,33693,17837,16985
9362417,9362415,TXFE7,128,9938,2,33695,17838,16986
9362479,9362479,TXFE7,128,9937,1,33696,17839,16987
9362504,9362498,TXFE7,128,9938,2,33698,17840,16989
9362529,9362522,TXFE7,128,9937,2,33700,17842,16990
9362529,9362524,TXFE7,128,9938,1,33701,17843,16991
9362542,9362529,TXFE7,128,9938,1,33702,17844,16992
9362592,9362583,TXFE7,128,9937,8,33710,17850,16993
9362592,9362588,TXFE7,128,9938,5,33715,17851,16997
9362617,9362604,TXFE7,128,9937,1,33716,17852,16998
9362617,9362608,TXFE7,128,9937,2,33718,17853,16999
9362617,9362609,TXFE7,128,9937,1,33719,17854,17000
9362617,9362613,TXFE7,128,9938,1,33720,17855,17001
9362617,9362616,TXFE7,128,9938,2,33722,17856,17003
9362629,9362618,TXFE7,128,9938,2,33724,17857,17005
9362767,9362760,TXFE7,128,9937,1,33725,17858,17006
9362817,9362811,TXFE7,128,9937,1,33726,17859,17007
9362842,9362840,TXFE7,128,9938,1,33727,17860,17008
9362879,9362877,TXFE7,128,9937,33,33760,17877,17009
9362892,9362884,TXFE7,128,9937,10,33770,17878,17015
9362904,9362893,TXFE7,128,9937,2,33772,17879,17016
9362967,9362959,TXFE7,128,9937,3,33775,17880,17018
9363004,9362997,TXFE7,128,9936,1,33776,17881,17019
9363017,9363013,TXFE7,128,9937,1,33777,17882,17020
9363029,9363021,TXFE7,128,9936,1,33778,17883,17021
9363042,9363037,TXFE7,128,9937,6,33784,17884,17023
9363079,9363078,TXFE7,128,9937,1,33785,17885,17024
9363092,9363087,TXFE7,128,9937,1,33786,17886,17025
9363117,9363109,TXFE7,128,9936,2,33788,17888,17026
9363117,9363113,TXFE7,128,9936,1,33789,17889,17027
9363129,9363118,TXFE7,128,9937,1,33790,17890,17028
9363192,9363181,TXFE7,128,9936,3,33793,17893,17029
9363192,9363181,TXFE7,128,9936,4,33797,17896,17030
9363192,9363181,TXFE7,128,9936,2,33799,17897,17031
9363192,9363181,TXFE7,128,9936,3,33802,17900,17032
9363192,9363181,TXFE7,128,9936,5,33807,17905,17033
9363217,9363214,TXFE7,128,9936,1,33808,17906,17034
9363254,9363249,TXFE7,128,9935,1,33809,17907,17035
9363342,9363338,TXFE7,128,9935,2,33811,17908,17036
9363404,9363394,TXFE7,128,9936,1,33812,17909,17037
9363417,9363414,TXFE7,128,9935,1,33813,17910,17038
9363429,9363419,TXFE7,128,9936,1,33814,17911,17039
9363442,9363433,TXFE7,128,9935,2,33816,17912,17040
9363479,9363479,TXFE7,128,9936,1,33817,17913,17041
9363492,9363481,TXFE7,128,9936,1,33818,17914,17042
9363529,9363525,TXFE7,128,9935,1,33819,17915,17043
9363642,9363640,TXFE7,128,9936,2,33821,17916,17045
9363817,9363807,TXFE7,128,9936,4,33825,17917,17048
9363867,9363863,TXFE7,128,9936,1,33826,17918,17049
9363879,9363874,TXFE7,128,9936,1,33827,17919,17050
9363892,9363879,TXFE7,128,9936,1,33828,17920,17051
9363892,9363882,TXFE7,128,9936,9,33837,17922,17052
9363904,9363892,TXFE7,128,9936,5,33842,17923,17053
9363954,9363946,TXFE7,128,9936,1,33843,17924,17054
9364054,9364053,TXFE7,128,9937,2,33845,17925,17056
9364067,9364056,TXFE7,128,9937,1,33846,17926,17057
9364067,9364067,TXFE7,128,9937,2,33848,17927,17059
9364229,9364221,TXFE7,128,9938,1,33849,17928,17060
9364242,9364240,TXFE7,128,9938,1,33850,17929,17061
9364254,9364244,TXFE7,128,9937,6,33856,17932,17062
9364254,9364254,TXFE7,128,9938,4,33860,17933,17066
9364267,9364256,TXFE7,128,9937,1,33861,17934,17067
9364317,9364311,TXFE7,128,9937,1,33862,17935,17068
9364329,9364319,TXFE7,128,9937,1,33863,17936,17069
9364342,9364337,TXFE7,128,9937,3,33866,17939,17070
9364517,9364505,TXFE7,128,9937,1,33867,17940,17071
9364554,9364548,TXFE7,128,9937,2,33869,17941,17072
9364667,9364657,TXFE7,128,9937,1,33870,17942,17073
9364704,9364697,TXFE7,128,9937,4,33874,17943,17077
9364742,9364734,TXFE7,128,9937,1,33875,17944,17078
9364817,9364813,TXFE7,128,9936,1,33876,17945,17079
9364829,9364824,TXFE7,128,9936,3,33879,17946,17080
9364854,9364843,TXFE7,128,9937,1,33880,17947,17081
9364867,9364864,TXFE7,128,9937,2,33882,17948,17083
9364892,9364883,TXFE7,128,9937,1,33883,17949,17084
9364892,9364885,TXFE7,128,9937,3,33886,17950,17087
9364904,9364895,TXFE7,128,9937,1,33887,17951,17088
9364904,9364901,TXFE7,128,9938,1,33888,17952,17089
9364904,9364904,TXFE7,128,9937,1,33889,17953,17090
9364992,9364984,TXFE7,128,9937,3,33892,17954,17091
9364992,9364985,TXFE7,128,9938,1,33893,17955,17092
9365054,9365051,TXFE7,128,9938,1,33894,17956,17093
9365217,9365214,TXFE7,128,9937,1,33895,17957,17094
9365229,9365220,TXFE7,128,9937,1,33896,17958,17095
9365279,9365276,TXFE7,128,9938,1,33897,17959,17096
9365292,9365289,TXFE7,128,9937,1,33898,17960,17097
9365367,9365360,TXFE7,128,9937,2,33900,17962,17098
9365392,9365385,TXFE7,128,9937,7,33907,17963,17099
9365392,9365387,TXFE7,128,9937,1,33908,17964,17100
9365404,9365392,TXFE7,128,9937,2,33910,17965,17101
9365404,9365398,TXFE7,128,9937,1,33911,17966,17102
9365429,9365428,TXFE7,128,9937,2,33913,17967,17103
9365454,9365452,TXFE7,128,9937,1,33914,17968,17104
9365479,9365478,TXFE7,128,9937,1,33915,17969,17105
9365504,9365499,TXFE7,128,9936,1,33916,17970,17106
9365529,9365520,TXFE7,128,9937,1,33917,17971,17107
9365529,9365523,TXFE7,128,9937,1,33918,17972,17108
9365554,9365544,TXFE7,128,9937,1,33919,17973,17109
9365604,9365596,TXFE7,128,9937,2,33921,17974,17111
9365629,9365620,TXFE7,128,9937,1,33922,17975,17112
9365629,9365629,TXFE7,128,9937,1,33923,17976,17113
9365654,9365643,TXFE7,128,9937,4,33927,17977,17115
9365667,9365659,TXFE7,128,9936,17,33944,17982,17116
9365667,9365662,TXFE7,128,9936,36,33980,17998,17117
9365667,9365663,TXFE7,128,9936,13,33993,18002,17118
9365667,9365664,TXFE7,129,9936,13,34017,18013,17119
9365667,9365664,TXFE7,129,9935,11,34017,18013,17119
9365667,9365667,TXFE7,128,9935,17,34034,18025,17120
9365679,9365667,TXFE7,128,9935,8,34042,18031,17121
9365679,9365667,TXFE7,128,9935,1,34043,18032,17122
9365679,9365667,TXFE7,128,9935,3,34046,18035,17123
9365679,9365667,TXFE7,128,9935,5,34051,18039,17124
9365679,9365667,TXFE7,128,9935,2,34053,18041,17125
9365679,9365667,TXFE7,129,9935,2,34063,18048,17126
9365679,9365667,TXFE7,129,9934,8,34063,18048,17126
9365679,9365668,TXFE7,128,9934,1,34064,18049,17127
9365692,9365680,TXFE7,128,9934,4,34068,18053,17128
9365692,9365684,TXFE7,128,9934,2,34070,18055,17129
9365704,9365692,TXFE7,128,9934,15,34085,18065,17130
9365704,9365692,TXFE7,128,9934,4,34089,18066,17132
9365704,9365692,TXFE7,128,9934,1,34090,18067,17133
9365704,9365698,TXFE7,128,9935,2,34092,18068,17135
9365717,9365704,TXFE7,128,9934,1,34093,18069,17136
9365717,9365704,TXFE7,128,9934,2,34095,18070,17137
9365717,9365704,TXFE7,128,9934,4,34099,18071,17138
9365717,9365704,TXFE7,128,9934,1,34100,18072,17139
9365729,9365717,TXFE7,128,9934,2,34102,18073,17140
9365742,9365733,TXFE7,128,9935,1,34103,18074,17141
9365742,9365740,TXFE7,128,9935,1,34104,18075,17142
9365754,9365742,TXFE7,128,9935,4,34108,18076,17145
9365754,9365744,TXFE7,128,9934,1,34109,18077,17146
9365754,9365753,TXFE7,128,9936,2,34111,18078,17148
9365792,9365790,TXFE7,128,9936,1,34112,18079,17149
9365804,9365804,TXFE7,128,9936,1,34113,18080,17150
9365842,9365835,TXFE7,128,9936,7,34120,18081,17152
9365854,9365848,TXFE7,128,9936,1,34121,18082,17153
9365942,9365929,TXFE7,128,9935,4,34125,18085,17154
9365954,9365942,TXFE7,128,9935,3,34128,18088,17155
9365979,9365979,TXFE7,128,9936,1,34129,18089,17156
9370042,9370033,TXFE7,128,9936,1,34130,18090,17157
9370092,9370080,TXFE7,128,9935,4,34134,18091,17158
9370092,9370087,TXFE7,128,9936,1,34135,18092,17159
9370104,9370092,TXFE7,128,9935,1,34136,18093,17160
9370642,9370635,TXFE7,128,9935,2,34138,18094,17162
9370704,9370695,TXFE7,128,9935,5,34143,18095,17166
9370904,9370901,TXFE7,128,9934,2,34145,18096,17167
9371092,9371092,TXFE7,128,9934,5,34150,18098,17168
9371117,9371113,TXFE7,128,9934,1,34151,18099,17169
9371142,9371136,TXFE7,128,9934,2,34153,18100,17170
9371142,9371139,TXFE7,128,9934,20,34173,18109,17171
9371154,9371144,TXFE7,128,9934,1,34174,18110,17172
9371154,9371146,TXFE7,128,9934,1,34175,18111,17173
9371154,9371146,TXFE7,128,9934,2,34177,18112,17174
9371154,9371146,TXFE7,128,9934,2,34179,18113,17175
9371154,9371146,TXFE7,128,9934,1,34180,18114,17176
9371154,9371146,TXFE7,128,9934,1,34181,18115,17177
9371154,9371146,TXFE7,128,9934,5,34186,18119,17178
9371154,9371147,TXFE7,128,9934,2,34188,18121,17179
9371167,9371154,TXFE7,128,9934,2,34190,18122,17180
9371167,9371154,TXFE7,128,9934,1,34191,18123,17181
9371167,9371154,TXFE7,128,9934,1,34192,18124,17182
9371167,9371154,TXFE7,128,9934,2,34194,18125,17183
9371179,9371173,TXFE7,128,9934,4,34198,18127,17184
9371192,9371180,TXFE7,128,9934,1,34199,18128,17185
9371204,9371198,TXFE7,128,9934,1,34200,18129,17186
9371292,9371284,TXFE7,128,9934,1,34201,18130,17187
9371342,9371331,TXFE7,128,9935,10,34211,18131,17195
9371479,9371476,TXFE7,128,9934,1,34212,18132,17196
9371654,9371646,TXFE7,128,9935,1,34213,18133,17197
9371729,9371721,TXFE7,128,9935,1,34214,18134,17198
9371879,9371870,TXFE7,128,9934,1,34215,18135,17199
9371942,9371936,TXFE7,128,9935,1,34216,18136,17200
9371954,9371944,TXFE7,128,9934,1,34217,18137,17201
9371992,9371980,TXFE7,128,9934,1,34218,18138,17202
9372067,9372057,TXFE7,128,9934,4,34222,18140,17203
9372067,9372066,TXFE7,128,9935,1,34223,18141,17204
9372479,9372467,TXFE7,128,9934,2,34225,18143,17205
9372504,9372501,TXFE7,128,9934,1,34226,18144,17206
9372592,9372582,TXFE7,128,9934,1,34227,18145,17207
9372679,9372671,TXFE7,128,9934,1,34228,18146,17208
9372967,9372955,TXFE7,128,9934,2,34230,18148,17209
9373067,9373064,TXFE7,128,9934,5,34235,18151,17210
9373154,9373151,TXFE7,128,9935,1,34236,18152,17211
9373354,9373345,TXFE7,128,9934,20,34256,18168,17212
9373367,9373354,TXFE7,128,9934,7,34263,18174,17213
9373404,9373396,TXFE7,128,9933,1,34264,18175,17214
9373404,9373404,TXFE7,128,9934,1,34265,18176,17215
9373429,9373422,TXFE7,128,9934,1,34266,18177,17216
9373454,9373448,TXFE7,128,9933,1,34267,18178,17217
9373467,9373460,TXFE7,128,9933,1,34268,18179,17218
9373579,9373574,TXFE7,128,9934,1,34269,18180,17219
9373717,9373707,TXFE7,128,9935,3,34272,18181,17222
9373742,9373741,TXFE7,128,9935,1,34273,18182,17223
9373867,9373860,TXFE7,128,9934,1,34274,18183,17224
9373867,9373862,TXFE7,128,9934,1,34275,18184,17225
9373879,9373875,TXFE7,128,9934,1,34276,18185,17226
9373892,9373887,TXFE7,128,9934,3,34279,18186,17227
9373917,9373904,TXFE7,128,9934,3,34282,18189,17228
9373929,9373917,TXFE7,128,9934,1,34283,18190,17229
9373942,9373941,TXFE7,128,9934,1,34284,18191,17230
9373967,9373966,TXFE7,128,9933,3,34287,18194,17231
9373979,9373976,TXFE7,128,9933,6,34293,18198,17232
9374042,9374030,TXFE7,128,9933,3,34296,18199,17233
9374129,9374124,TXFE7,128,9934,1,34297,18200,17234
9374292,9374287,TXFE7,128,9934,14,34311,18201,17240
9374479,9374468,TXFE7,128,9934,1,34312,18202,17241
9374592,9374589,TXFE7,128,9934,1,34313,18203,17242
9374654,9374644,TXFE7,128,9934,1,34314,18204,17243
9374704,9374701,TXFE7,128,9935,1,34315,18205,17244
9374729,9374727,TXFE7,128,9934,2,34317,18207,17245
9374779,9374774,TXFE7,128,9934,1,34318,18208,17246
9374904,9374892,TXFE7,128,9934,2,34320,18209,17247
9375367,9375367,TXFE7,128,9935,1,34321,18210,17248
9375567,9375567,TXFE7,128,9935,1,34322,18211,17249
9375629,9375621,TXFE7,128,9934,11,34333,18219,17250
9375667,9375656,TXFE7,128,9934,11,34344,18226,17251
9375729,9375718,TXFE7,128,9934,4,34348,18228,17252
9375729,9375722,TXFE7,128,9934,3,34351,18231,17253
9375729,9375723,TXFE7,128,9935,1,34352,18232,17254
9375754,9375752,TXFE7,128,9934,1,34353,18233,17255
9375867,9375867,TXFE7,128,9934,1,34354,18234,17256
9380054,9380047,TXFE7,128,9934,1,34355,18235,17257
9380067,9380065,TXFE7,128,9935,1,34356,18236,17258
9380092,9380087,TXFE7,128,9934,24,34380,18252,17259
9380304,9380292,TXFE7,128,9934,2,34382,18253,17260
9380317,9380314,TXFE7,128,9934,4,34386,18254,17261
9380467,9380460,TXFE7,128,9934,1,34387,18255,17262
9380592,9380591,TXFE7,128,9934,2,34389,18256,17263
9380604,9380596,TXFE7,128,9934,1,34390,18257,17264
9380629,9380619,TXFE7,128,9934,2,34392,18258,17265
9380679,9380677,TXFE7,128,9934,3,34395,18259,17266
9380804,9380792,TXFE7,128,9934,1,34396,18260,17267
9380817,9380808,TXFE7,128,9934,4,34400,18261,17268
9380879,9380872,TXFE7,128,9934,2,34402,18262,17270
9380879,9380872,TXFE7,128,9934,9,34411,18263,17275
9380879,9380873,TXFE7,128,9934,1,34412,18264,17276
9381042,9381039,TXFE7,128,9934,2,34414,18266,17277
9381267,9381265,TXFE7,128,9935,1,34415,18267,17278
9381429,9381425,TXFE7,128,9934,2,34417,18268,17279
9381442,9381442,TXFE7,128,9935,1,34418,18269,17280
9381979,9381969,TXFE7,128,9935,1,34419,18270,17281
9382117,9382110,TXFE7,128,9934,2,34421,18271,17282
9382129,9382126,TXFE7,128,9934,5,34426,18273,17283
9382179,9382168,TXFE7,128,9934,1,34427,18274,17284
9382254,9382242,TXFE7,128,9934,1,34428,18275,17285
9382317,9382312,TXFE7,128,9934,1,34429,18276,17286
9382354,9382347,TXFE7,128,9935,14,34443,18277,17296
9382354,9382351,TXFE7,128,9935,1,34444,18278,17297
9382367,9382355,TXFE7,128,9934,4,34448,18281,17298
9382392,9382383,TXFE7,128,9934,1,34449,18282,17299
9382504,9382503,TXFE7,128,9935,1,34450,18283,17300
9382554,9382545,TXFE7,128,9935,1,34451,18284,17301
9382679,9382674,TXFE7,128,9934,2,34453,18285,17302
9382767,9382760,TXFE7,128,9934,1,34454,18286,17303
9382979,9382970,TXFE7,128,9935,5,34459,18287,17308
9383004,9383002,TXFE7,128,9935,3,34462,18288,17311
9383092,9383081,TXFE7,128,9935,5,34467,18289,17315
9383092,9383088,TXFE7,128,9935,1,34468,18290,17316
9383104,9383092,TXFE7,128,9935,11,34479,18291,17324
9383117,9383110,TXFE7,128,9934,1,34480,18292,17325
9383254,9383246,TXFE7,128,9935,1,34481,18293,17326
9383304,9383297,TXFE7,128,9935,1,34482,18294,17327
9383617,9383613,TXFE7,128,9935,1,34483,18295,17328
9383629,9383628,TXFE7,128,9935,2,34485,18296,17329
9383642,9383631,TXFE7,128,9935,14,34499,18301,17330
9383642,9383632,TXFE7,128,9936,5,34504,18302,17332
9383667,9383660,TXFE7,128,9935,1,34505,18303,17333
9383942,9383941,TXFE7,128,9935,1,34506,18304,17334
9384079,9384068,TXFE7,128,9936,1,34507,18305,17335
9384617,9384614,TXFE7,128,9936,7,34514,18306,17339
9384792,9384784,TXFE7,128,9936,1,34515,18307,17340
9384892,9384892,TXFE7,128,9935,1,34516,18308,17341
9385142,9385140,TXFE7,128,9935,1,34517,18309,17342
9385192,9385181,TXFE7,128,9936,11,34528,18310,17347
9385317,9385305,TXFE7,128,9935,24,34552,18320,17348
9385329,9385321,TXFE7,128,9935,1,34553,18321,17349
9385417,9385413,TXFE7,128,9935,1,34554,18322,17350
9385654,9385642,TXFE7,128,9934,1,34555,18323,17351
9390042,9390037,TXFE7,128,9934,1,34556,18324,17352
9390042,9390038,TXFE7,128,9934,1,34557,18325,17353
9390042,9390038,TXFE7,128,9934,1,34558,18326,17354
9390042,9390038,TXFE7,128,9934,1,34559,18327,17355
9390042,9390038,TXFE7,128,9934,1,34560,18328,17356
9390042,9390038,TXFE7,128,9934,35,34595,18352,17357
9390054,9390046,TXFE7,128,9933,1,34596,18353,17358
9390067,9390054,TXFE7,128,9933,3,34599,18356,17359
9390067,9390066,TXFE7,128,9934,1,34600,18357,17360
9390167,9390166,TXFE7,128,9934,1,34601,18358,17361
9390179,9390177,TXFE7,128,9934,1,34602,18359,17362
9390217,9390215,TXFE7,128,9933,1,34603,18360,17363
9390242,9390231,TXFE7,128,9934,7,34610,18361,17365
9390254,9390246,TXFE7,128,9933,2,34612,18363,17366
9390454,9390442,TXFE7,128,9933,1,34613,18364,17367
9390467,9390459,TXFE7,128,9933,100,34713,18399,17368
9390467,9390461,TXFE7,128,9933,7,34720,18403,17369
9390467,9390461,TXFE7,128,9933,1,34721,18404,17370
9390467,9390461,TXFE7,128,9933,2,34723,18405,17371
9390467,9390461,TXFE7,128,9933,2,34725,18406,17372
9390479,9390467,TXFE7,128,9932,4,34729,18408,17373
9390479,9390467,TXFE7,128,9932,2,34731,18410,17374
9390479,9390467,TXFE7,128,9932,1,34732,18411,17375
9390479,9390467,TXFE7,128,9932,10,34742,18421,17376
9390479,9390471,TXFE7,128,9932,1,34743,18422,17377
9390479,9390471,TXFE7,128,9932,3,34746,18425,17378
9390479,9390471,TXFE7,128,9932,4,34750,18428,17379
9390479,9390471,TXFE7,128,9932,8,34758,18431,17380
9390479,9390471,TXFE7,128,9932,2,34760,18432,17381
9390479,9390471,TXFE7,128,9932,2,34762,18433,17382
9390479,9390471,TXFE7,128,9932,6,34768,18436,17383
9390479,9390471,TXFE7,128,9932,3,34771,18439,17384
9390479,9390471,TXFE7,128,9932,4,34775,18442,17385
9390479,9390471,TXFE7,128,9932,2,34777,18444,17386
9390479,9390471,TXFE7,128,9932,4,34781,18448,17387
9390492,9390479,TXFE7,128,9932,1,34782,18449,17388
9390492,9390479,TXFE7,128,9931,7,34789,18454,17389
9390492,9390480,TXFE7,128,9931,7,34796,18459,17390
9390504,9390492,TXFE7,128,9931,1,34797,18460,17391
9390504,9390492,TXFE7,128,9931,5,34802,18461,17392
9390504,9390492,TXFE7,128,9931,24,34826,18464,17393
9390504,9390493,TXFE7,128,9931,1,34827,18465,17394
9390504,9390500,TXFE7,128,9931,1,34828,18466,17395
9390517,9390504,TXFE7,128,9931,1,34829,18467,17396
9390517,9390504,TXFE7,128,9931,2,34831,18469,17397
9390517,9390505,TXFE7,128,9931,14,34845,18480,17398
9390517,9390511,TXFE7,128,9931,1,34846,18481,17399
9390517,9390512,TXFE7,128,9931,1,34847,18482,17400
9390517,9390514,TXFE7,128,9930,1,34848,18483,17401
9390517,9390516,TXFE7,128,9930,1,34849,18484,17402
9390529,9390517,TXFE7,128,9930,14,34863,18492,17403
9390529,9390520,TXFE7,128,9930,1,34864,18493,17404
9390529,9390520,TXFE7,128,9930,1,34865,18494,17405
9390529,9390524,TXFE7,128,9930,2,34867,18495,17406
9390529,9390527,TXFE7,128,9930,2,34869,18496,17407
9390554,9390553,TXFE7,128,9931,1,34870,18497,17408
9390567,9390566,TXFE7,128,9930,1,34871,18498,17409
9390579,9390574,TXFE7,128,9931,7,34878,18499,17415
9390592,9390587,TXFE7,128,9931,1,34879,18500,17416
9390617,9390615,TXFE7,128,9932,1,34880,18501,17417
9390629,9390618,TXFE7,128,9931,1,34881,18502,17418
9390629,9390626,TXFE7,128,9931,5,34886,18503,17419
9390654,9390649,TXFE7,128,9931,1,34887,18504,17420
9390667,9390666,TXFE7,128,9931,1,34888,18505,17421
9390667,9390666,TXFE7,128,9932,1,34889,18506,17422
9390692,9390691,TXFE7,128,9932,5,34894,18507,17426
9390717,9390712,TXFE7,128,9932,5,34899,18508,17429
9390729,9390719,TXFE7,128,9931,1,34900,18509,17430
9390829,9390824,TXFE7,128,9931,1,34901,18510,17431
9390979,9390971,TXFE7,128,9932,2,34903,18511,17432
9390992,9390984,TXFE7,128,9931,1,34904,18512,17433
9391029,9391024,TXFE7,128,9931,1,34905,18513,17434
9391067,9391065,TXFE7,128,9931,2,34907,18514,17435
9391092,9391080,TXFE7,128,9931,1,34908,18515,17436
9391129,9391128,TXFE7,128,9931,2,34910,18516,17437
9391142,9391131,TXFE7,128,9931,12,34922,18524,17438
9391142,9391135,TXFE7,128,9931,1,34923,18525,17439
9391167,9391161,TXFE7,128,9932,1,34924,18526,17440
9391179,9391176,TXFE7,128,9931,1,34925,18527,17441
9391192,9391187,TXFE7,128,9931,1,34926,18528,17442
9391254,9391250,TXFE7,128,9931,1,34927,18529,17443
9391267,9391266,TXFE7,128,9931,1,34928,18530,17444
9391304,9391300,TXFE7,128,9932,25,34953,18531,17452
9391354,9391348,TXFE7,128,9933,1,34954,18532,17453
9391504,9391496,TXFE7,128,9932,5,34959,18534,17454
9391517,9391516,TXFE7,128,9932,2,34961,18536,17455
9391692,9391685,TXFE7,128,9932,1,34962,18537,17456
9391767,9391760,TXFE7,128,9932,1,34963,18538,17457
9391779,9391778,TXFE7,128,9932,1,34964,18539,17458
9391817,9391809,TXFE7,128,9933,10,34974,18540,17462
9391842,9391836,TXFE7,128,9933,2,34976,18541,17463
9391917,9391905,TXFE7,128,9932,1,34977,18542,17464
9391917,9391909,TXFE7,128,9933,1,34978,18543,17465
9392317,9392314,TXFE7,128,9932,5,34983,18544,17466
9392467,9392465,TXFE7,128,9933,10,34993,18545,17468
9392492,9392483,TXFE7,128,9933,10,35003,18546,17471
9392554,9392550,TXFE7,128,9932,1,35004,18547,17472
9392567,9392559,TXFE7,128,9933,5,35009,18548,17475
9392654,9392652,TXFE7,128,9933,1,35010,18549,17476
9392717,9392710,TXFE7,128,9933,1,35011,18550,17477
9392942,9392930,TXFE7,128,9933,1,35012,18551,17478
9392954,9392943,TXFE7,128,9932,1,35013,18552,17479
9392954,9392946,TXFE7,128,9933,1,35014,18553,17480
9392979,9392967,TXFE7,128,9933,1,35015,18554,17481
9393104,9393102,TXFE7,128,9933,1,35016,18555,17482
9393117,9393115,TXFE7,129,9933,1,35019,18556,17484
9393117,9393115,TXFE7,129,9934,2,35019,18556,17484
9393204,9393194,TXFE7,128,9933,1,35020,18557,17485
9393217,9393208,TXFE7,128,9933,1,35021,18558,17486
9393567,9393556,TXFE7,128,9933,1,35022,18559,17487
9393604,9393592,TXFE7,128,9933,3,35025,18560,17489
9393604,9393599,TXFE7,128,9933,1,35026,18561,17490
9393617,9393612,TXFE7,128,9932,2,35028,18563,17491
9393642,9393635,TXFE7,128,9933,5,35033,18564,17492
9393654,9393650,TXFE7,128,9933,1,35034,18565,17493
9393729,9393725,TXFE7,128,9933,1,35035,18566,17494
9393792,9393783,TXFE7,128,9933,11,35046,18567,17497
9393792,9393787,TXFE7,128,9933,2,35048,18568,17499
9393804,9393798,TXFE7,128,9933,5,35053,18569,17501
9394367,9394357,TXFE7,128,9934,1,35054,18570,17502
9394379,9394369,TXFE7,128,9934,2,35056,18571,17504
9394392,9394382,TXFE7,128,9933,1,35057,18572,17505
9394442,9394430,TXFE7,128,9934,2,35059,18573,17507
9394442,9394441,TXFE7,128,9934,5,35064,18574,17508
9394479,9394470,TXFE7,128,9934,2,35066,18575,17510
9394542,9394540,TXFE7,128,9934,5,35071,18576,17513
9394592,9394583,TXFE7,128,9934,1,35072,18577,17514
9394717,9394716,TXFE7,128,9935,28,35100,18578,17532
9394729,9394724,TXFE7,128,9936,1,35101,18579,17533
9394792,9394786,TXFE7,128,9936,3,35104,18580,17535
9394792,9394789,TXFE7,128,9936,2,35106,18581,17536
9394804,9394795,TXFE7,128,9936,2,35108,18582,17537
9394829,9394828,TXFE7,128,9936,5,35113,18583,17540
9394842,9394838,TXFE7,128,9936,2,35115,18584,17542
9394842,9394840,TXFE7,128,9936,3,35118,18585,17543
9394854,9394842,TXFE7,128,9936,5,35123,18586,17547
9394867,9394856,TXFE7,128,9935,1,35124,18587,17548
9394979,9394967,TXFE7,128,9936,3,35127,18588,17550
9395092,9395083,TXFE7,128,9935,4,35131,18589,17551
9395104,9395096,TXFE7,128,9935,1,35132,18590,17552
9395129,9395119,TXFE7,128,9935,1,35133,18591,17553
9395142,9395129,TXFE7,128,9935,20,35153,18597,17554
9395229,9395217,TXFE7,128,9934,15,35168,18604,17555
9395317,9395310,TXFE7,128,9935,1,35169,18605,17556
9395567,9395565,TXFE7,128,9936,1,35170,18606,17557
9395879,9395877,TXFE7,128,9936,3,35173,18607,17559
9395904,9395899,TXFE7,128,9935,1,35174,18608,17560
9395929,9395920,TXFE7,128,9936,1,35175,18609,17561
9400067,9400059,TXFE7,128,9936,1,35176,18610,17562
9400067,9400063,TXFE7,128,9935,2,35178,18612,17563
9400117,9400114,TXFE7,128,9936,1,35179,18613,17564
9400129,9400121,TXFE7,128,9936,1,35180,18614,17565
9400129,9400122,TXFE7,128,9936,1,35181,18615,17566
9400129,9400125,TXFE7,128,9936,1,35182,18616,17567
9400142,9400136,TXFE7,128,9935,1,35183,18617,17568
9400179,9400167,TXFE7,128,9936,3,35186,18618,17570
9400179,9400170,TXFE7,128,9935,2,35188,18620,17571
9400304,9400302,TXFE7,128,9935,1,35189,18621,17572
9400317,9400306,TXFE7,128,9936,1,35190,18622,17573
9400392,9400391,TXFE7,128,9935,1,35191,18623,17574
9400404,9400396,TXFE7,128,9935,8,35199,18627,17575
9400442,9400437,TXFE7,128,9935,6,35205,18629,17576
9400554,9400542,TXFE7,128,9935,1,35206,18630,17577
9400867,9400858,TXFE7,128,9936,1,35207,18631,17578
9400892,9400879,TXFE7,128,9936,1,35208,18632,17579
9400892,9400891,TXFE7,128,9935,1,35209,18633,17580
9401017,9401008,TXFE7,128,9936,1,35210,18634,17581
9401054,9401052,TXFE7,128,9935,2,35212,18635,17582
9401079,9401073,TXFE7,128,9935,2,35214,18636,17583
9401304,9401295,TXFE7,128,9936,4,35218,18637,17584
9401329,9401327,TXFE7,128,9936,1,35219,18638,17585
9401354,9401342,TXFE7,128,9936,44,35263,18639,17609
9401354,9401348,TXFE7,128,9936,2,35265,18640,17610
9401367,9401364,TXFE7,128,9936,1,35266,18641,17611
9401367,9401364,TXFE7,128,9937,1,35267,18642,17612
9401379,9401368,TXFE7,128,9937,1,35268,18643,17613
9401392,9401379,TXFE7,128,9937,48,35316,18644,17636
9401404,9401392,TXFE7,128,9937,1,35317,18645,17637
9401404,9401392,TXFE7,128,9937,1,35318,18646,17638
9401404,9401392,TXFE7,128,9937,4,35322,18647,17640
9401404,9401392,TXFE7,128,9937,1,35323,18648,17641
9401404,9401392,TXFE7,128,9937,2,35325,18649,17643
9401429,9401421,TXFE7,128,9937,1,35326,18650,17644
9401592,9401580,TXFE7,128,9937,1,35327,18651,17645
9401592,9401589,TXFE7,128,9938,1,35328,18652,17646
9401604,9401592,TXFE7,128,9937,4,35332,18654,17647
9401617,9401605,TXFE7,128,9938,1,35333,18655,17648
9401679,9401668,TXFE7,128,9937,2,35335,18656,17649
9401692,9401688,TXFE7,128,9937,2,35337,18657,17650
9401767,9401761,TXFE7,128,9937,1,35338,18658,17651
9401779,9401774,TXFE7,128,9937,5,35343,18659,17653
9401804,9401797,TXFE7,128,9937,1,35344,18660,17654
9401867,9401857,TXFE7,128,9937,2,35346,18661,17656
9401879,9401867,TXFE7,128,9937,2,35348,18662,17657
9401892,9401892,TXFE7,128,9938,1,35349,18663,17658
9401967,9401963,TXFE7,128,9937,1,35350,18664,17659
9402004,9401993,TXFE7,128,9937,1,35351,18665,17660
9402017,9402004,TXFE7,128,9937,1,35352,18666,17661
9402029,9402019,TXFE7,128,9937,1,35353,18667,17662
9402192,9402190,TXFE7,128,9938,1,35354,18668,17663
9402217,9402213,TXFE7,128,9937,1,35355,18669,17664
9402229,9402219,TXFE7,128,9938,1,35356,18670,17665
9402254,9402251,TXFE7,128,9938,1,35357,18671,17666
9402279,9402267,TXFE7,128,9938,1,35358,18672,17667
9402292,9402288,TXFE7,128,9938,1,35359,18673,17668
9402317,9402308,TXFE7,128,9938,1,35360,18674,17669
9402342,9402331,TXFE7,128,9938,2,35362,18675,17670
9402342,9402331,TXFE7,128,9938,3,35365,18676,17673
9402342,9402341,TXFE7,128,9937,1,35366,18677,17674
9402404,9402393,TXFE7,128,9937,4,35370,18680,17675
9402404,9402398,TXFE7,128,9938,1,35371,18681,17676
9402417,9402415,TXFE7,128,9937,1,35372,18682,17677
9402467,9402456,TXFE7,128,9937,1,35373,18683,17678
9402517,9402509,TXFE7,128,9937,1,35374,18684,17679
9402579,9402572,TXFE7,128,9938,2,35376,18685,17681
9402579,9402577,TXFE7,128,9937,1,35377,18686,17682
9402679,9402671,TXFE7,128,9937,1,35378,18687,17683
9402692,9402688,TXFE7,128,9938,1,35379,18688,17684
9402692,9402689,TXFE7,128,9938,2,35381,18689,17685
9402779,9402779,TXFE7,128,9937,1,35382,18690,17686
9402879,9402875,TXFE7,128,9938,1,35383,18691,17687
9402892,9402889,TXFE7,128,9937,1,35384,18692,17688
9402904,9402892,TXFE7,128,9937,1,35385,18693,17689
9402917,9402914,TXFE7,128,9938,1,35386,18694,17690
9402942,9402941,TXFE7,128,9938,4,35390,18695,17694
9403117,9403115,TXFE7,128,9938,1,35391,18696,17695
9403179,9403168,TXFE7,128,9938,2,35393,18697,17697
9403192,9403191,TXFE7,128,9938,2,35395,18698,17699
9403292,9403283,TXFE7,128,9938,2,35397,18699,17701
9403329,9403318,TXFE7,128,9938,1,35398,18700,17702
9403342,9403330,TXFE7,128,9937,1,35399,18701,17703
9403417,9403408,TXFE7,128,9938,1,35400,18702,17704
9403454,9403445,TXFE7,128,9937,1,35401,18703,17705
9403479,9403469,TXFE7,128,9938,3,35404,18704,17708
9403517,9403514,TXFE7,128,9938,1,35405,18705,17709
9403529,9403526,TXFE7,128,9937,1,35406,18706,17710
9403529,9403529,TXFE7,128,9938,2,35408,18707,17711
9403667,9403659,TXFE7,128,9938,1,35409,18708,17712
9403767,9403756,TXFE7,128,9938,1,35410,18709,17713
9403767,9403765,TXFE7,128,9938,1,35411,18710,17714
9403804,9403795,TXFE7,128,9938,1,35412,18711,17715
9403804,9403801,TXFE7,128,9938,1,35413,18712,17716
9403829,9403821,TXFE7,128,9937,1,35414,18713,17717
9403867,9403855,TXFE7,128,9937,2,35416,18714,17718
9403892,9403886,TXFE7,128,9938,1,35417,18715,17719
9403904,9403895,TXFE7,128,9938,1,35418,18716,17720
9403917,9403905,TXFE7,128,9938,1,35419,18717,17721
9403992,9403991,TXFE7,128,9938,1,35420,18718,17722
9404304,9404301,TXFE7,128,9938,1,35421,18719,17723
9404317,9404305,TXFE7,128,9937,1,35422,18720,17724
9404354,9404344,TXFE7,128,9938,2,35424,18721,17726
9404404,9404393,TXFE7,128,9938,2,35426,18722,17727
9404504,9404494,TXFE7,128,9938,2,35428,18723,17728
9404579,9404577,TXFE7,128,9938,1,35429,18724,17729
9404617,9404612,TXFE7,128,9938,8,35437,18725,17733
9404629,9404626,TXFE7,128,9938,1,35438,18726,17734
9404704,9404704,TXFE7,128,9937,2,35440,18727,17735
9404729,9404724,TXFE7,128,9938,9,35449,18728,17741
9404804,9404800,TXFE7,128,9938,10,35459,18729,17749
9404842,9404836,TXFE7,128,9938,1,35460,18730,17750
9404867,9404854,TXFE7,128,9938,5,35465,18731,17753
9404867,9404862,TXFE7,128,9938,50,35515,18732,17779
9404879,9404867,TXFE7,128,9938,4,35519,18733,17780
9404879,9404867,TXFE7,128,9938,5,35524,18734,17785
9404879,9404878,TXFE7,128,9938,1,35525,18735,17786
9404992,9404983,TXFE7,128,9938,1,35526,18736,17787
9405017,9405014,TXFE7,128,9938,1,35527,18737,17788
9405067,9405063,TXFE7,128,9939,5,35532,18738,17793
9405067,9405065,TXFE7,128,9939,2,35534,18739,17795
9405079,9405069,TXFE7,128,9938,1,35535,18740,17796
9405079,9405070,TXFE7,128,9939,1,35536,18741,17797
9405079,9405070,TXFE7,128,9939,1,35537,18742,17798
9405079,9405071,TXFE7,128,9939,1,35538,18743,17799
9405092,9405089,TXFE7,128,9939,5,35543,18744,17801
9405092,9405089,TXFE7,128,9939,1,35544,18745,17802
9405104,9405100,TXFE7,128,9939,1,35545,18746,17803
9405117,9405114,TXFE7,128,9939,1,35546,18747,17804
9405129,9405121,TXFE7,128,9939,3,35549,18748,17807
9405167,9405165,TXFE7,128,9938,2,35551,18749,17808
9405179,9405177,TXFE7,128,9939,1,35552,18750,17809
9405192,9405190,TXFE7,128,9939,9,35561,18751,17814
9405204,9405200,TXFE7,128,9939,1,35562,18752,17815
9405217,9405205,TXFE7,128,9939,5,35567,18753,17820
9405229,9405228,TXFE7,128,9938,1,35568,18754,17821
9405242,9405230,TXFE7,128,9939,2,35570,18755,17823
9405242,9405236,TXFE7,128,9939,1,35571,18756,17824
9405254,9405243,TXFE7,128,9939,6,35577,18757,17830
9405292,9405283,TXFE7,128,9938,1,35578,18758,17831
9405304,9405295,TXFE7,128,9938,1,35579,18759,17832
9405317,9405314,TXFE7,128,9938,1,35580,18760,17833
9405329,9405323,TXFE7,128,9939,2,35582,18761,17834
9405342,9405329,TXFE7,128,9938,1,35583,18762,17835
9405404,9405392,TXFE7,128,9938,1,35584,18763,17836
9405404,9405394,TXFE7,128,9938,1,35585,18764,17837
9405429,9405429,TXFE7,128,9938,1,35586,18765,17838
9405454,9405443,TXFE7,128,9938,1,35587,18766,17839
9405504,9405503,TXFE7,128,9939,1,35588,18767,17840
9405592,9405584,TXFE7,128,9939,5,35593,18768,17841
9405604,9405599,TXFE7,128,9938,1,35594,18769,17842
9405617,9405613,TXFE7,128,9938,1,35595,18770,17843
9405629,9405629,TXFE7,128,9938,8,35603,18773,17844
9405629,9405629,TXFE7,128,9938,1,35604,18774,17845
9405629,9405629,TXFE7,128,9938,1,35605,18775,17846
9405654,9405644,TXFE7,128,9938,5,35610,18776,17850
9405667,9405660,TXFE7,128,9938,1,35611,18777,17851
9405679,9405675,TXFE7,128,9938,2,35613,18778,17852
9405717,9405704,TXFE7,128,9938,4,35617,18779,17854
9405717,9405707,TXFE7,128,9938,3,35620,18780,17856
9405717,9405711,TXFE7,128,9938,1,35621,18781,17857
9405729,9405725,TXFE7,128,9938,1,35622,18782,17858
9405729,9405728,TXFE7,128,9938,1,35623,18783,17859
9405742,9405734,TXFE7,128,9938,1,35624,18784,17860
9405754,9405743,TXFE7,128,9938,1,35625,18785,17861
9405754,9405750,TXFE7,128,9939,2,35627,18786,17862
9405804,9405797,TXFE7,128,9938,1,35628,18787,17863
9405854,9405851,TXFE7,128,9939,4,35632,18788,17866
9405867,9405861,TXFE7,128,9939,4,35636,18789,17869
9405879,9405877,TXFE7,128,9938,1,35637,18790,17870
9405892,9405886,TXFE7,128,9939,1,35638,18791,17871
9405929,9405929,TXFE7,128,9938,5,35643,18793,17872
9405942,9405940,TXFE7,128,9939,1,35644,18794,17873
9405942,9405941,TXFE7,128,9939,5,35649,18795,17877
9405979,9405968,TXFE7,128,9939,5,35654,18796,17882
9405992,9405990,TXFE7,128,9938,1,35655,18797,17883
9410142,9410140,TXFE7,128,9939,1,35656,18798,17884
9410154,9410151,TXFE7,128,9939,1,35657,18799,17885
9410192,9410190,TXFE7,128,9939,1,35658,18800,17886
9410229,9410227,TXFE7,128,9938,3,35661,18803,17887
9410242,9410232,TXFE7,128,9939,1,35662,18804,17888
9410254,9410247,TXFE7,128,9939,1,35663,18805,17889
9410292,9410286,TXFE7,128,9939,2,35665,18806,17891
9410317,9410310,TXFE7,128,9939,4,35669,18807,17895
9410379,9410368,TXFE7,128,9938,1,35670,18808,17896
9410404,9410394,TXFE7,128,9939,2,35672,18809,17898
9410404,9410398,TXFE7,128,9938,1,35673,18810,17899
9410429,9410426,TXFE7,128,9939,2,35675,18811,17901
9410454,9410443,TXFE7,128,9939,2,35677,18812,17903
9410479,9410467,TXFE7,128,9939,3,35680,18813,17905
9410517,9410509,TXFE7,128,9939,2,35682,18814,17907
9410542,9410530,TXFE7,128,9939,2,35684,18815,17908
9410542,9410532,TXFE7,128,9938,1,35685,18816,17909
9410554,9410545,TXFE7,128,9939,2,35687,18817,17910
9410567,9410557,TXFE7,128,9939,2,35689,18818,17911
9410579,9410568,TXFE7,128,9939,2,35691,18819,17912
9410592,9410583,TXFE7,128,9939,2,35693,18820,17913
9410604,9410593,TXFE7,128,9939,1,35694,18821,17914
9410629,9410619,TXFE7,128,9939,1,35695,18822,17915
9410704,9410695,TXFE7,128,9939,1,35696,18823,17916
9410704,9410696,TXFE7,128,9939,4,35700,18824,17920
9410792,9410785,TXFE7,128,9939,1,35701,18825,17921
9410792,9410785,TXFE7,128,9939,1,35702,18826,17922
9410804,9410795,TXFE7,128,9939,8,35710,18827,17930
9410904,9410897,TXFE7,128,9938,23,35733,18846,17931
9410954,9410949,TXFE7,128,9938,1,35734,18847,17932
9410954,9410951,TXFE7,128,9938,1,35735,18848,17933
9410967,9410957,TXFE7,128,9938,1,35736,18849,17934
9410979,9410968,TXFE7,128,9938,3,35739,18850,17935
9410992,9410980,TXFE7,128,9938,1,35740,18851,17936
9410992,9410981,TXFE7,128,9938,1,35741,18852,17937
9411004,9411004,TXFE7,128,9937,44,35785,18882,17938
9411017,9411004,TXFE7,128,9937,1,35786,18883,17939
9411029,9411019,TXFE7,128,9937,1,35787,18884,17940
9411092,9411089,TXFE7,128,9937,3,35790,18885,17942
9411179,9411169,TXFE7,128,9937,2,35792,18886,17943
9411192,9411185,TXFE7,128,9937,1,35793,18887,17944
9411242,9411233,TXFE7,128,9936,1,35794,18888,17945
9411267,9411264,TXFE7,128,9936,1,35795,18889,17946
9411304,9411292,TXFE7,128,9937,1,35796,18890,17947
9411317,9411310,TXFE7,128,9937,2,35798,18891,17948
9411317,9411312,TXFE7,128,9937,2,35800,18892,17950
9411317,9411313,TXFE7,128,9937,2,35802,18893,17952
9411317,9411315,TXFE7,128,9938,2,35804,18894,17953
9411317,9411316,TXFE7,128,9938,2,35806,18895,17954
9411329,9411317,TXFE7,128,9937,1,35807,18896,17955
9411367,9411358,TXFE7,128,9937,1,35808,18897,17956
9411367,9411359,TXFE7,128,9937,1,35809,18898,17957
9411417,9411414,TXFE7,128,9937,1,35810,18899,17958
9411467,9411460,TXFE7,128,9938,1,35811,18900,17959
9411517,9411505,TXFE7,128,9937,1,35812,18901,17960
9411529,9411522,TXFE7,128,9938,1,35813,18902,17961
9411617,9411611,TXFE7,128,9937,1,35814,18903,17962
9411717,9411705,TXFE7,128,9937,1,35815,18904,17963
9411717,9411710,TXFE7,128,9937,2,35817,18906,17964
9411754,9411742,TXFE7,128,9937,2,35819,18907,17965
9411754,9411744,TXFE7,128,9937,3,35822,18909,17966
9411792,9411789,TXFE7,128,9936,5,35827,18911,17967
9411817,9411816,TXFE7,128,9937,1,35828,18912,17968
9411867,9411864,TXFE7,128,9937,1,35829,18913,17969
9411892,9411880,TXFE7,128,9937,1,35830,18914,17970
9412179,9412172,TXFE7,128,9937,1,35831,18915,17971
9412192,9412189,TXFE7,128,9937,3,35834,18916,17972
9412254,9412249,TXFE7,128,9937,1,35835,18917,17973
9412267,9412258,TXFE7,128,9937,2,35837,18919,17974
9412392,9412382,TXFE7,128,9937,4,35841,18923,17975
9412392,9412382,TXFE7,128,9938,1,35842,18924,17976
9412442,9412431,TXFE7,128,9937,1,35843,18925,17977
9412454,9412442,TXFE7,128,9938,1,35844,18926,17978
9412454,9412452,TXFE7,128,9938,1,35845,18927,17979
9412692,9412691,TXFE7,128,9938,1,35846,18928,17980
9412804,9412795,TXFE7,128,9938,1,35847,18929,17981
9412804,9412802,TXFE7,128,9937,1,35848,18930,17982
9412904,9412896,TXFE7,128,9938,1,35849,18931,17983
9412967,9412958,TXFE7,128,9938,5,35854,18932,17987
9412967,9412961,TXFE7,128,9938,1,35855,18933,17988
9412979,9412972,TXFE7,128,9938,25,35880,18934,18007
9413054,9413044,TXFE7,128,9939,2,35882,18935,18009
9413092,9413086,TXFE7,128,9938,1,35883,18936,18010
9413129,9413128,TXFE7,128,9938,1,35884,18937,18011
9413204,9413194,TXFE7,128,9938,1,35885,18938,18012
9413292,9413287,TXFE7,128,9938,1,35886,18939,18013
9413467,9413461,TXFE7,128,9938,1,35887,18940,18014
9413479,9413472,TXFE7,128,9938,1,35888,18941,18015
9413517,9413515,TXFE7,128,9939,15,35903,18942,18024
9413567,9413557,TXFE7,128,9939,1,35904,18943,18025
9413592,9413584,TXFE7,128,9938,1,35905,18944,18026
9413629,9413619,TXFE7,128,9939,5,35910,18945,18030
9413992,9413989,TXFE7,128,9939,2,35912,18946,18032
9414004,9413994,TXFE7,128,9939,18,35930,18947,18047
9414017,9414007,TXFE7,128,9940,1,35931,18948,18048
9414017,9414012,TXFE7,128,9939,1,35932,18949,18049
9414029,9414017,TXFE7,128,9939,3,35935,18950,18050
9414029,9414019,TXFE7,128,9940,2,35937,18951,18052
9414029,9414019,TXFE7,128,9940,4,35941,18952,18055
9414029,9414021,TXFE7,128,9940,2,35943,18953,18057
9414029,9414021,TXFE7,128,9940,2,35945,18954,18059
9414029,9414022,TXFE7,128,9940,1,35946,18955,18060
9414029,9414023,TXFE7,128,9940,1,35947,18956,18061
9414029,9414025,TXFE7,128,9940,2,35949,18957,18063
9414042,9414034,TXFE7,128,9940,1,35950,18958,18064
9414042,9414037,TXFE7,128,9940,1,35951,18959,18065
9414042,9414038,TXFE7,128,9940,1,35952,18960,18066
9414054,9414049,TXFE7,128,9940,12,35964,18961,18073
9414067,9414055,TXFE7,128,9940,1,35965,18962,18074
9414067,9414056,TXFE7,128,9940,10,35975,18963,18075
9414067,9414061,TXFE7,128,9940,2,35977,18964,18076
9414067,9414062,TXFE7,128,9940,1,35978,18965,18077
9414079,9414068,TXFE7,128,9939,1,35979,18966,18078
9414079,9414068,TXFE7,128,9940,1,35980,18967,18079
9414079,9414069,TXFE7,128,9940,1,35981,18968,18080
9414079,9414069,TXFE7,128,9940,1,35982,18969,18081
9414079,9414071,TXFE7,128,9940,1,35983,18970,18082
9414079,9414072,TXFE7,128,9940,1,35984,18971,18083
9414079,9414077,TXFE7,128,9940,1,35985,18972,18084
9414079,9414078,TXFE7,128,9940,1,35986,18973,18085
9414079,9414078,TXFE7,128,9940,1,35987,18974,18086
9414079,9414079,TXFE7,128,9940,1,35988,18975,18087
9414092,9414081,TXFE7,128,9940,1,35989,18976,18088
9414092,9414081,TXFE7,128,9940,8,35997,18977,18095
9414092,9414091,TXFE7,128,9939,1,35998,18978,18096
9414104,9414092,TXFE7,128,9939,1,35999,18979,18097
9414104,9414104,TXFE7,128,9939,6,36005,18981,18098
9414117,9414107,TXFE7,128,9940,2,36007,18982,18100
9414117,9414116,TXFE7,128,9940,1,36008,18983,18101
9414154,9414151,TXFE7,128,9940,2,36010,18984,18102
9414179,9414175,TXFE7,128,9939,1,36011,18985,18103
9414192,9414181,TXFE7,128,9939,1,36012,18986,18104
9414192,9414186,TXFE7,128,9939,4,36016,18987,18105
9414192,9414188,TXFE7,128,9939,1,36017,18988,18106
9414204,9414192,TXFE7,128,9939,8,36025,18989,18107
9414217,9414211,TXFE7,128,9940,2,36027,18990,18109
9414242,9414234,TXFE7,128,9940,1,36028,18991,18110
9414254,9414251,TXFE7,128,9940,1,36029,18992,18111
9414267,9414261,TXFE7,128,9940,4,36033,18993,18114
9414279,9414269,TXFE7,128,9938,1,36034,18994,18115
9414279,9414269,TXFE7,128,9939,1,36035,18995,18116
9414279,9414277,TXFE7,128,9939,1,36036,18996,18117
9414292,9414288,TXFE7,128,9939,1,36037,18997,18118
9414292,9414289,TXFE7,128,9939,1,36038,18998,18119
9414417,9414411,TXFE7,128,9938,2,36040,19000,18120
9414417,9414412,TXFE7,128,9939,1,36041,19001,18121
9414429,9414421,TXFE7,128,9939,3,36044,19002,18123
9414467,9414456,TXFE7,128,9939,6,36050,19003,18125
9414467,9414460,TXFE7,128,9938,4,36054,19005,18126
9414529,9414528,TXFE7,128,9939,1,36055,19006,18127
9414554,9414543,TXFE7,128,9939,1,36056,19007,18128
9414604,9414600,TXFE7,128,9938,1,36057,19008,18129
9414629,9414621,TXFE7,128,9939,1,36058,19009,18130
9414654,9414648,TXFE7,128,9938,1,36059,19010,18131
9414654,9414652,TXFE7,128,9938,5,36064,19012,18132
9414704,9414695,TXFE7,128,9939,1,36065,19013,18133
9414704,9414698,TXFE7,128,9938,5,36070,19014,18134
9414767,9414766,TXFE7,128,9939,20,36090,19015,18142
9414779,9414777,TXFE7,128,9939,1,36091,19016,18143
9414929,9414927,TXFE7,128,9939,1,36092,19017,18144
9414954,9414949,TXFE7,128,9939,1,36093,19018,18145
9414967,9414960,TXFE7,128,9939,1,36094,19019,18146
9414979,9414967,TXFE7,128,9939,1,36095,19020,18147
9414979,9414977,TXFE7,128,9938,1,36096,19021,18148
9415042,9415031,TXFE7,128,9939,1,36097,19022,18149
9415054,9415042,TXFE7,128,9938,1,36098,19023,18150
9415092,9415091,TXFE7,128,9939,2,36100,19024,18152
9415117,9415116,TXFE7,128,9939,3,36103,19025,18155
9415167,9415165,TXFE7,128,9938,1,36104,19026,18156
9415179,9415178,TXFE7,128,9938,1,36105,19027,18157
9415204,9415201,TXFE7,128,9939,1,36106,19028,18158
9415279,9415278,TXFE7,128,9939,1,36107,19029,18159
9415304,9415300,TXFE7,128,9939,1,36108,19030,18160
9415317,9415305,TXFE7,128,9939,4,36112,19031,18163
9415329,9415328,TXFE7,128,9939,1,36113,19032,18164
9415342,9415333,TXFE7,128,9939,1,36114,19033,18165
9415367,9415364,TXFE7,128,9939,29,36143,19038,18166
9415392,9415382,TXFE7,128,9938,1,36144,19039,18167
9415554,9415548,TXFE7,128,9939,1,36145,19040,18168
9415554,9415550,TXFE7,128,9938,1,36146,19041,18169
9415692,9415691,TXFE7,128,9939,1,36147,19042,18170
9415717,9415716,TXFE7,128,9939,2,36149,19043,18171
9420154,9420143,TXFE7,128,9939,1,36150,19044,18172
9420154,9420146,TXFE7,128,9939,1,36151,19045,18173
9420154,9420149,TXFE7,128,9939,2,36153,19046,18174
9420192,9420183,TXFE7,128,9939,1,36154,19047,18175
9420192,9420192,TXFE7,128,9938,1,36155,19048,18176
9420292,9420284,TXFE7,128,9939,6,36161,19049,18177
9420329,9420317,TXFE7,128,9939,38,36199,19050,18195
9420342,9420329,TXFE7,128,9939,1,36200,19051,18196
9420392,9420381,TXFE7,128,9939,1,36201,19052,18197
9420592,9420587,TXFE7,128,9940,1,36202,19053,18198
9420592,9420588,TXFE7,128,9939,1,36203,19054,18199
9420654,9420648,TXFE7,128,9939,1,36204,19055,18200
9420704,9420703,TXFE7,128,9939,1,36205,19056,18201
9420717,9420705,TXFE7,128,9940,2,36207,19057,18203
9420717,9420711,TXFE7,128,9939,1,36208,19058,18204
9420804,9420798,TXFE7,128,9939,1,36209,19059,18205
9420829,9420826,TXFE7,128,9939,1,36210,19060,18206
9420842,9420830,TXFE7,128,9939,1,36211,19061,18207
9420842,9420839,TXFE7,128,9939,1,36212,19062,18208
9420879,9420868,TXFE7,128,9940,5,36217,19063,18213
9420892,9420888,TXFE7,128,9939,1,36218,19064,18214
9420904,9420901,TXFE7,128,9939,1,36219,19065,18215
9420917,9420908,TXFE7,128,9939,4,36223,19067,18216
9420967,9420959,TXFE7,128,9939,1,36224,19068,18217
9420979,9420972,TXFE7,128,9939,1,36225,19069,18218
9421054,9421048,TXFE7,128,9939,1,36226,19070,18219
9421067,9421064,TXFE7,128,9940,1,36227,19071,18220
9421079,9421071,TXFE7,128,9939,1,36228,19072,18221
9421117,9421113,TXFE7,128,9939,1,36229,19073,18222
9421129,9421127,TXFE7,128,9939,1,36230,19074,18223
9421217,9421217,TXFE7,128,9940,2,36232,19075,18225
9421267,9421260,TXFE7,128,9939,1,36233,19076,18226
9421329,9421327,TXFE7,128,9940,1,36234,19077,18227
9421379,9421370,TXFE7,128,9940,5,36239,19078,18231
9421392,9421383,TXFE7,128,9939,1,36240,19079,18232
9421517,9421510,TXFE7,128,9940,1,36241,19080,18233
9421542,9421536,TXFE7,128,9940,1,36242,19081,18234
9421567,9421557,TXFE7,128,9940,1,36243,19082,18235
9421567,9421558,TXFE7,128,9940,1,36244,19083,18236
9421604,9421600,TXFE7,128,9939,1,36245,19084,18237
9421629,9421625,TXFE7,128,9939,1,36246,19085,18238
9421629,9421629,TXFE7,128,9940,1,36247,19086,18239
9421692,9421685,TXFE7,128,9940,1,36248,19087,18240
9421754,9421747,TXFE7,128,9940,2,36250,19088,18242
9421792,9421783,TXFE7,128,9940,20,36270,19089,18253
9421817,9421811,TXFE7,128,9940,20,36290,19090,18270
9421829,9421817,TXFE7,128,9940,1,36291,19091,18271
9421829,9421817,TXFE7,128,9940,1,36292,19092,18272
9421829,9421817,TXFE7,128,9940,1,36293,19093,18273
9421829,9421821,TXFE7,128,9940,7,36300,19094,18277
9421829,9421821,TXFE7,128,9940,1,36301,19095,18278
9421829,9421825,TXFE7,128,9940,1,36302,19096,18279
9421829,9421829,TXFE7,128,9940,44,36346,19097,18299
9421842,9421829,TXFE7,128,9940,6,36352,19098,18304
9421842,9421829,TXFE7,128,9940,2,36354,19099,18306
9421842,9421829,TXFE7,128,9940,2,36356,19100,18308
9421842,9421829,TXFE7,128,9940,2,36358,19101,18310
9421842,9421833,TXFE7,128,9941,1,36359,19102,18311
9421854,9421843,TXFE7,128,9941,5,36364,19103,18316
9421854,9421845,TXFE7,128,9941,1,36365,19104,18317
9421854,9421846,TXFE7,128,9941,2,36367,19105,18319
9421854,9421847,TXFE7,128,9941,1,36368,19106,18320
9421854,9421848,TXFE7,128,9941,2,36370,19107,18322
9421854,9421849,TXFE7,128,9941,1,36371,19108,18323
9421854,9421850,TXFE7,128,9941,2,36373,19109,18324
9421854,9421853,TXFE7,128,9941,5,36378,19110,18328
9421854,9421853,TXFE7,128,9941,2,36380,19111,18330
9421854,9421854,TXFE7,128,9941,3,36383,19112,18332
9421867,9421854,TXFE7,128,9941,1,36384,19113,18333
9421867,9421861,TXFE7,128,9941,1,36385,19114,18334
9421867,9421864,TXFE7,128,9941,6,36391,19115,18338
9421867,9421866,TXFE7,128,9941,2,36393,19116,18340
9421879,9421869,TXFE7,128,9940,1,36394,19117,18341
9421879,9421876,TXFE7,128,9941,1,36395,19118,18342
9421879,9421876,TXFE7,128,9940,7,36402,19122,18343
9421879,9421876,TXFE7,128,9941,1,36403,19123,18344
9421879,9421877,TXFE7,128,9941,3,36406,19124,18347
9421892,9421880,TXFE7,128,9941,25,36431,19125,18361
9421892,9421881,TXFE7,129,9941,5,36437,19126,18367
9421892,9421881,TXFE7,129,9942,1,36437,19126,18367
9421904,9421893,TXFE7,128,9942,2,36439,19127,18369
9421904,9421894,TXFE7,128,9942,1,36440,19128,18370
9421904,9421895,TXFE7,128,9942,1,36441,19129,18371
9421904,9421895,TXFE7,128,9942,2,36443,19130,18372
9421904,9421896,TXFE7,128,9942,10,36453,19131,18380
9421904,9421896,TXFE7,128,9942,1,36454,19132,18381
9421904,9421898,TXFE7,128,9942,2,36456,19133,18382
9421904,9421898,TXFE7,128,9942,1,36457,19134,18383
9421904,9421898,TXFE7,128,9942,1,36458,19135,18384
9421904,9421899,TXFE7,128,9942,1,36459,19136,18385
9421904,9421899,TXFE7,128,9942,2,36461,19137,18386
9421917,9421908,TXFE7,128,9942,1,36462,19138,18387
9421917,9421911,TXFE7,128,9941,1,36463,19139,18388
9421917,9421914,TXFE7,128,9942,1,36464,19140,18389
9421917,9421915,TXFE7,128,9942,1,36465,19141,18390
9421917,9421916,TXFE7,128,9942,1,36466,19142,18391
9421929,9421924,TXFE7,128,9942,1,36467,19143,18392
9421929,9421925,TXFE7,128,9942,2,36469,19144,18393
9421929,9421929,TXFE7,128,9941,1,36470,19145,18394
9421929,9421929,TXFE7,128,9942,1,36471,19146,18395
9421942,9421935,TXFE7,128,9942,2,36473,19147,18396
9421942,9421935,TXFE7,128,9942,1,36474,19148,18397
9421942,9421940,TXFE7,128,9942,2,36476,19149,18399
9421942,9421941,TXFE7,128,9942,1,36477,19150,18400
9421954,9421942,TXFE7,128,9942,2,36479,19151,18401
9421967,9421962,TXFE7,128,9941,19,36498,19160,18402
9421979,9421975,TXFE7,128,9941,1,36499,19161,18403
9421979,9421976,TXFE7,128,9941,2,36501,19162,18404
9421979,9421976,TXFE7,128,9941,2,36503,19163,18405
9421979,9421977,TXFE7,128,9941,1,36504,19164,18406
9421979,9421977,TXFE7,129,9941,1,36507,19165,18409
9421979,9421977,TXFE7,129,9942,2,36507,19165,18409
9421992,9421980,TXFE7,128,9941,2,36509,19166,18410
9421992,9421986,TXFE7,128,9942,1,36510,19167,18411
9421992,9421986,TXFE7,128,9942,4,36514,19168,18414
9421992,9421987,TXFE7,128,9942,1,36515,19169,18415
9421992,9421990,TXFE7,128,9941,5,36520,19171,18416
9422004,9421996,TXFE7,128,9941,1,36521,19172,18417
9422004,9421999,TXFE7,128,9941,7,36528,19173,18421
9422017,9422011,TXFE7,128,9941,1,36529,19174,18422
9422017,9422013,TXFE7,128,9941,1,36530,19175,18423
9422029,9422022,TXFE7,128,9940,1,36531,19176,18424
9422042,9422039,TXFE7,128,9941,2,36533,19177,18426
9422042,9422041,TXFE7,128,9941,2,36535,19178,18427
9422054,9422042,TXFE7,128,9941,2,36537,19179,18428
9422054,9422042,TXFE7,128,9941,2,36539,19180,18429
9422054,9422044,TXFE7,128,9941,2,36541,19181,18430
9422054,9422049,TXFE7,128,9942,1,36542,19182,18431
9422067,9422059,TXFE7,128,9942,1,36543,19183,18432
9422067,9422059,TXFE7,128,9942,1,36544,19184,18433
9422067,9422065,TXFE7,128,9942,8,36552,19185,18438
9422079,9422067,TXFE7,128,9942,2,36554,19186,18440
9422079,9422067,TXFE7,128,9942,1,36555,19187,18441
9422079,9422070,TXFE7,128,9942,3,36558,19188,18443
9422079,9422072,TXFE7,128,9942,1,36559,19189,18444
9422079,9422076,TXFE7,128,9942,2,36561,19190,18445
9422079,9422076,TXFE7,128,9941,2,36563,19192,18446
9422079,9422078,TXFE7,128,9942,1,36564,19193,18447
9422092,9422079,TXFE7,128,9942,2,36566,19194,18449
9422092,9422080,TXFE7,128,9942,2,36568,19195,18450
9422092,9422081,TXFE7,128,9942,1,36569,19196,18451
9422092,9422082,TXFE7,128,9942,2,36571,19197,18453
9422092,9422083,TXFE7,128,9942,1,36572,19198,18454
9422092,9422087,TXFE7,128,9942,1,36573,19199,18455
9422092,9422088,TXFE7,128,9942,8,36581,19200,18461
9422092,9422090,TXFE7,128,9942,1,36582,19201,18462
9422104,9422092,TXFE7,128,9942,2,36584,19202,18464
9422104,9422095,TXFE7,128,9942,1,36585,19203,18465
9422104,9422102,TXFE7,128,9942,1,36586,19204,18466
9422117,9422106,TXFE7,128,9942,1,36587,19205,18467
9422117,9422110,TXFE7,128,9941,1,36588,19206,18468
9422117,9422111,TXFE7,128,9942,8,36596,19207,18475
9422129,9422126,TXFE7,128,9942,5,36601,19208,18480
9422129,9422129,TXFE7,128,9942,2,36603,19209,18482
9422142,9422135,TXFE7,128,9942,1,36604,19210,18483
9422154,9422147,TXFE7,128,9942,5,36609,19211,18487
9422154,9422154,TXFE7,128,9942,1,36610,19212,18488
9422167,9422162,TXFE7,128,9941,2,36612,19214,18489
9422192,9422184,TXFE7,128,9942,3,36615,19215,18490
9422204,9422194,TXFE7,128,9942,1,36616,19216,18491
9422229,9422225,TXFE7,128,9942,1,36617,19217,18492
9422229,9422228,TXFE7,128,9942,1,36618,19218,18493
9422242,9422232,TXFE7,128,9942,2,36620,19219,18495
9422254,9422249,TXFE7,128,9942,2,36622,19220,18496
9422279,9422272,TXFE7,128,9942,1,36623,19221,18497
9422292,9422282,TXFE7,128,9942,1,36624,19222,18498
9422317,9422309,TXFE7,128,9941,1,36625,19223,18499
9422354,9422354,TXFE7,128,9941,3,36628,19224,18500
9422367,9422363,TXFE7,128,9942,7,36635,19225,18503
9422367,9422363,TXFE7,128,9941,1,36636,19226,18504
9422379,9422372,TXFE7,128,9942,1,36637,19227,18505
9422392,9422389,TXFE7,128,9941,1,36638,19228,18506
9422404,9422402,TXFE7,128,9941,1,36639,19229,18507
9422479,9422479,TXFE7,128,9942,1,36640,19230,18508
9422492,9422487,TXFE7,128,9941,2,36642,19232,18509
9422492,9422489,TXFE7,128,9942,5,36647,19233,18514
9422554,9422553,TXFE7,128,9941,1,36648,19234,18515
9422567,9422555,TXFE7,128,9942,1,36649,19235,18516
9422567,9422564,TXFE7,128,9941,1,36650,19236,18517
9422567,9422567,TXFE7,128,9942,1,36651,19237,18518
9422579,9422576,TXFE7,128,9942,2,36653,19238,18520
9422579,9422579,TXFE7,128,9942,2,36655,19239,18522
9422592,9422581,TXFE7,128,9942,1,36656,19240,18523
9422592,9422584,TXFE7,128,9942,1,36657,19241,18524
9422604,9422599,TXFE7,128,9941,1,36658,19242,18525
9422654,9422647,TXFE7,128,9942,1,36659,19243,18526
9422692,9422687,TXFE7,128,9941,1,36660,19244,18527
9422729,9422723,TXFE7,128,9942,1,36661,19245,18528
9422742,9422730,TXFE7,128,9942,1,36662,19246,18529
9422754,9422754,TXFE7,128,9942,1,36663,19247,18530
9422767,9422762,TXFE7,128,9941,5,36668,19251,18531
9422892,9422881,TXFE7,128,9941,5,36673,19253,18532
9422892,9422886,TXFE7,128,9942,1,36674,19254,18533
9422892,9422888,TXFE7,128,9942,3,36677,19255,18535
9422904,9422902,TXFE7,128,9941,1,36678,19256,18536
9422917,9422905,TXFE7,128,9942,1,36679,19257,18537
9422929,9422925,TXFE7,128,9941,3,36682,19259,18538
9422929,9422926,TXFE7,128,9942,2,36684,19260,18540
9422942,9422938,TXFE7,128,9942,1,36685,19261,18541
9422979,9422973,TXFE7,128,9942,2,36687,19262,18542
9422979,9422975,TXFE7,128,9942,1,36688,19263,18543
9422992,9422980,TXFE7,128,9942,1,36689,19264,18544
9422992,9422981,TXFE7,128,9942,1,36690,19265,18545
9422992,9422983,TXFE7,128,9942,1,36691,19266,18546
9422992,9422986,TXFE7,128,9942,1,36692,19267,18547
9423004,9422994,TXFE7,128,9942,1,36693,19268,18548
9423004,9422996,TXFE7,128,9942,1,36694,19269,18549
9423004,9422999,TXFE7,128,9941,1,36695,19270,18550
9423017,9423009,TXFE7,128,9942,1,36696,19271,18551
9423029,9423020,TXFE7,128,9941,1,36697,19272,18552
9423054,9423046,TXFE7,128,9941,1,36698,19273,18553
9423054,9423051,TXFE7,128,9942,2,36700,19274,18555
9423079,9423068,TXFE7,128,9942,2,36702,19275,18556
9423079,9423072,TXFE7,128,9942,1,36703,19276,18557
9423079,9423075,TXFE7,128,9942,1,36704,19277,18558
9423092,9423090,TXFE7,128,9942,1,36705,19278,18559
9423104,9423093,TXFE7,128,9942,1,36706,19279,18560
9423104,9423095,TXFE7,128,9942,1,36707,19280,18561
9423104,9423104,TXFE7,128,9942,1,36708,19281,18562
9423117,9423110,TXFE7,128,9942,1,36709,19282,18563
9423129,9423120,TXFE7,128,9942,1,36710,19283,18564
9423142,9423139,TXFE7,128,9942,5,36715,19284,18566
9423154,9423145,TXFE7,128,9942,3,36718,19285,18568
9423204,9423195,TXFE7,128,9942,5,36723,19286,18573
9423242,9423239,TXFE7,128,9942,5,36728,19287,18576
9423304,9423293,TXFE7,128,9942,5,36733,19288,18578
9423304,9423294,TXFE7,128,9942,2,36735,19289,18580
9423304,9423303,TXFE7,128,9941,1,36736,19290,18581
9423317,9423305,TXFE7,128,9942,7,36743,19291,18586
9423317,9423313,TXFE7,128,9942,1,36744,19292,18587
9423342,9423340,TXFE7,128,9941,2,36746,19294,18588
9423354,9423342,TXFE7,128,9942,1,36747,19295,18589
9423367,9423364,TXFE7,128,9942,1,36748,19296,18590
9423379,9423373,TXFE7,128,9942,1,36749,19297,18591
9423392,9423382,TXFE7,128,9942,1,36750,19298,18592
9423417,9423416,TXFE7,128,9943,1,36751,19299,18593
9423429,9423417,TXFE7,128,9943,1,36752,19300,18594
9423429,9423418,TXFE7,128,9943,2,36754,19301,18596
9423429,9423419,TXFE7,128,9942,1,36755,19302,18597
9423429,9423419,TXFE7,128,9943,1,36756,19303,18598
9423429,9423420,TXFE7,128,9943,2,36758,19304,18599
9423429,9423420,TXFE7,128,9943,1,36759,19305,18600
9423429,9423420,TXFE7,128,9943,3,36762,19306,18601
9423429,9423421,TXFE7,128,9943,1,36763,19307,18602
9423429,9423422,TXFE7,128,9943,2,36765,19308,18603
9423429,9423422,TXFE7,128,9943,1,36766,19309,18604
9423429,9423422,TXFE7,128,9941,7,36773,19312,18605
9423429,9423423,TXFE7,128,9943,2,36775,19313,18606
9423429,9423428,TXFE7,128,9943,2,36777,19314,18607
9423442,9423431,TXFE7,128,9943,1,36778,19315,18608
9423442,9423441,TXFE7,128,9943,1,36779,19316,18609
9423454,9423447,TXFE7,128,9943,1,36780,19317,18610
9423454,9423447,TXFE7,128,9942,1,36781,19318,18611
9423454,9423451,TXFE7,128,9943,2,36783,19319,18613
9423479,9423469,TXFE7,128,9943,1,36784,19320,18614
9423492,9423483,TXFE7,128,9943,1,36785,19321,18615
9423504,9423492,TXFE7,128,9942,5,36790,19322,18616
9423517,9423505,TXFE7,128,9942,1,36791,19323,18617
9423529,9423522,TXFE7,128,9942,1,36792,19324,18618
9423529,9423522,TXFE7,128,9942,2,36794,19325,18619
9423554,9423542,TXFE7,128,9942,3,36797,19327,18620
9423567,9423555,TXFE7,128,9942,1,36798,19328,18621
9423617,9423605,TXFE7,128,9942,1,36799,19329,18622
9423642,9423637,TXFE7,128,9943,5,36804,19330,18627
9423642,9423640,TXFE7,128,9943,2,36806,19331,18628
9423767,9423764,TXFE7,128,9943,1,36807,19332,18629
9423779,9423770,TXFE7,128,9942,3,36810,19334,18630
9423779,9423771,TXFE7,128,9942,1,36811,19335,18631
9423779,9423771,TXFE7,128,9943,1,36812,19336,18632
9423779,9423777,TXFE7,128,9943,1,36813,19337,18633
9423792,9423789,TXFE7,128,9942,1,36814,19338,18634
9423817,9423816,TXFE7,128,9942,1,36815,19339,18635
9423879,9423868,TXFE7,128,9942,1,36816,19340,18636
9423879,9423871,TXFE7,128,9942,1,36817,19341,18637
9423904,9423900,TXFE7,128,9943,1,36818,19342,18638
9423917,9423905,TXFE7,128,9942,1,36819,19343,18639
9423929,9423925,TXFE7,128,9943,1,36820,19344,18640
9423929,9423928,TXFE7,128,9943,1,36821,19345,18641
9423942,9423930,TXFE7,128,9943,3,36824,19346,18643
9423942,9423931,TXFE7,128,9943,2,36826,19347,18645
9423942,9423933,TXFE7,128,9943,2,36828,19348,18646
9423967,9423957,TXFE7,128,9943,2,36830,19349,18647
9424004,9423995,TXFE7,128,9943,1,36831,19350,18648
9424017,9424009,TXFE7,128,9943,2,36833,19351,18649
9424067,9424064,TXFE7,128,9942,2,36835,19353,18650
9424079,9424074,TXFE7,128,9943,1,36836,19354,18651
9424104,9424101,TXFE7,128,9942,1,36837,19355,18652
9424179,9424179,TXFE7,128,9943,1,36838,19356,18653
9424354,9424344,TXFE7,128,9942,1,36839,19357,18654
9424354,9424347,TXFE7,128,9942,3,36842,19358,18655
9424379,9424373,TXFE7,128,9943,7,36849,19359,18658
9424379,9424378,TXFE7,128,9942,2,36851,19360,18659
9424492,9424481,TXFE7,128,9943,17,36868,19361,18671
9424492,9424481,TXFE7,128,9943,17,36885,19362,18687
9424492,9424489,TXFE7,128,9943,1,36886,19363,18688
9424492,9424489,TXFE7,128,9943,1,36887,19364,18689
9424492,9424490,TXFE7,128,9943,1,36888,19365,18690
9424504,9424497,TXFE7,128,9942,1,36889,19366,18691
9424529,9424521,TXFE7,128,9942,1,36890,19367,18692
9424567,9424557,TXFE7,128,9943,5,36895,19368,18697
9424579,9424577,TXFE7,128,9942,1,36896,19369,18698
9424592,9424583,TXFE7,128,9943,1,36897,19370,18699
9424604,9424596,TXFE7,128,9943,1,36898,19371,18700
9424617,9424608,TXFE7,128,9943,1,36899,19372,18701
9424629,9424629,TXFE7,128,9943,5,36904,19373,18706
9424654,9424645,TXFE7,128,9942,1,36905,19374,18707
9424692,9424687,TXFE7,128,9942,1,36906,19375,18708
9424767,9424756,TXFE7,128,9942,1,36907,19376,18709
9424767,9424757,TXFE7,128,9943,6,36913,19377,18711
9424767,9424758,TXFE7,128,9942,1,36914,19378,18712
9424817,9424815,TXFE7,128,9943,1,36915,19379,18713
9424854,9424846,TXFE7,128,9942,1,36916,19380,18714
9424904,9424903,TXFE7,128,9943,1,36917,19381,18715
9424942,9424930,TXFE7,128,9943,1,36918,19382,18716
9424942,9424930,TXFE7,128,9943,4,36922,19383,18719
9424942,9424931,TXFE7,128,9942,1,36923,19384,18720
9424942,9424932,TXFE7,128,9942,1,36924,19385,18721
9424942,9424935,TXFE7,128,9943,1,36925,19386,18722
9424954,9424948,TXFE7,128,9943,2,36927,19387,18724
9424979,9424976,TXFE7,128,9943,2,36929,19388,18726
9424979,9424978,TXFE7,128,9943,1,36930,19389,18727
9425017,9425009,TXFE7,128,9943,5,36935,19390,18730
9425017,9425015,TXFE7,128,9943,1,36936,19391,18731
9425029,9425024,TXFE7,128,9942,1,36937,19392,18732
9425042,9425040,TXFE7,128,9942,5,36942,19395,18733
9425079,9425071,TXFE7,128,9942,2,36944,19397,18734
9425117,9425107,TXFE7,128,9942,1,36945,19398,18735
9425154,9425149,TXFE7,128,9942,5,36950,19399,18736
9425167,9425154,TXFE7,128,9942,1,36951,19400,18737
9425167,9425154,TXFE7,128,9942,4,36955,19401,18738
9425179,9425171,TXFE7,128,9942,1,36956,19402,18739
9425192,9425180,TXFE7,128,9942,56,37012,19428,18740
9425192,9425181,TXFE7,128,9942,1,37013,19429,18741
9425204,9425194,TXFE7,128,9941,1,37014,19430,18742
9425242,9425240,TXFE7,128,9942,1,37015,19431,18743
9425267,9425265,TXFE7,128,9941,1,37016,19432,18744
9425267,9425265,TXFE7,128,9941,1,37017,19433,18745
9425267,9425265,TXFE7,128,9941,5,37022,19438,18746
9425267,9425265,TXFE7,128,9941,15,37037,19440,18747
9425267,9425265,TXFE7,128,9941,3,37040,19442,18748
9425267,9425265,TXFE7,128,9941,2,37042,19444,18749
9425267,9425265,TXFE7,128,9941,1,37043,19445,18750
9425267,9425265,TXFE7,128,9941,1,37044,19446,18751
9425267,9425265,TXFE7,128,9941,1,37045,19447,18752
9425267,9425265,TXFE7,128,9941,1,37046,19448,18753
9425267,9425265,TXFE7,128,9941,1,37047,19449,18754
9425267,9425265,TXFE7,128,9941,1,37048,19450,18755
9425267,9425265,TXFE7,128,9941,1,37049,19451,18756
9425267,9425265,TXFE7,128,9941,1,37050,19452,18757
9425267,9425265,TXFE7,128,9941,3,37053,19455,18758
9425267,9425265,TXFE7,128,9941,1,37054,19456,18759
9425279,9425267,TXFE7,128,9941,1,37055,19457,18760
9425279,9425267,TXFE7,128,9941,1,37056,19458,18761
9425279,9425267,TXFE7,128,9941,1,37057,19459,18762
9425279,9425267,TXFE7,128,9941,1,37058,19460,18763
9425279,9425272,TXFE7,128,9941,1,37059,19461,18764
9425279,9425277,TXFE7,128,9940,1,37060,19462,18765
9425304,9425299,TXFE7,128,9941,1,37061,19463,18766
9425317,9425312,TXFE7,128,9940,1,37062,19464,18767
9425342,9425341,TXFE7,128,9941,1,37063,19465,18768
9425392,9425387,TXFE7,128,9940,1,37064,19466,18769
9425454,9425443,TXFE7,128,9940,1,37065,19467,18770
9425454,9425444,TXFE7,128,9941,1,37066,19468,18771
9425454,9425453,TXFE7,128,9940,2,37068,19470,18772
9425492,9425486,TXFE7,128,9940,1,37069,19471,18773
9425492,9425488,TXFE7,128,9941,1,37070,19472,18774
9425504,9425497,TXFE7,128,9940,1,37071,19473,18775
9425504,9425501,TXFE7,128,9940,2,37073,19475,18776
9425517,9425508,TXFE7,128,9940,1,37074,19476,18777
9425542,9425534,TXFE7,128,9940,1,37075,19477,18778
9425554,9425546,TXFE7,128,9941,10,37085,19478,18781
9425592,9425588,TXFE7,128,9940,1,37086,19479,18782
9425692,9425689,TXFE7,128,9940,1,37087,19480,18783
9425692,9425691,TXFE7,128,9940,2,37089,19482,18784
9425779,9425773,TXFE7,128,9941,1,37090,19483,18785
9425817,9425807,TXFE7,128,9941,1,37091,19484,18786
9425879,9425868,TXFE7,128,9940,1,37092,19485,18787
9425917,9425917,TXFE7,128,9940,1,37093,19486,18788
9425929,9425925,TXFE7,128,9940,1,37094,19487,18789
9430004,9425999,TXFE7,128,9940,7,37101,19491,18790
9430017,9430012,TXFE7,128,9940,1,37102,19492,18791
9430042,9430041,TXFE7,128,9941,1,37103,19493,18792
9430092,9430089,TXFE7,128,9940,2,37105,19494,18793
9430104,9430093,TXFE7,128,9941,10,37115,19495,18801
9430204,9430194,TXFE7,128,9940,1,37116,19496,18802
9430217,9430208,TXFE7,128,9940,1,37117,19497,18803
9430229,9430225,TXFE7,128,9941,1,37118,19498,18804
9430242,9430237,TXFE7,128,9941,1,37119,19499,18805
9430254,9430249,TXFE7,128,9941,1,37120,19500,18806
9430367,9430360,TXFE7,128,9941,2,37122,19501,18808
9430404,9430393,TXFE7,128,9941,4,37126,19502,18812
9430404,9430397,TXFE7,128,9940,1,37127,19503,18813
9430417,9430405,TXFE7,128,9940,1,37128,19504,18814
9430429,9430424,TXFE7,128,9941,1,37129,19505,18815
9430492,9430480,TXFE7,128,9941,6,37135,19506,18818
9430492,9430481,TXFE7,128,9940,1,37136,19507,18819
9430492,9430481,TXFE7,128,9941,1,37137,19508,18820
9430542,9430529,TXFE7,128,9941,5,37142,19509,18821
9430542,9430529,TXFE7,128,9941,1,37143,19510,18822
9430604,9430600,TXFE7,128,9941,1,37144,19511,18823
9430604,9430604,TXFE7,128,9941,1,37145,19512,18824
9430617,9430615,TXFE7,128,9941,3,37148,19514,18825
9430729,9430725,TXFE7,128,9942,5,37153,19515,18827
9430729,9430729,TXFE7,128,9941,1,37154,19516,18828
9430817,9430810,TXFE7,128,9941,1,37155,19517,18829
9430854,9430851,TXFE7,128,9941,3,37158,19518,18830
9430867,9430857,TXFE7,128,9942,1,37159,19519,18831
9430917,9430907,TXFE7,128,9941,2,37161,19520,18832
9430954,9430950,TXFE7,128,9941,3,37164,19523,18833
9431017,9431005,TXFE7,128,9941,2,37166,19524,18834
9431029,9431023,TXFE7,128,9942,1,37167,19525,18835
9431054,9431045,TXFE7,128,9941,1,37168,19526,18836
9431092,9431084,TXFE7,128,9941,1,37169,19527,18837
9431092,9431087,TXFE7,128,9941,1,37170,19528,18838
9431254,9431244,TXFE7,128,9941,5,37175,19530,18839
9431254,9431248,TXFE7,128,9941,9,37184,19531,18840
9431267,9431254,TXFE7,128,9941,7,37191,19536,18841
9431279,9431267,TXFE7,128,9941,1,37192,19537,18842
9431292,9431285,TXFE7,128,9941,1,37193,19538,18843
9431367,9431363,TXFE7,128,9940,1,37194,19539,18844
9431392,9431381,TXFE7,128,9940,1,37195,19540,18845
9431392,9431382,TXFE7,128,9941,2,37197,19541,18846
9431404,9431399,TXFE7,128,9940,1,37198,19542,18847
9431429,9431428,TXFE7,128,9940,1,37199,19543,18848
9431454,9431446,TXFE7,128,9940,1,37200,19544,18849
9431467,9431455,TXFE7,128,9940,1,37201,19545,18850
9431479,9431472,TXFE7,128,9940,1,37202,19546,18851
9431942,9431940,TXFE7,128,9940,5,37207,19549,18852
9432004,9432001,TXFE7,128,9940,1,37208,19550,18853
9432004,9432004,TXFE7,128,9941,10,37218,19551,18859
9432117,9432116,TXFE7,128,9940,1,37219,19552,18860
9432392,9432381,TXFE7,128,9940,3,37222,19554,18861
9432442,9432436,TXFE7,128,9941,1,37223,19555,18862
9432554,9432549,TXFE7,128,9941,1,37224,19556,18863
9432592,9432591,TXFE7,128,9940,1,37225,19557,18864
9432642,9432641,TXFE7,128,9940,1,37226,19558,18865
9432692,9432688,TXFE7,128,9940,5,37231,19563,18866
9432754,9432750,TXFE7,128,9940,5,37236,19566,18867
9432829,9432824,TXFE7,128,9940,5,37241,19569,18868
9432842,9432838,TXFE7,128,9940,1,37242,19570,18869
9432917,9432912,TXFE7,128,9940,1,37243,19571,18870
9432967,9432955,TXFE7,128,9940,1,37244,19572,18871
9433042,9433040,TXFE7,128,9940,1,37245,19573,18872
9433054,9433045,TXFE7,128,9941,1,37246,19574,18873
9433192,9433183,TXFE7,128,9941,2,37248,19575,18874
9433192,9433190,TXFE7,128,9941,2,37250,19576,18876
9433254,9433247,TXFE7,128,9940,1,37251,19577,18877
9433342,9433336,TXFE7,128,9941,1,37252,19578,18878
9433454,9433453,TXFE7,128,9940,2,37254,19580,18879
9433479,9433474,TXFE7,128,9941,1,37255,19581,18880
9433504,9433493,TXFE7,128,9941,1,37256,19582,18881
9433529,9433518,TXFE7,128,9941,1,37257,19583,18882
9433529,9433527,TXFE7,128,9941,1,37258,19584,18883
9433692,9433684,TXFE7,128,9940,1,37259,19585,18884
9433729,9433726,TXFE7,128,9941,2,37261,19586,18885
9433742,9433740,TXFE7,128,9940,4,37265,19590,18886
9433792,9433790,TXFE7,128,9941,5,37270,19591,18891
9433979,9433974,TXFE7,128,9941,1,37271,19592,18892
9434004,9434002,TXFE7,128,9940,1,37272,19593,18893
9434017,9434008,TXFE7,128,9941,1,37273,19594,18894
9434317,9434305,TXFE7,128,9941,1,37274,19595,18895
9434392,9434380,TXFE7,128,9940,2,37276,19596,18896
9434579,9434569,TXFE7,128,9940,5,37281,19600,18897
9434629,9434620,TXFE7,128,9940,5,37286,19604,18898
9434667,9434661,TXFE7,128,9940,1,37287,19605,18899
9434692,9434687,TXFE7,128,9940,10,37297,19614,18900
9434804,9434795,TXFE7,128,9939,1,37298,19615,18901
9434854,9434848,TXFE7,128,9940,1,37299,19616,18902
9435017,9435011,TXFE7,128,9940,1,37300,19617,18903
9435029,9435022,TXFE7,128,9940,7,37307,19618,18904
9435079,9435074,TXFE7,128,9939,2,37309,19619,18905
9435104,9435093,TXFE7,128,9940,1,37310,19620,18906
9435104,9435096,TXFE7,128,9939,2,37312,19622,18907
9435517,9435515,TXFE7,128,9939,2,37314,19623,18908
9435567,9435555,TXFE7,128,9940,1,37315,19624,18909
9435817,9435808,TXFE7,128,9940,4,37319,19625,18910
9435817,9435812,TXFE7,128,9940,1,37320,19626,18911
9435854,9435850,TXFE7,128,9939,1,37321,19627,18912
9435879,9435875,TXFE7,128,9939,1,37322,19628,18913
9435904,9435893,TXFE7,128,9940,2,37324,19629,18914
9435917,9435912,TXFE7,128,9939,1,37325,19630,18915
9435917,9435914,TXFE7,128,9940,1,37326,19631,18916
9435954,9435944,TXFE7,128,9940,1,37327,19632,18917
9435954,9435949,TXFE7,128,9940,1,37328,19633,18918
9435967,9435955,TXFE7,128,9940,1,37329,19634,18919
9435992,9435988,TXFE7,128,9940,5,37334,19635,18920
9440004,9435999,TXFE7,128,9940,1,37335,19636,18921
9440004,9440001,TXFE7,128,9940,1,37336,19637,18922
9440017,9440009,TXFE7,128,9940,1,37337,19638,18923
9440042,9440039,TXFE7,128,9940,1,37338,19639,18924
9440267,9440266,TXFE7,128,9940,2,37340,19640,18926
9440292,9440280,TXFE7,128,9940,1,37341,19641,18927
9440442,9440441,TXFE7,128,9939,1,37342,19642,18928
9440454,9440451,TXFE7,128,9940,1,37343,19643,18929
9440642,9440633,TXFE7,128,9940,1,37344,19644,18930
9440729,9440729,TXFE7,128,9939,1,37345,19645,18931
9440892,9440884,TXFE7,128,9940,1,37346,19646,18932
9440904,9440903,TXFE7,128,9940,2,37348,19647,18934
9440929,9440918,TXFE7,128,9940,1,37349,19648,18935
9440929,9440918,TXFE7,128,9940,23,37372,19649,18952
9440967,9440965,TXFE7,128,9941,1,37373,19650,18953
9440979,9440971,TXFE7,128,9940,5,37378,19652,18954
9441004,9440995,TXFE7,128,9941,1,37379,19653,18955
9441067,9441060,TXFE7,128,9940,20,37399,19662,18956
9441092,9441085,TXFE7,128,9941,1,37400,19663,18957
9441092,9441091,TXFE7,128,9941,1,37401,19664,18958
9441204,9441199,TXFE7,128,9940,1,37402,19665,18959
9441354,9441346,TXFE7,128,9940,1,37403,19666,18960
9441617,9441611,TXFE7,128,9940,1,37404,19667,18961
9441679,9441667,TXFE7,128,9941,56,37460,19668,18995
9441779,9441771,TXFE7,128,9941,5,37465,19671,18996
9441817,9441815,TXFE7,128,9941,1,37466,19672,18997
9441842,9441830,TXFE7,128,9942,2,37468,19673,18998
9442029,9442023,TXFE7,128,9942,4,37472,19674,19001
9442054,9442043,TXFE7,128,9941,1,37473,19675,19002
9442079,9442079,TXFE7,128,9942,1,37474,19676,19003
9442092,9442089,TXFE7,128,9942,3,37477,19677,19005
9442154,9442142,TXFE7,128,9942,3,37480,19678,19008
9442242,9442232,TXFE7,128,9941,1,37481,19679,19009
9442254,9442254,TXFE7,128,9941,2,37483,19680,19010
9442292,9442285,TXFE7,128,9941,1,37484,19681,19011
9442567,9442567,TXFE7,128,9941,1,37485,19682,19012
9442654,9442647,TXFE7,128,9941,1,37486,19683,19013
9442892,9442881,TXFE7,128,9941,1,37487,19684,19014
9443229,9443221,TXFE7,128,9941,6,37493,19685,19015
9443354,9443353,TXFE7,128,9941,1,37494,19686,19016
9443404,9443395,TXFE7,128,9942,1,37495,19687,19017
9443429,9443422,TXFE7,128,9941,2,37497,19689,19018
9443429,9443422,TXFE7,128,9941,1,37498,19690,19019
9443554,9443552,TXFE7,128,9941,3,37501,19691,19020
9443567,9443556,TXFE7,128,9942,1,37502,19692,19021
9443604,9443592,TXFE7,128,9942,1,37503,19693,19022
9443604,9443600,TXFE7,128,9942,1,37504,19694,19023
9443692,9443686,TXFE7,128,9941,1,37505,19695,19024
9443767,9443766,TXFE7,128,9941,2,37507,19696,19025
9444092,9444079,TXFE7,128,9942,1,37508,19697,19026
9444217,9444213,TXFE7,128,9942,2,37510,19698,19028
9444329,9444326,TXFE7,128,9942,2,37512,19699,19030
9444342,9444330,TXFE7,128,9942,45,37557,19700,19071
9444367,9444360,TXFE7,128,9942,1,37558,19701,19072
9444454,9444452,TXFE7,128,9943,1,37559,19702,19073
9444467,9444465,TXFE7,128,9943,5,37564,19703,19077
9444492,9444490,TXFE7,128,9943,2,37566,19704,19078
9444492,9444491,TXFE7,128,9943,1,37567,19705,19079
9444579,9444567,TXFE7,128,9943,59,37626,19706,19113
9444579,9444575,TXFE7,128,9944,3,37629,19707,19116
9444592,9444580,TXFE7,128,9944,19,37648,19708,19126
9444592,9444586,TXFE7,128,9944,2,37650,19709,19127
9444592,9444586,TXFE7,128,9944,2,37652,19710,19129
9444592,9444592,TXFE7,128,9944,1,37653,19711,19130
9444604,9444593,TXFE7,128,9944,4,37657,19712,19131
9444604,9444594,TXFE7,128,9944,1,37658,19713,19132
9444629,9444622,TXFE7,128,9944,4,37662,19714,19133
9444642,9444634,TXFE7,128,9944,1,37663,19715,19134
9444642,9444641,TXFE7,128,9943,5,37668,19719,19135
9444654,9444642,TXFE7,128,9944,1,37669,19720,19136
9444654,9444654,TXFE7,128,9943,1,37670,19721,19137
9444667,9444660,TXFE7,128,9944,1,37671,19722,19138
9444692,9444684,TXFE7,128,9944,2,37673,19723,19140
9444717,9444712,TXFE7,128,9944,1,37674,19724,19141
9444742,9444738,TXFE7,128,9944,5,37679,19725,19146
9444754,9444752,TXFE7,128,9944,1,37680,19726,19147
9444792,9444783,TXFE7,128,9944,1,37681,19727,19148
9444817,9444805,TXFE7,128,9943,3,37684,19730,19149
9444904,9444903,TXFE7,128,9944,1,37685,19731,19150
9444979,9444972,TXFE7,128,9943,2,37687,19732,19151
9445029,9445022,TXFE7,128,9943,1,37688,19733,19152
9445054,9445047,TXFE7,128,9943,11,37699,19740,19153
9445067,9445062,TXFE7,128,9943,1,37700,19741,19154
9445079,9445067,TXFE7,128,9943,1,37701,19742,19155
9445092,9445079,TXFE7,128,9943,6,37707,19743,19156
9445129,9445122,TXFE7,128,9943,13,37720,19744,19161
9445154,9445154,TXFE7,128,9943,1,37721,19745,19162
9445167,9445166,TXFE7,128,9943,1,37722,19746,19163
9445179,9445178,TXFE7,128,9944,2,37724,19747,19165
9445192,9445180,TXFE7,128,9944,2,37726,19748,19167
9445192,9445184,TXFE7,128,9943,2,37728,19749,19168
9445217,9445211,TXFE7,128,9943,1,37729,19750,19169
9445254,9445254,TXFE7,128,9944,7,37736,19751,19172
9445342,9445331,TXFE7,128,9943,1,37737,19752,19173
9445354,9445346,TXFE7,128,9943,1,37738,19753,19174
9445354,9445352,TXFE7,128,9944,1,37739,19754,19175
9445467,9445455,TXFE7,128,9943,1,37740,19755,19176
9445492,9445483,TXFE7,128,9943,1,37741,19756,19177
9445492,9445489,TXFE7,128,9944,2,37743,19757,19179
9445579,9445568,TXFE7,128,9943,1,37744,19758,19180
9445604,9445600,TXFE7,128,9943,1,37745,19759,19181
9445667,9445660,TXFE7,128,9943,4,37749,19763,19182
9445667,9445663,TXFE7,128,9944,2,37751,19764,19184
9445717,9445707,TXFE7,128,9944,1,37752,19765,19185
9445717,9445717,TXFE7,128,9943,1,37753,19766,19186
9445729,9445727,TXFE7,128,9944,3,37756,19767,19188
9445742,9445733,TXFE7,128,9943,1,37757,19768,19189
9445767,9445759,TXFE7,128,9944,1,37758,19769,19190
9445817,9445805,TXFE7,128,9943,1,37759,19770,19191
9445867,9445863,TXFE7,128,9943,1,37760,19771,19192
9445954,9445952,TXFE7,128,9943,1,37761,19772,19193
9445954,9445954,TXFE7,128,9944,2,37763,19773,19195
9450004,9450001,TXFE7,128,9943,1,37764,19774,19196
9450004,9450002,TXFE7,128,9943,1,37765,19775,19197
9450017,9450016,TXFE7,128,9944,7,37772,19776,19202
9450029,9450025,TXFE7,128,9944,3,37775,19777,19205
9450029,9450026,TXFE7,128,9944,1,37776,19778,19206
9450029,9450026,TXFE7,128,9944,2,37778,19779,19208
9450042,9450031,TXFE7,128,9944,1,37779,19780,19209
9450042,9450033,TXFE7,128,9944,1,37780,19781,19210
9450042,9450033,TXFE7,128,9944,1,37781,19782,19211
9450042,9450033,TXFE7,128,9944,1,37782,19783,19212
9450042,9450034,TXFE7,128,9944,1,37783,19784,19213
9450042,9450035,TXFE7,128,9944,1,37784,19785,19214
9450042,9450036,TXFE7,128,9944,1,37785,19786,19215
9450042,9450037,TXFE7,128,9944,1,37786,19787,19216
9450054,9450042,TXFE7,128,9944,1,37787,19788,19217
9450054,9450044,TXFE7,128,9944,1,37788,19789,19218
9450054,9450052,TXFE7,128,9943,1,37789,19790,19219
9450067,9450056,TXFE7,128,9944,1,37790,19791,19220
9450067,9450056,TXFE7,128,9944,8,37798,19792,19222
9450067,9450058,TXFE7,128,9944,8,37806,19793,19224
9450067,9450061,TXFE7,128,9944,3,37809,19794,19226
9450079,9450069,TXFE7,128,9944,2,37811,19795,19227
9450079,9450072,TXFE7,128,9944,1,37812,19796,19228
9450079,9450074,TXFE7,128,9944,1,37813,19797,19229
9450092,9450083,TXFE7,128,9944,2,37815,19798,19231
9450092,9450084,TXFE7,128,9944,1,37816,19799,19232
9450092,9450084,TXFE7,128,9944,12,37828,19800,19242
9450104,9450095,TXFE7,128,9944,2,37830,19801,19244
9450104,9450099,TXFE7,128,9944,7,37837,19802,19251
9450129,9450120,TXFE7,128,9944,1,37838,19803,19252
9450142,9450139,TXFE7,128,9944,5,37843,19804,19253
9450154,9450143,TXFE7,128,9944,1,37844,19805,19254
9450154,9450147,TXFE7,128,9944,3,37847,19806,19255
9450154,9450152,TXFE7,128,9944,6,37853,19807,19261
9450179,9450171,TXFE7,128,9944,1,37854,19808,19262
9450179,9450174,TXFE7,129,9944,4,37866,19809,19268
9450179,9450174,TXFE7,129,9945,8,37866,19809,19268
9450192,9450180,TXFE7,128,9945,1,37867,19810,19269
9450192,9450184,TXFE7,128,9945,1,37868,19811,19270
9450192,9450185,TXFE7,128,9944,1,37869,19812,19271
9450192,9450185,TXFE7,128,9944,2,37871,19813,19272
9450192,9450186,TXFE7,128,9944,1,37872,19814,19273
9450192,9450186,TXFE7,128,9944,3,37875,19815,19274
9450192,9450186,TXFE7,128,9945,1,37876,19816,19275
9450192,9450186,TXFE7,128,9945,1,37877,19817,19276
9450192,9450187,TXFE7,128,9945,1,37878,19818,19277
9450192,9450187,TXFE7,128,9944,1,37879,19819,19278
9450192,9450187,TXFE7,128,9945,1,37880,19820,19279
9450192,9450189,TXFE7,128,9945,1,37881,19821,19280
9450192,9450190,TXFE7,128,9945,1,37882,19822,19281
9450192,9450191,TXFE7,128,9945,1,37883,19823,19282
9450192,9450192,TXFE7,128,9945,6,37889,19824,19285
9450204,9450192,TXFE7,128,9945,2,37891,19825,19287
9450204,9450192,TXFE7,128,9944,1,37892,19826,19288
9450204,9450192,TXFE7,128,9944,1,37893,19827,19289
9450204,9450197,TXFE7,128,9943,1,37894,19828,19290
9450204,9450199,TXFE7,128,9944,1,37895,19829,19291
9450204,9450202,TXFE7,128,9944,2,37897,19830,19292
9450204,9450202,TXFE7,129,9944,1,37899,19831,19294
9450204,9450202,TXFE7,129,9945,1,37899,19831,19294
9450217,9450216,TXFE7,128,9944,1,37900,19832,19295
9450229,9450220,TXFE7,128,9943,1,37901,19833,19296
9450229,9450223,TXFE7,128,9944,1,37902,19834,19297
9450229,9450228,TXFE7,128,9945,1,37903,19835,19298
9450242,9450230,TXFE7,128,9944,3,37906,19836,19299
9450242,9450231,TXFE7,128,9945,4,37910,19837,19300
9450242,9450231,TXFE7,128,9945,1,37911,19838,19301
9450242,9450234,TXFE7,128,9945,1,37912,19839,19302
9450242,9450235,TXFE7,128,9944,2,37914,19840,19303
9450242,9450238,TXFE7,128,9945,4,37918,19841,19304
9450242,9450240,TXFE7,128,9945,1,37919,19842,19305
9450242,9450241,TXFE7,128,9945,2,37921,19843,19306
9450254,9450244,TXFE7,128,9944,1,37922,19844,19307
9450254,9450254,TXFE7,128,9945,2,37924,19845,19308
9450267,9450266,TXFE7,128,9944,5,37929,19847,19309
9450267,9450266,TXFE7,128,9944,1,37930,19848,19310
9450279,9450267,TXFE7,128,9944,2,37932,19849,19312
9450279,9450268,TXFE7,128,9944,2,37934,19850,19313
9450292,9450280,TXFE7,128,9944,1,37935,19851,19314
9450292,9450283,TXFE7,128,9943,1,37936,19852,19315
9450317,9450314,TXFE7,128,9943,2,37938,19853,19316
9450317,9450316,TXFE7,128,9945,1,37939,19854,19317
9450317,9450317,TXFE7,128,9945,1,37940,19855,19318
9450317,9450317,TXFE7,128,9943,1,37941,19856,19319
9450354,9450349,TXFE7,128,9943,1,37942,19857,19320
9450354,9450350,TXFE7,128,9944,1,37943,19858,19321
9450392,9450392,TXFE7,128,9944,2,37945,19859,19322
9450404,9450395,TXFE7,128,9944,1,37946,19860,19323
9450417,9450416,TXFE7,128,9943,1,37947,19861,19324
9450429,9450421,TXFE7,128,9943,1,37948,19862,19325
9450467,9450459,TXFE7,128,9943,1,37949,19863,19326
9450467,9450464,TXFE7,128,9944,3,37952,19864,19328
9450517,9450511,TXFE7,128,9943,5,37957,19866,19329
9450579,9450578,TXFE7,128,9944,1,37958,19867,19330
9450604,9450602,TXFE7,128,9943,8,37966,19870,19331
9450692,9450692,TXFE7,128,9943,10,37976,19872,19332
9450704,9450692,TXFE7,128,9943,3,37979,19875,19333
9450717,9450716,TXFE7,128,9943,1,37980,19876,19334
9450767,9450760,TXFE7,128,9943,1,37981,19877,19335
9450829,9450822,TXFE7,128,9944,5,37986,19878,19339
9450842,9450830,TXFE7,128,9943,1,37987,19879,19340
9450954,9450943,TXFE7,128,9944,2,37989,19880,19342
9450979,9450972,TXFE7,128,9943,1,37990,19881,19343
9450992,9450981,TXFE7,128,9944,2,37992,19882,19345
9450992,9450981,TXFE7,128,9944,2,37994,19883,19347
9450992,9450981,TXFE7,128,9944,2,37996,19884,19348
9450992,9450982,TXFE7,128,9944,1,37997,19885,19349
9450992,9450982,TXFE7,128,9944,1,37998,19886,19350
9450992,9450982,TXFE7,128,9944,1,37999,19887,19351
9450992,9450982,TXFE7,128,9944,1,38000,19888,19352
9450992,9450982,TXFE7,128,9944,1,38001,19889,19353
9450992,9450982,TXFE7,128,9944,1,38002,19890,19354
9450992,9450985,TXFE7,128,9944,1,38003,19891,19355
9450992,9450992,TXFE7,128,9944,1,38004,19892,19356
9451004,9450995,TXFE7,128,9944,22,38026,19893,19368
9451004,9450997,TXFE7,128,9944,1,38027,19894,19369
9451017,9451004,TXFE7,128,9944,1,38028,19895,19370
9451017,9451015,TXFE7,129,9944,1,38040,19896,19378
9451017,9451015,TXFE7,129,9945,11,38040,19896,19378
9451017,9451016,TXFE7,128,9945,9,38049,19897,19383
9451017,9451016,TXFE7,128,9945,3,38052,19898,19384
9451042,9451033,TXFE7,128,9944,3,38055,19901,19385
9451042,9451034,TXFE7,128,9944,2,38057,19902,19386
9451067,9451059,TXFE7,128,9944,2,38059,19903,19388
9451092,9451080,TXFE7,128,9944,3,38062,19904,19389
9451104,9451097,TXFE7,128,9943,1,38063,19905,19390
9451104,9451103,TXFE7,128,9944,2,38065,19906,19391
9451104,9451104,TXFE7,128,9945,2,38067,19907,19392
9451117,9451114,TXFE7,128,9945,1,38068,19908,19393
9451154,9451147,TXFE7,128,9944,3,38071,19909,19396
9451154,9451153,TXFE7,128,9943,10,38081,19914,19397
9451167,9451161,TXFE7,128,9944,2,38083,19915,19398
9451179,9451176,TXFE7,128,9943,1,38084,19916,19399
9451204,9451196,TXFE7,128,9943,1,38085,19917,19400
9451217,9451212,TXFE7,128,9944,1,38086,19918,19401
9451267,9451257,TXFE7,128,9944,1,38087,19919,19402
9451317,9451307,TXFE7,128,9943,1,38088,19920,19403
9451329,9451327,TXFE7,128,9944,2,38090,19921,19405
9451354,9451346,TXFE7,129,9944,3,38101,19922,19410
9451354,9451346,TXFE7,129,9945,8,38101,19922,19410
9451429,9451424,TXFE7,128,9943,1,38102,19923,19411
9451492,9451479,TXFE7,128,9943,3,38105,19926,19412
9451529,9451518,TXFE7,128,9944,1,38106,19927,19413
9451529,9451519,TXFE7,128,9943,1,38107,19928,19414
9451542,9451542,TXFE7,128,9943,2,38109,19929,19415
9451629,9451618,TXFE7,128,9943,1,38110,19930,19416
9451692,9451685,TXFE7,128,9944,1,38111,19931,19417
9451729,9451718,TXFE7,128,9944,4,38115,19932,19419
9451854,9451847,TXFE7,128,9944,1,38116,19933,19420
9451854,9451850,TXFE7,128,9943,2,38118,19935,19421
9451979,9451974,TXFE7,128,9944,2,38120,19936,19422
9452004,9452003,TXFE7,128,9943,1,38121,19937,19423
9452017,9452015,TXFE7,128,9944,10,38131,19938,19429
9452042,9452041,TXFE7,128,9943,1,38132,19939,19430
9452054,9452048,TXFE7,128,9944,1,38133,19940,19431
9452179,9452173,TXFE7,128,9944,1,38134,19941,19432
9452204,9452194,TXFE7,128,9943,2,38136,19942,19433
9452254,9452252,TXFE7,128,9943,1,38137,19943,19434
9452254,9452254,TXFE7,128,9943,2,38139,19944,19435
9452279,9452268,TXFE7,128,9943,1,38140,19945,19436
9452304,9452302,TXFE7,128,9944,1,38141,19946,19437
9452304,9452304,TXFE7,128,9944,1,38142,19947,19438
9452329,9452317,TXFE7,128,9943,25,38167,19958,19439
9452329,9452320,TXFE7,128,9944,1,38168,19959,19440
9452329,9452323,TXFE7,128,9943,1,38169,19960,19441
9452329,9452326,TXFE7,128,9944,1,38170,19961,19442
9452342,9452333,TXFE7,128,9943,1,38171,19962,19443
9452354,9452342,TXFE7,128,9943,26,38197,19977,19444
9452367,9452354,TXFE7,128,9943,2,38199,19978,19445
9452367,9452354,TXFE7,128,9943,1,38200,19979,19446
9452404,9452398,TXFE7,128,9942,1,38201,19980,19447
9452442,9452437,TXFE7,128,9942,6,38207,19984,19448
9452492,9452491,TXFE7,128,9942,1,38208,19985,19449
9452554,9452543,TXFE7,128,9943,5,38213,19986,19453
9452554,9452544,TXFE7,128,9942,1,38214,19987,19454
9452567,9452555,TXFE7,128,9943,1,38215,19988,19455
9452567,9452559,TXFE7,128,9942,1,38216,19989,19456
9452592,9452584,TXFE7,128,9942,1,38217,19990,19457
9452729,9452722,TXFE7,128,9942,1,38218,19991,19458
9452754,9452747,TXFE7,128,9943,1,38219,19992,19459
9452767,9452758,TXFE7,128,9942,5,38224,19994,19460
9452779,9452778,TXFE7,128,9942,1,38225,19995,19461
9452817,9452814,TXFE7,128,9942,1,38226,19996,19462
9452879,9452876,TXFE7,128,9943,2,38228,19997,19464
9452892,9452882,TXFE7,128,9942,1,38229,19998,19465
9452992,9452985,TXFE7,128,9942,1,38230,19999,19466
9453029,9453023,TXFE7,128,9943,2,38232,20000,19467
9453029,9453026,TXFE7,128,9942,1,38233,20001,19468
9453129,9453123,TXFE7,128,9942,1,38234,20002,19469
9453192,9453182,TXFE7,128,9943,1,38235,20003,19470
9453292,9453286,TXFE7,128,9942,2,38237,20004,19471
9453292,9453289,TXFE7,128,9942,2,38239,20006,19472
9453379,9453368,TXFE7,128,9942,6,38245,20010,19473
9453517,9453515,TXFE7,128,9942,1,38246,20011,19474
9453529,9453517,TXFE7,128,9942,67,38313,20038,19475
9453542,9453534,TXFE7,128,9941,2,38315,20040,19476
9453567,9453563,TXFE7,128,9942,1,38316,20041,19477
9453642,9453630,TXFE7,128,9941,1,38317,20042,19478
9453654,9453643,TXFE7,128,9941,2,38319,20043,19479
9453679,9453667,TXFE7,128,9942,1,38320,20044,19480
9453679,9453668,TXFE7,128,9941,3,38323,20045,19481
9453704,9453692,TXFE7,128,9941,3,38326,20048,19482
9453742,9453733,TXFE7,128,9941,48,38374,20074,19483
9453854,9453851,TXFE7,128,9940,1,38375,20075,19484
9453892,9453884,TXFE7,128,9940,1,38376,20076,19485
9453904,9453895,TXFE7,128,9941,1,38377,20077,19486
9453904,9453898,TXFE7,128,9940,2,38379,20079,19487
9453904,9453901,TXFE7,128,9941,1,38380,20080,19488
9453904,9453903,TXFE7,128,9940,1,38381,20081,19489
9453917,9453905,TXFE7,128,9940,2,38383,20082,19490
9453917,9453913,TXFE7,128,9940,1,38384,20083,19491
9453929,9453920,TXFE7,128,9940,1,38385,20084,19492
9453942,9453940,TXFE7,128,9940,1,38386,20085,19493
9453954,9453943,TXFE7,128,9940,1,38387,20086,19494
9453967,9453956,TXFE7,128,9940,1,38388,20087,19495
9454004,9453997,TXFE7,128,9940,1,38389,20088,19496
9454029,9454020,TXFE7,128,9940,1,38390,20089,19497
9454067,9454065,TXFE7,128,9941,1,38391,20090,19498
9454117,9454112,TXFE7,128,9940,1,38392,20091,19499
9454142,9454131,TXFE7,128,9941,1,38393,20092,19500
9454292,9454291,TXFE7,128,9941,1,38394,20093,19501
9454304,9454300,TXFE7,128,9940,1,38395,20094,19502
9454367,9454366,TXFE7,128,9941,1,38396,20095,19503
9454454,9454454,TXFE7,128,9940,1,38397,20096,19504
9454504,9454494,TXFE7,128,9941,1,38398,20097,19505
9454542,9454530,TXFE7,128,9940,1,38399,20098,19506
9454617,9454609,TXFE7,128,9941,1,38400,20099,19507
9454642,9454630,TXFE7,128,9940,1,38401,20100,19508
9454642,9454631,TXFE7,129,9941,13,38416,20101,19522
9454642,9454631,TXFE7,129,9942,2,38416,20101,19522
9454642,9454638,TXFE7,128,9941,1,38417,20102,19523
9454654,9454642,TXFE7,128,9941,1,38418,20103,19524
9454692,9454684,TXFE7,128,9941,9,38427,20106,19525
9454779,9454770,TXFE7,128,9941,3,38430,20107,19526
9454892,9454881,TXFE7,128,9941,1,38431,20108,19527
9454892,9454885,TXFE7,128,9941,2,38433,20109,19528
9455117,9455116,TXFE7,128,9941,1,38434,20110,19529
9455142,9455137,TXFE7,128,9942,1,38435,20111,19530
9455154,9455145,TXFE7,128,9942,4,38439,20112,19532
9455167,9455154,TXFE7,128,9942,2,38441,20113,19534
9455192,9455191,TXFE7,128,9942,1,38442,20114,19535
9455204,9455192,TXFE7,128,9942,1,38443,20115,19536
9455204,9455196,TXFE7,128,9942,1,38444,20116,19537
9455267,9455262,TXFE7,128,9943,1,38445,20117,19538
9455267,9455263,TXFE7,128,9942,2,38447,20119,19539
9455292,9455290,TXFE7,128,9943,3,38450,20120,19540
9455329,9455320,TXFE7,128,9941,1,38451,20121,19541
9455429,9455422,TXFE7,128,9942,1,38452,20122,19542
9455579,9455569,TXFE7,128,9942,1,38453,20123,19543
9455767,9455755,TXFE7,128,9942,1,38454,20124,19544
9455804,9455799,TXFE7,128,9941,1,38455,20125,19545
9455817,9455809,TXFE7,128,9942,1,38456,20126,19546
9460029,9460018,TXFE7,128,9942,3,38459,20127,19549
9460579,9460571,TXFE7,128,9942,1,38460,20128,19550
9460617,9460614,TXFE7,128,9942,1,38461,20129,19551
9460642,9460635,TXFE7,128,9942,24,38485,20130,19567
9460654,9460643,TXFE7,128,9942,1,38486,20131,19568
9460704,9460702,TXFE7,128,9942,1,38487,20132,19569
9460729,9460724,TXFE7,128,9942,1,38488,20133,19570
9460754,9460749,TXFE7,128,9942,1,38489,20134,19571
9460767,9460755,TXFE7,128,9942,5,38494,20137,19572
9460792,9460786,TXFE7,128,9942,2,38496,20138,19573
9460842,9460833,TXFE7,128,9942,1,38497,20139,19574
9460854,9460849,TXFE7,128,9941,9,38506,20143,19575
9460967,9460959,TXFE7,128,9941,2,38508,20145,19576
9460979,9460970,TXFE7,128,9941,1,38509,20146,19577
9461092,9461084,TXFE7,128,9942,1,38510,20147,19578
9461292,9461289,TXFE7,128,9941,2,38512,20148,19579
9461592,9461584,TXFE7,128,9941,1,38513,20149,19580
9461629,9461617,TXFE7,128,9941,1,38514,20150,19581
9461629,9461628,TXFE7,128,9941,24,38538,20166,19582
9461717,9461711,TXFE7,128,9940,1,38539,20167,19583
9461817,9461806,TXFE7,128,9941,1,38540,20168,19584
9461879,9461879,TXFE7,128,9941,1,38541,20169,19585
9461967,9461964,TXFE7,128,9940,1,38542,20170,19586
9461992,9461992,TXFE7,128,9941,3,38545,20171,19589
9462079,9462075,TXFE7,128,9940,1,38546,20172,19590
9462129,9462120,TXFE7,128,9941,3,38549,20173,19591
9462129,9462121,TXFE7,128,9941,2,38551,20174,19592
9462129,9462121,TXFE7,128,9940,1,38552,20175,19593
9462142,9462134,TXFE7,128,9941,1,38553,20176,19594
9462142,9462141,TXFE7,128,9940,1,38554,20177,19595
9462254,9462251,TXFE7,128,9940,2,38556,20178,19596
9462279,9462272,TXFE7,128,9940,2,38558,20180,19597
9462304,9462302,TXFE7,128,9941,9,38567,20181,19605
9462329,9462321,TXFE7,128,9941,1,38568,20182,19606
9462667,9462662,TXFE7,128,9941,1,38569,20183,19607
9462679,9462667,TXFE7,128,9941,1,38570,20184,19608
9462817,9462806,TXFE7,128,9941,3,38573,20186,19609
9462842,9462831,TXFE7,128,9941,2,38575,20187,19610
9462942,9462937,TXFE7,128,9941,1,38576,20188,19611
9463117,9463111,TXFE7,128,9942,1,38577,20189,19612
9463229,9463225,TXFE7,128,9942,1,38578,20190,19613
9463292,9463284,TXFE7,128,9941,1,38579,20191,19614
9463292,9463286,TXFE7,128,9941,1,38580,20192,19615
9463392,9463387,TXFE7,128,9941,1,38581,20193,19616
9463579,9463578,TXFE7,128,9942,1,38582,20194,19617
9463792,9463782,TXFE7,128,9942,1,38583,20195,19618
9463842,9463836,TXFE7,128,9942,1,38584,20196,19619
9464004,9463993,TXFE7,128,9941,1,38585,20197,19620
9464092,9464082,TXFE7,128,9941,1,38586,20198,19621
9464254,9464245,TXFE7,128,9941,3,38589,20199,19622
9464254,9464251,TXFE7,128,9941,1,38590,20200,19623
9464292,9464281,TXFE7,128,9941,1,38591,20201,19624
9464304,9464300,TXFE7,128,9942,1,38592,20202,19625
9464354,9464350,TXFE7,128,9941,1,38593,20203,19626
9464367,9464355,TXFE7,128,9941,1,38594,20204,19627
9464617,9464612,TXFE7,128,9941,1,38595,20205,19628
9464679,9464671,TXFE7,128,9941,1,38596,20206,19629
9464692,9464680,TXFE7,128,9941,7,38603,20212,19630
9464792,9464783,TXFE7,128,9940,1,38604,20213,19631
9464842,9464835,TXFE7,128,9941,1,38605,20214,19632
9464854,9464854,TXFE7,128,9940,5,38610,20215,19633
9464904,9464901,TXFE7,128,9940,1,38611,20216,19634
9464929,9464917,TXFE7,128,9940,1,38612,20217,19635
9464929,9464919,TXFE7,128,9940,1,38613,20218,19636
9465379,9465367,TXFE7,128,9940,1,38614,20219,19637
9465717,9465711,TXFE7,128,9940,5,38619,20221,19638
9465842,9465837,TXFE7,128,9940,3,38622,20224,19639
9465879,9465871,TXFE7,128,9941,1,38623,20225,19640
9465879,9465876,TXFE7,128,9941,1,38624,20226,19641
9465929,9465922,TXFE7,128,9941,5,38629,20227,19643
9470067,9470058,TXFE7,128,9941,1,38630,20228,19644
9470067,9470058,TXFE7,128,9941,1,38631,20229,19645
9470079,9470071,TXFE7,128,9940,1,38632,20230,19646
9470092,9470087,TXFE7,128,9940,2,38634,20232,19647
9470129,9470129,TXFE7,128,9940,1,38635,20233,19648
9470267,9470263,TXFE7,128,9940,1,38636,20234,19649
9470279,9470269,TXFE7,128,9941,1,38637,20235,19650
9470279,9470270,TXFE7,128,9941,1,38638,20236,19651
9470279,9470272,TXFE7,128,9941,1,38639,20237,19652
9470279,9470273,TXFE7,128,9941,1,38640,20238,19653
9470292,9470287,TXFE7,128,9940,1,38641,20239,19654
9470292,9470289,TXFE7,128,9940,10,38651,20240,19655
9470492,9470483,TXFE7,128,9940,1,38652,20241,19656
9470504,9470495,TXFE7,128,9940,1,38653,20242,19657
9470579,9470571,TXFE7,128,9940,1,38654,20243,19658
9470579,9470574,TXFE7,128,9940,3,38657,20244,19659
9470642,9470632,TXFE7,128,9940,2,38659,20245,19660
9470667,9470664,TXFE7,128,9940,1,38660,20246,19661
9470717,9470709,TXFE7,128,9941,5,38665,20247,19665
9470767,9470766,TXFE7,128,9940,1,38666,20248,19666
9470967,9470955,TXFE7,128,9940,3,38669,20249,19667
9471117,9471112,TXFE7,128,9941,1,38670,20250,19668
9471129,9471121,TXFE7,128,9940,1,38671,20251,19669
9471429,9471427,TXFE7,128,9940,25,38696,20274,19670
9471467,9471456,TXFE7,128,9940,2,38698,20276,19671
9471529,9471522,TXFE7,128,9940,3,38701,20278,19672
9471542,9471540,TXFE7,128,9940,1,38702,20279,19673
9471592,9471584,TXFE7,128,9941,1,38703,20280,19674
9471604,9471595,TXFE7,128,9940,1,38704,20281,19675
9471617,9471611,TXFE7,128,9940,1,38705,20282,19676
9471692,9471681,TXFE7,128,9940,1,38706,20283,19677
9471704,9471700,TXFE7,128,9940,3,38709,20286,19678
9471742,9471733,TXFE7,128,9940,1,38710,20287,19679
9471792,9471789,TXFE7,128,9940,1,38711,20288,19680
9471842,9471842,TXFE7,128,9940,1,38712,20289,19681
9471867,9471856,TXFE7,128,9940,1,38713,20290,19682
9471892,9471891,TXFE7,128,9940,1,38714,20291,19683
9471892,9471891,TXFE7,128,9940,1,38715,20292,19684
9471917,9471916,TXFE7,128,9940,1,38716,20293,19685
9471967,9471963,TXFE7,128,9940,2,38718,20294,19686
9471979,9471975,TXFE7,128,9940,1,38719,20295,19687
9471992,9471985,TXFE7,129,9940,13,38749,20316,19688
9471992,9471985,TXFE7,129,9939,17,38749,20316,19688
9472017,9472007,TXFE7,128,9939,1,38750,20317,19689
9472029,9472017,TXFE7,128,9939,1,38751,20318,19690
9472029,9472018,TXFE7,128,9939,2,38753,20320,19691
9472029,9472026,TXFE7,128,9939,3,38756,20321,19692
9472054,9472047,TXFE7,128,9939,1,38757,20322,19693
9472092,9472081,TXFE7,128,9940,5,38762,20323,19696
9472104,9472098,TXFE7,128,9939,1,38763,20324,19697
9472154,9472143,TXFE7,128,9940,5,38768,20325,19701
9472192,9472182,TXFE7,128,9939,4,38772,20329,19702
9472204,9472200,TXFE7,128,9939,1,38773,20330,19703
9472229,9472219,TXFE7,128,9939,10,38783,20333,19704
9472242,9472235,TXFE7,128,9939,1,38784,20334,19705
9472354,9472349,TXFE7,128,9940,2,38786,20335,19706
9472354,9472351,TXFE7,128,9940,5,38791,20336,19711
9472404,9472395,TXFE7,128,9940,3,38794,20337,19714
9472417,9472416,TXFE7,128,9941,1,38795,20338,19715
9472454,9472445,TXFE7,128,9941,1,38796,20339,19716
9472654,9472643,TXFE7,128,9940,25,38821,20345,19717
9472667,9472659,TXFE7,128,9940,1,38822,20346,19718
9472792,9472781,TXFE7,128,9940,3,38825,20348,19719
9473004,9472993,TXFE7,128,9940,1,38826,20349,19720
9473029,9473017,TXFE7,128,9940,1,38827,20350,19721
9473092,9473087,TXFE7,128,9940,1,38828,20351,19722
9473129,9473124,TXFE7,128,9940,1,38829,20352,19723
9473167,9473155,TXFE7,128,9940,1,38830,20353,19724
9473304,9473295,TXFE7,128,9940,1,38831,20354,19725
9473317,9473304,TXFE7,128,9940,1,38832,20355,19726
9473317,9473313,TXFE7,128,9940,1,38833,20356,19727
9473329,9473329,TXFE7,128,9940,1,38834,20357,19728
9473392,9473385,TXFE7,128,9940,2,38836,20358,19729
9473429,9473421,TXFE7,128,9941,1,38837,20359,19730
9473454,9473451,TXFE7,128,9941,2,38839,20360,19732
9473454,9473453,TXFE7,128,9940,1,38840,20361,19733
9473467,9473458,TXFE7,128,9940,2,38842,20362,19734
9473492,9473486,TXFE7,128,9940,1,38843,20363,19735
9473579,9473578,TXFE7,128,9941,1,38844,20364,19736
9473604,9473603,TXFE7,128,9940,4,38848,20367,19737
9473729,9473719,TXFE7,128,9940,1,38849,20368,19738
9473804,9473798,TXFE7,128,9940,1,38850,20369,19739
9473804,9473801,TXFE7,128,9939,1,38851,20370,19740
9473829,9473829,TXFE7,128,9940,1,38852,20371,19741
9473854,9473847,TXFE7,128,9939,2,38854,20373,19742
9473904,9473901,TXFE7,128,9940,3,38857,20374,19744
9473967,9473956,TXFE7,128,9940,2,38859,20375,19746
9474229,9474221,TXFE7,128,9940,1,38860,20376,19747
9474242,9474231,TXFE7,128,9939,1,38861,20377,19748
9474254,9474246,TXFE7,128,9939,1,38862,20378,19749
9474542,9474540,TXFE7,128,9940,3,38865,20379,19752
9474567,9474562,TXFE7,128,9940,2,38867,20380,19754
9474592,9474591,TXFE7,128,9940,1,38868,20381,19755
9474604,9474593,TXFE7,128,9940,2,38870,20382,19757
9474704,9474696,TXFE7,128,9940,1,38871,20383,19758
9474892,9474883,TXFE7,128,9939,1,38872,20384,19759
9474954,9474954,TXFE7,128,9940,1,38873,20385,19760
9475142,9475139,TXFE7,128,9940,1,38874,20386,19761
9475242,9475234,TXFE7,128,9940,1,38875,20387,19762
9475254,9475246,TXFE7,128,9940,15,38890,20388,19772
9475304,9475295,TXFE7,128,9940,1,38891,20389,19773
9475304,9475297,TXFE7,128,9940,1,38892,20390,19774
9475329,9475320,TXFE7,128,9940,1,38893,20391,19775
9475342,9475329,TXFE7,128,9940,2,38895,20392,19776
9475404,9475399,TXFE7,128,9940,1,38896,20393,19777
9475504,9475501,TXFE7,128,9940,1,38897,20394,19778
9475692,9475684,TXFE7,128,9940,3,38900,20397,19779
9475717,9475716,TXFE7,128,9940,1,38901,20398,19780
9475729,9475720,TXFE7,128,9940,1,38902,20399,19781
9475754,9475746,TXFE7,128,9939,1,38903,20400,19782
9475779,9475767,TXFE7,128,9940,2,38905,20401,19783
9475792,9475788,TXFE7,128,9941,10,38915,20402,19788
9480054,9480053,TXFE7,128,9941,4,38919,20403,19790
9480054,9480054,TXFE7,128,9941,6,38925,20404,19791
9480067,9480055,TXFE7,128,9941,6,38931,20405,19792
9480067,9480057,TXFE7,128,9941,2,38933,20406,19793
9480079,9480067,TXFE7,128,9941,61,38994,20407,19819
9480192,9480188,TXFE7,128,9941,1,38995,20408,19820
9480567,9480562,TXFE7,128,9942,1,38996,20409,19821
9480579,9480574,TXFE7,128,9942,3,38999,20410,19822
9480592,9480580,TXFE7,128,9941,1,39000,20411,19823
9480704,9480693,TXFE7,128,9942,1,39001,20412,19824
9480767,9480761,TXFE7,128,9942,3,39004,20413,19827
9480917,9480915,TXFE7,128,9941,1,39005,20414,19828
9480954,9480942,TXFE7,128,9941,1,39006,20415,19829
9481154,9481147,TXFE7,128,9941,10,39016,20419,19830
9481167,9481154,TXFE7,128,9941,2,39018,20421,19831
9481167,9481159,TXFE7,128,9941,1,39019,20422,19832
9481192,9481179,TXFE7,128,9941,2,39021,20423,19833
9481229,9481217,TXFE7,128,9941,1,39022,20424,19834
9481242,9481230,TXFE7,128,9941,2,39024,20425,19835
9481354,9481353,TXFE7,128,9940,3,39027,20428,19836
9481367,9481357,TXFE7,128,9941,1,39028,20429,19837
9481604,9481594,TXFE7,128,9941,1,39029,20430,19838
9481717,9481709,TXFE7,128,9941,1,39030,20431,19839
9481892,9481889,TXFE7,128,9941,3,39033,20432,19842
9481979,9481967,TXFE7,128,9941,1,39034,20433,19843
9482067,9482063,TXFE7,128,9942,1,39035,20434,19844
9482192,9482179,TXFE7,128,9942,4,39039,20435,19845
9482217,9482205,TXFE7,128,9941,1,39040,20436,19846
9482292,9482285,TXFE7,128,9941,1,39041,20437,19847
9482317,9482313,TXFE7,128,9941,5,39046,20441,19848
9482554,9482551,TXFE7,128,9942,52,39098,20442,19882
9482554,9482553,TXFE7,128,9942,1,39099,20443,19883
9482554,9482553,TXFE7,128,9941,1,39100,20444,19884
9482567,9482554,TXFE7,128,9942,2,39102,20445,19885
9482567,9482554,TXFE7,128,9942,1,39103,20446,19886
9482567,9482554,TXFE7,128,9942,3,39106,20447,19888
9482567,9482554,TXFE7,128,9942,4,39110,20448,19891
9482617,9482611,TXFE7,128,9942,1,39111,20449,19892
9482692,9482691,TXFE7,128,9942,2,39113,20450,19893
9482829,9482825,TXFE7,128,9942,1,39114,20451,19894
9482842,9482839,TXFE7,128,9942,1,39115,20452,19895
9482892,9482886,TXFE7,128,9942,2,39117,20454,19896
9482929,9482917,TXFE7,128,9942,1,39118,20455,19897
9482929,9482924,TXFE7,128,9941,1,39119,20456,19898
9483142,9483131,TXFE7,128,9942,1,39120,20457,19899
9483467,9483467,TXFE7,128,9942,1,39121,20458,19900
9483592,9483584,TXFE7,128,9942,5,39126,20459,19901
9483742,9483731,TXFE7,128,9942,5,39131,20462,19902
9483767,9483763,TXFE7,128,9942,4,39135,20465,19903
9483817,9483813,TXFE7,128,9942,2,39137,20466,19904
9483829,9483826,TXFE7,128,9942,4,39141,20467,19905
9483904,9483898,TXFE7,128,9942,1,39142,20468,19906
9483904,9483899,TXFE7,128,9943,1,39143,20469,19907
9483929,9483923,TXFE7,128,9943,2,39145,20470,19908
9483942,9483939,TXFE7,128,9943,1,39146,20471,19909
9484042,9484035,TXFE7,128,9942,1,39147,20472,19910
9484304,9484296,TXFE7,128,9942,1,39148,20473,19911
9484517,9484509,TXFE7,128,9942,14,39162,20480,19912
9484592,9484591,TXFE7,128,9942,5,39167,20481,19913
9484617,9484605,TXFE7,128,9942,2,39169,20482,19915
9484654,9484642,TXFE7,128,9941,21,39190,20492,19916
9484717,9484711,TXFE7,128,9942,1,39191,20493,19917
9484929,9484917,TXFE7,128,9942,3,39194,20494,19920
9484979,9484979,TXFE7,128,9942,1,39195,20495,19921
9485542,9485533,TXFE7,128,9942,3,39198,20496,19924
9485554,9485549,TXFE7,128,9942,10,39208,20497,19929
9485767,9485761,TXFE7,128,9943,3,39211,20498,19932
9485817,9485806,TXFE7,128,9942,1,39212,20499,19933
9485842,9485830,TXFE7,128,9942,1,39213,20500,19934
9485954,9485950,TXFE7,128,9943,1,39214,20501,19935
9490029,9490026,TXFE7,128,9942,2,39216,20503,19936
9490042,9490033,TXFE7,128,9942,1,39217,20504,19937
9490129,9490125,TXFE7,128,9943,1,39218,20505,19938
9490142,9490141,TXFE7,128,9942,1,39219,20506,19939
9490154,9490144,TXFE7,128,9943,1,39220,20507,19940
9490154,9490145,TXFE7,128,9943,6,39226,20508,19943
9490154,9490149,TXFE7,128,9943,2,39228,20509,19945
9490167,9490159,TXFE7,128,9943,1,39229,20510,19946
9490192,9490182,TXFE7,128,9943,1,39230,20511,19947
9490217,9490216,TXFE7,128,9943,1,39231,20512,19948
9490229,9490223,TXFE7,128,9943,1,39232,20513,19949
9490242,9490232,TXFE7,128,9943,1,39233,20514,19950
9490254,9490251,TXFE7,128,9943,1,39234,20515,19951
9490292,9490289,TXFE7,128,9943,1,39235,20516,19952
9490317,9490308,TXFE7,128,9943,1,39236,20517,19953
9490317,9490315,TXFE7,128,9943,1,39237,20518,19954
9490329,9490318,TXFE7,128,9943,1,39238,20519,19955
9490329,9490318,TXFE7,128,9943,20,39258,20520,19967
9490354,9490344,TXFE7,128,9943,1,39273,20526,19976
9490379,9490373,TXFE7,128,9943,1,39274,20527,19977
9490379,9490374,TXFE7,128,9943,2,39276,20528,19979
9490392,9490379,TXFE7,128,9943,4,39280,20529,19983
9490392,9490379,TXFE7,128,9943,2,39282,20530,19985
9490392,9490379,TXFE7,128,9943,2,39284,20531,19986
9490392,9490379,TXFE7,128,9943,1,39285,20532,19987
9490392,9490379,TXFE7,128,9943,4,39289,20533,19991
9490429,9490425,TXFE7,128,9943,1,39290,20534,19992
9490454,9490442,TXFE7,128,9943,3,39293,20537,19993
9490454,9490442,TXFE7,128,9943,3,39296,20538,19994
9490454,9490444,TXFE7,128,9943,1,39297,20539,19995
9490467,9490454,TXFE7,128,9943,2,39299,20540,19996
9490467,9490454,TXFE7,128,9943,2,39301,20541,19997
9490467,9490463,TXFE7,128,9943,2,39303,20542,19998
9490667,9490666,TXFE7,128,9943,2,39318,20548,20004
9490742,9490741,TXFE7,128,9943,5,39323,20549,20005
9490754,9490747,TXFE7,128,9943,1,39324,20550,20006
9490879,9490875,TXFE7,128,9942,3,39327,20553,20007
9490917,9490911,TXFE7,128,9943,1,39328,20554,20008
9490992,9490986,TXFE7,128,9942,5,39333,20559,20009
9491004,9491003,TXFE7,128,9943,1,39334,20560,20010
9491054,9491042,TXFE7,128,9942,1,39335,20561,20011
9491142,9491138,TXFE7,128,9942,1,39336,20562,20012
9491367,9491361,TXFE7,128,9942,1,39337,20563,20013
9491379,9491367,TXFE7,128,9943,1,39338,20564,20014
9491529,9491521,TXFE7,128,9942,1,39339,20565,20015
9491542,9491530,TXFE7,128,9943,1,39340,20566,20016
9491579,9491568,TXFE7,128,9943,4,39344,20567,20017
9491592,9491586,TXFE7,128,9943,1,39345,20568,20018
9491942,9491932,TXFE7,128,9942,2,39347,20570,20019
9492067,9492065,TXFE7,128,9943,10,39357,20571,20020
9492192,9492187,TXFE7,128,9943,5,39362,20572,20025
9492204,9492192,TXFE7,128,9943,26,39388,20573,20036
9492217,9492211,TXFE7,128,9943,1,39389,20574,20037
9492329,9492320,TXFE7,128,9943,2,39391,20576,20038
9492404,9492397,TXFE7,128,9943,8,39399,20579,20039
9492442,9492439,TXFE7,128,9943,3,39402,20580,20041
9492629,9492625,TXFE7,128,9943,2,39404,20581,20042
9492829,9492820,TXFE7,128,9942,1,39405,20582,20043
9492854,9492842,TXFE7,128,9942,1,39406,20583,20044
9492879,9492867,TXFE7,128,9942,1,39407,20584,20045
9492892,9492884,TXFE7,128,9942,4,39411,20586,20046
9492929,9492918,TXFE7,128,9942,19,39430,20593,20047
9492954,9492942,TXFE7,128,9942,1,39431,20594,20048
9492954,9492946,TXFE7,128,9942,1,39432,20595,20049
9493042,9493033,TXFE7,128,9941,1,39433,20596,20050
9493079,9493078,TXFE7,128,9941,1,39434,20597,20051
9493154,9493153,TXFE7,128,9942,1,39435,20598,20052
9493279,9493268,TXFE7,128,9942,1,39436,20599,20053
9493417,9493406,TXFE7,128,9941,2,39438,20600,20054
9493429,9493417,TXFE7,128,9941,8,39446,20601,20055
9493429,9493417,TXFE7,128,9941,8,39454,20606,20056
9493429,9493417,TXFE7,128,9941,6,39460,20610,20057
9493429,9493417,TXFE7,128,9941,2,39462,20611,20058
9493429,9493417,TXFE7,128,9941,4,39466,20614,20059
9493429,9493417,TXFE7,128,9941,22,39488,20620,20060
9493429,9493417,TXFE7,128,9941,11,39499,20627,20061
9493517,9493507,TXFE7,128,9941,1,39500,20628,20062
9493604,9493596,TXFE7,128,9941,5,39505,20629,20064
9494017,9494008,TXFE7,128,9941,1,39506,20630,20065
9494079,9494068,TXFE7,128,9940,1,39507,20631,20066
9494104,9494097,TXFE7,128,9941,1,39508,20632,20067
9494129,9494128,TXFE7,128,9940,5,39513,20637,20068
9494179,9494176,TXFE7,128,9941,3,39516,20638,20070
9494229,9494229,TXFE7,128,9940,1,39517,20639,20071
9494254,9494244,TXFE7,128,9940,1,39518,20640,20072
9494292,9494285,TXFE7,128,9940,1,39519,20641,20073
9494392,9494387,TXFE7,128,9940,1,39520,20642,20074
9494404,9494404,TXFE7,128,9940,1,39521,20643,20075
9494717,9494716,TXFE7,128,9940,1,39522,20644,20076
9494892,9494891,TXFE7,128,9940,1,39523,20645,20077
9495454,9495445,TXFE7,128,9941,1,39524,20646,20078
9495467,9495465,TXFE7,128,9940,1,39525,20647,20079
9495492,9495486,TXFE7,128,9940,1,39526,20648,20080
9495717,9495715,TXFE7,128,9940,1,39527,20649,20081
9495867,9495864,TXFE7,128,9941,1,39528,20650,20082
9495967,9495962,TXFE7,128,9941,5,39533,20651,20087
9495967,9495964,TXFE7,128,9940,18,39551,20656,20088
9500054,9500044,TXFE7,128,9941,1,39552,20657,20089
9500067,9500055,TXFE7,128,9941,7,39559,20658,20096
9500267,9500260,TXFE7,128,9942,4,39563,20659,20099
9500279,9500278,TXFE7,128,9942,11,39574,20660,20105
9500304,9500298,TXFE7,128,9942,1,39575,20661,20106
9500317,9500308,TXFE7,128,9942,1,39576,20662,20107
9500329,9500319,TXFE7,128,9943,4,39580,20663,20109
9500329,9500321,TXFE7,128,9942,2,39582,20664,20110
9500354,9500346,TXFE7,128,9942,2,39584,20665,20111
9500492,9500486,TXFE7,128,9942,2,39586,20666,20112
9500504,9500492,TXFE7,128,9942,1,39587,20667,20113
9500629,9500617,TXFE7,128,9941,1,39588,20668,20114
9500654,9500642,TXFE7,128,9941,1,39589,20669,20115
9500667,9500661,TXFE7,128,9941,3,39592,20672,20116
9500679,9500667,TXFE7,128,9941,2,39594,20674,20117
9500679,9500674,TXFE7,128,9940,1,39595,20675,20118
9500692,9500683,TXFE7,128,9941,1,39596,20676,20119
9500742,9500735,TXFE7,128,9942,5,39601,20677,20121
9501342,9501331,TXFE7,128,9941,1,39602,20678,20122
9502054,9502042,TXFE7,128,9942,1,39603,20679,20123
9502517,9502505,TXFE7,128,9941,1,39604,20680,20124
9502529,9502518,TXFE7,128,9942,1,39605,20681,20125
9502654,9502650,TXFE7,128,9941,1,39606,20682,20126
9503242,9503239,TXFE7,128,9941,20,39626,20690,20127
9503342,9503335,TXFE7,128,9941,21,39647,20696,20128
9503342,9503335,TXFE7,128,9941,2,39649,20698,20129
9503567,9503556,TXFE7,128,9941,1,39650,20699,20130
9503842,9503832,TXFE7,128,9940,1,39651,20700,20131
9504242,9504230,TXFE7,128,9941,2,39653,20701,20133
9504604,9504594,TXFE7,128,9941,1,39654,20702,20134
9504604,9504594,TXFE7,128,9941,3,39657,20703,20136
9504604,9504594,TXFE7,128,9941,5,39662,20704,20141
9504792,9504785,TXFE7,128,9941,1,39663,20705,20142
9504792,9504791,TXFE7,128,9941,1,39664,20706,20143
9504804,9504796,TXFE7,128,9941,5,39669,20711,20144
9504829,9504824,TXFE7,128,9941,1,39670,20712,20145
9505092,9505083,TXFE7,128,9941,1,39671,20713,20146
9505292,9505289,TXFE7,128,9941,1,39672,20714,20147
9505304,9505294,TXFE7,128,9941,1,39673,20715,20148
9505317,9505310,TXFE7,128,9941,1,39674,20716,20149
9505367,9505358,TXFE7,128,9941,1,39675,20717,20150
9505479,9505475,TXFE7,128,9941,1,39676,20718,20151
9505729,9505728,TXFE7,128,9941,1,39677,20719,20152
9510429,9510426,TXFE7,128,9941,1,39678,20720,20153
9510442,9510441,TXFE7,128,9941,2,39680,20721,20154
9510454,9510449,TXFE7,128,9941,1,39681,20722,20155
9510492,9510488,TXFE7,128,9941,2,39683,20723,20156
9510504,9510495,TXFE7,128,9941,2,39685,20724,20157
9510504,9510500,TXFE7,128,9941,4,39689,20725,20158
9510529,9510517,TXFE7,128,9941,1,39690,20726,20159
9510529,9510517,TXFE7,128,9941,4,39694,20728,20160
9510529,9510528,TXFE7,128,9941,13,39707,20733,20161
9510554,9510546,TXFE7,128,9941,1,39708,20734,20162
9511129,9511129,TXFE7,128,9941,5,39713,20735,20166
9511179,9511178,TXFE7,128,9940,2,39715,20737,20167
9511554,9511543,TXFE7,128,9940,1,39716,20738,20168
9511717,9511712,TXFE7,128,9940,3,39719,20741,20169
9511792,9511786,TXFE7,128,9940,1,39720,20742,20170
9512554,9512554,TXFE7,128,9941,5,39725,20743,20171
9512604,9512593,TXFE7,128,9941,2,39727,20744,20172
9512629,9512620,TXFE7,128,9940,1,39728,20745,20173
9512817,9512806,TXFE7,128,9940,1,39729,20746,20174
9512917,9512914,TXFE7,128,9940,1,39730,20747,20175
9513054,9513050,TXFE7,128,9940,1,39731,20748,20176
9513292,9513281,TXFE7,128,9941,1,39732,20749,20177
9513304,9513292,TXFE7,128,9941,6,39738,20750,20181
9513329,9513317,TXFE7,128,9941,1,39739,20751,20182
9513329,9513317,TXFE7,128,9941,6,39745,20752,20188
9513404,9513399,TXFE7,128,9942,1,39746,20753,20189
9513429,9513428,TXFE7,128,9941,1,39747,20754,20190
9513467,9513457,TXFE7,128,9942,3,39750,20755,20192
9513492,9513491,TXFE7,128,9942,3,39753,20756,20195
9513717,9513711,TXFE7,128,9942,2,39755,20757,20196
9514042,9514031,TXFE7,128,9941,2,39757,20758,20197
9514142,9514133,TXFE7,128,9942,1,39758,20759,20198
9514542,9514538,TXFE7,128,9942,1,39759,20760,20199
9514604,9514603,TXFE7,128,9941,1,39760,20761,20200
9514679,9514672,TXFE7,128,9941,2,39762,20762,20201
9514779,9514767,TXFE7,128,9941,1,39763,20763,20202
9514992,9514982,TXFE7,128,9941,16,39779,20772,20203
9515004,9514992,TXFE7,128,9941,11,39790,20775,20204
9515004,9514997,TXFE7,128,9941,1,39791,20776,20205
9515067,9515064,TXFE7,128,9940,1,39792,20777,20206
9515479,9515467,TXFE7,128,9941,2,39794,20779,20207
9515492,9515489,TXFE7,128,9941,3,39797,20780,20208
9515504,9515504,TXFE7,128,9941,2,39799,20781,20209
9515529,9515519,TXFE7,128,9941,1,39800,20782,20210
9515617,9515609,TXFE7,128,9941,2,39802,20783,20212
9515792,9515779,TXFE7,128,9941,1,39803,20784,20213
9520354,9520346,TXFE7,128,9942,63,39866,20785,20249
9520354,9520346,TXFE7,128,9942,10,39876,20786,20255
9520379,9520374,TXFE7,128,9943,1,39877,20787,20256
9520379,9520376,TXFE7,128,9943,1,39878,20788,20257
9520392,9520383,TXFE7,128,9943,2,39880,20789,20258
9520404,9520398,TXFE7,128,9943,1,39881,20790,20259
9520404,9520399,TXFE7,128,9943,1,39882,20791,20260
9520404,9520400,TXFE7,128,9943,1,39883,20792,20261
9520417,9520408,TXFE7,128,9943,2,39885,20793,20262
9520417,9520412,TXFE7,128,9943,2,39887,20794,20263
9520442,9520433,TXFE7,128,9943,1,39888,20795,20264
9520454,9520450,TXFE7,128,9943,1,39889,20796,20265
9520517,9520512,TXFE7,128,9943,20,39909,20797,20276
9520517,9520516,TXFE7,128,9942,1,39910,20798,20277
9520529,9520517,TXFE7,128,9943,2,39912,20799,20279
9520542,9520530,TXFE7,128,9943,56,39968,20800,20309
9520579,9520568,TXFE7,128,9943,10,39978,20803,20310
9520592,9520582,TXFE7,128,9943,2,39980,20805,20311
9520604,9520592,TXFE7,128,9943,1,39981,20806,20312
9520604,9520604,TXFE7,128,9944,5,39986,20807,20313
9520629,9520618,TXFE7,129,9943,5,39996,20813,20314
9520629,9520618,TXFE7,129,9942,5,39996,20813,20314
9520629,9520623,TXFE7,128,9944,5,40001,20814,20315
9520654,9520645,TXFE7,128,9943,1,40002,20815,20316
9520667,9520664,TXFE7,128,9944,5,40007,20816,20317
9520679,9520678,TXFE7,128,9944,5,40012,20817,20318
9520704,9520697,TXFE7,128,9944,5,40017,20818,20319
9520729,9520721,TXFE7,128,9944,1,40018,20819,20320
9520729,9520722,TXFE7,128,9944,1,40019,20820,20321
9520729,9520724,TXFE7,128,9944,25,40044,20821,20340
9520792,9520784,TXFE7,128,9944,1,40045,20822,20341
9520992,9520981,TXFE7,128,9943,1,40046,20823,20342
9521129,9521118,TXFE7,128,9943,1,40047,20824,20343
9521154,9521147,TXFE7,128,9944,2,40049,20825,20345
9521167,9521156,TXFE7,128,9943,3,40052,20828,20346
9521204,9521193,TXFE7,128,9944,1,40053,20829,20347
9521204,9521198,TXFE7,128,9944,1,40054,20830,20348
9521217,9521206,TXFE7,128,9944,2,40056,20831,20349
9521254,9521249,TXFE7,128,9944,1,40057,20832,20350
9521254,9521253,TXFE7,128,9944,1,40058,20833,20351
9521267,9521255,TXFE7,128,9944,47,40105,20834,20379
9521279,9521267,TXFE7,128,9945,7,40112,20835,20384
9521292,9521280,TXFE7,128,9945,2,40114,20836,20386
9521292,9521280,TXFE7,128,9945,3,40117,20837,20389
9521292,9521282,TXFE7,128,9945,1,40118,20838,20390
9521292,9521282,TXFE7,128,9945,4,40122,20839,20394
9521292,9521283,TXFE7,128,9945,1,40123,20840,20395
9521292,9521287,TXFE7,128,9945,3,40126,20841,20398
9521292,9521288,TXFE7,128,9945,10,40136,20842,20403
9521292,9521289,TXFE7,128,9945,6,40142,20843,20407
9521292,9521292,TXFE7,128,9945,1,40143,20844,20408
9521304,9521292,TXFE7,128,9945,4,40147,20845,20411
9521304,9521292,TXFE7,128,9945,1,40148,20846,20412
9521304,9521299,TXFE7,128,9945,7,40155,20847,20417
9521317,9521304,TXFE7,128,9945,1,40156,20848,20418
9521317,9521317,TXFE7,128,9945,2,40158,20849,20420
9521329,9521325,TXFE7,128,9945,1,40159,20850,20421
9521342,9521338,TXFE7,128,9945,1,40160,20851,20422
9521354,9521350,TXFE7,128,9945,1,40161,20852,20423
9521367,9521355,TXFE7,128,9945,1,40162,20853,20424
9521367,9521357,TXFE7,128,9945,1,40163,20854,20425
9521367,9521358,TXFE7,128,9945,1,40164,20855,20426
9521367,9521360,TXFE7,128,9944,2,40166,20857,20427
9521367,9521365,TXFE7,128,9945,1,40167,20858,20428
9521379,9521369,TXFE7,128,9945,1,40168,20859,20429
9521379,9521374,TXFE7,128,9945,1,40169,20860,20430
9521442,9521434,TXFE7,128,9945,1,40170,20861,20431
9521479,9521471,TXFE7,128,9945,1,40171,20862,20432
9521529,9521518,TXFE7,128,9944,2,40173,20864,20433
9521592,9521589,TXFE7,128,9944,11,40184,20871,20434
9521617,9521606,TXFE7,128,9944,1,40185,20872,20435
9521667,9521664,TXFE7,128,9943,1,40186,20873,20436
9521754,9521754,TXFE7,128,9943,1,40187,20874,20437
9521779,9521767,TXFE7,128,9943,8,40195,20881,20438
9521804,9521797,TXFE7,128,9944,5,40200,20882,20440
9521829,9521820,TXFE7,128,9944,1,40201,20883,20441
9521867,9521865,TXFE7,128,9943,3,40204,20885,20442
9521904,9521898,TXFE7,128,9943,1,40205,20886,20443
9522017,9522014,TXFE7,128,9943,1,40206,20887,20444
9522067,9522058,TXFE7,128,9944,1,40207,20888,20445
9522092,9522084,TXFE7,128,9944,1,40208,20889,20446
9522129,9522117,TXFE7,128,9944,6,40214,20890,20448
9522154,9522142,TXFE7,128,9944,4,40218,20891,20451
9522167,9522155,TXFE7,128,9944,5,40223,20892,20452
9522304,9522300,TXFE7,128,9943,1,40224,20893,20453
9522379,9522377,TXFE7,128,9944,1,40225,20894,20454
9522429,9522418,TXFE7,128,9944,1,40226,20895,20455
9522492,9522489,TXFE7,128,9944,1,40227,20896,20456
9522654,9522646,TXFE7,128,9944,1,40228,20897,20457
9522767,9522758,TXFE7,128,9943,2,40230,20899,20458
9522842,9522832,TXFE7,128,9944,1,40231,20900,20459
9522967,9522957,TXFE7,128,9944,1,40232,20901,20460
9523029,9523029,TXFE7,128,9943,10,40242,20906,20461
9523067,9523062,TXFE7,128,9944,1,40243,20907,20462
9523154,9523143,TXFE7,128,9944,4,40247,20908,20466
9523467,9523455,TXFE7,128,9943,3,40250,20911,20467
9523504,9523492,TXFE7,128,9943,4,40254,20915,20468
9523504,9523501,TXFE7,128,9943,3,40257,20917,20469
9523542,9523537,TXFE7,128,9943,1,40258,20918,20470
9523554,9523552,TXFE7,128,9943,1,40259,20919,20471
9523804,9523803,TXFE7,128,9943,1,40260,20920,20472
9524042,9524035,TXFE7,128,9943,1,40261,20921,20473
9524067,9524061,TXFE7,128,9942,1,40262,20922,20474
9524117,9524109,TXFE7,128,9943,1,40263,20923,20475
9524242,9524230,TXFE7,128,9942,1,40264,20924,20476
9524367,9524364,TXFE7,128,9943,3,40267,20925,20477
9524379,9524378,TXFE7,128,9942,10,40277,20932,20478
9524704,9524698,TXFE7,128,9942,1,40278,20933,20479
9524729,9524723,TXFE7,128,9942,1,40279,20934,20480
9524742,9524732,TXFE7,128,9942,2,40281,20935,20481
9524967,9524964,TXFE7,128,9943,1,40282,20936,20482
9524979,9524967,TXFE7,128,9943,2,40284,20937,20483
9525129,9525118,TXFE7,128,9943,5,40289,20938,20487
9525179,9525173,TXFE7,128,9943,5,40294,20939,20489
9525229,9525229,TXFE7,128,9943,1,40295,20940,20490
9525342,9525342,TXFE7,128,9943,1,40296,20941,20491
9525504,9525492,TXFE7,128,9943,5,40301,20942,20495
9525529,9525523,TXFE7,128,9943,4,40305,20943,20496
9525554,9525542,TXFE7,128,9943,1,40306,20944,20497
9525892,9525883,TXFE7,128,9943,2,40308,20945,20498
9530067,9530065,TXFE7,128,9943,2,40310,20946,20499
9530117,9530108,TXFE7,128,9944,2,40312,20947,20500
9530129,9530117,TXFE7,128,9944,35,40347,20948,20518
9530142,9530129,TXFE7,128,9944,1,40348,20949,20519
9530154,9530144,TXFE7,128,9945,2,40350,20950,20521
9530167,9530166,TXFE7,128,9945,9,40359,20951,20529
9530179,9530168,TXFE7,128,9945,8,40367,20952,20534
9530179,9530169,TXFE7,128,9945,4,40371,20953,20537
9530179,9530176,TXFE7,128,9945,1,40372,20954,20538
9530179,9530177,TXFE7,128,9945,8,40380,20955,20546
9530204,9530192,TXFE7,128,9945,11,40391,20956,20554
9530204,9530200,TXFE7,128,9945,3,40394,20957,20557
9530217,9530204,TXFE7,128,9945,1,40395,20958,20558
9530217,9530212,TXFE7,128,9945,1,40396,20959,20559
9530229,9530229,TXFE7,128,9945,1,40397,20960,20560
9530254,9530245,TXFE7,128,9945,1,40398,20961,20561
9530267,9530261,TXFE7,128,9945,1,40399,20962,20562
9530279,9530272,TXFE7,128,9945,1,40400,20963,20563
9530292,9530280,TXFE7,128,9945,2,40402,20964,20565
9530517,9530514,TXFE7,128,9945,2,40404,20965,20566
9530529,9530518,TXFE7,128,9945,2,40406,20966,20568
9530592,9530591,TXFE7,128,9945,1,40407,20967,20569
9530717,9530714,TXFE7,128,9944,1,40408,20968,20570
9530892,9530885,TXFE7,128,9944,5,40413,20969,20571
9530917,9530916,TXFE7,128,9944,1,40414,20970,20572
9530929,9530917,TXFE7,128,9944,1,40415,20971,20573
9530992,9530981,TXFE7,128,9945,4,40419,20972,20577
9531004,9531002,TXFE7,128,9944,1,40420,20973,20578
9531017,9531014,TXFE7,128,9945,1,40421,20974,20579
9531042,9531042,TXFE7,128,9944,6,40427,20975,20581
9531154,9531143,TXFE7,128,9945,1,40428,20976,20582
9531179,9531174,TXFE7,128,9944,2,40430,20977,20583
9531192,9531186,TXFE7,128,9945,1,40431,20978,20584
9531192,9531191,TXFE7,128,9945,3,40434,20979,20587
9531254,9531252,TXFE7,128,9945,1,40435,20980,20588
9531304,9531300,TXFE7,128,9944,1,40436,20981,20589
9531392,9531387,TXFE7,128,9944,1,40437,20982,20590
9531629,9531626,TXFE7,128,9944,3,40440,20983,20591
9531642,9531639,TXFE7,128,9944,1,40441,20984,20592
9531679,9531668,TXFE7,128,9944,2,40443,20985,20593
9531692,9531680,TXFE7,128,9945,1,40444,20986,20594
9531742,9531735,TXFE7,128,9945,1,40445,20987,20595
9531767,9531759,TXFE7,128,9945,4,40449,20988,20599
9531804,9531804,TXFE7,128,9945,1,40450,20989,20600
9531842,9531833,TXFE7,128,9944,1,40451,20990,20601
9531904,9531898,TXFE7,128,9944,2,40453,20991,20602
9531992,9531984,TXFE7,128,9944,20,40473,20992,20603
9532042,9532037,TXFE7,128,9944,1,40474,20993,20604
9532092,9532082,TXFE7,128,9944,1,40475,20994,20605
9532092,9532084,TXFE7,128,9944,2,40477,20996,20606
9532117,9532114,TXFE7,129,9944,9,40497,21008,20607
9532117,9532114,TXFE7,129,9943,11,40497,21008,20607
9532129,9532127,TXFE7,128,9944,4,40501,21009,20608
9532179,9532169,TXFE7,128,9944,1,40502,21010,20609
9532304,9532297,TXFE7,128,9944,5,40507,21011,20611
9532354,9532347,TXFE7,128,9944,4,40511,21012,20613
9532354,9532353,TXFE7,128,9944,1,40512,21013,20614
9532479,9532467,TXFE7,128,9943,1,40513,21014,20615
9532492,9532487,TXFE7,128,9944,2,40515,21015,20616
9532579,9532568,TXFE7,128,9944,1,40516,21016,20617
9532629,9532628,TXFE7,128,9943,1,40517,21017,20618
9532754,9532749,TXFE7,128,9944,1,40518,21018,20619
9532917,9532904,TXFE7,128,9944,1,40519,21019,20620
9532992,9532985,TXFE7,128,9944,1,40520,21020,20621
9533279,9533276,TXFE7,128,9943,5,40525,21022,20622
9533392,9533390,TXFE7,128,9943,1,40526,21023,20623
9533592,9533584,TXFE7,128,9944,1,40527,21024,20624
9533642,9533633,TXFE7,128,9944,1,40528,21025,20625
9533717,9533716,TXFE7,128,9943,1,40529,21026,20626
9533742,9533737,TXFE7,128,9943,10,40539,21028,20627
9533754,9533747,TXFE7,128,9944,1,40540,21029,20628
9533754,9533750,TXFE7,128,9943,1,40541,21030,20629
9533804,9533793,TXFE7,128,9943,1,40542,21031,20630
9533867,9533856,TXFE7,128,9943,1,40543,21032,20631
9534329,9534324,TXFE7,128,9943,2,40545,21033,20632
9534429,9534427,TXFE7,128,9943,2,40547,21035,20633
9534492,9534489,TXFE7,128,9943,2,40549,21037,20634
9534492,9534490,TXFE7,128,9943,1,40550,21038,20635
9535017,9535013,TXFE7,128,9944,1,40551,21039,20636
9535192,9535190,TXFE7,128,9944,1,40552,21040,20637
9535317,9535314,TXFE7,128,9944,4,40556,21041,20640
9535329,9535326,TXFE7,128,9944,1,40557,21042,20641
9535379,9535369,TXFE7,128,9943,3,40560,21045,20642
9535417,9535417,TXFE7,128,9944,1,40561,21046,20643
9535542,9535537,TXFE7,128,9944,2,40563,21047,20644
9535554,9535544,TXFE7,128,9944,1,40564,21048,20645
9535692,9535683,TXFE7,128,9944,5,40569,21049,20650
9535704,9535693,TXFE7,128,9943,2,40571,21051,20651
9535767,9535759,TXFE7,128,9944,1,40572,21052,20652
9535792,9535788,TXFE7,128,9944,2,40574,21053,20654
9535817,9535817,TXFE7,128,9943,6,40580,21057,20655
9535842,9535832,TXFE7,128,9944,2,40582,21058,20657
9535892,9535891,TXFE7,128,9944,1,40583,21059,20658
9535904,9535898,TXFE7,128,9944,2,40585,21060,20660
9535954,9535942,TXFE7,128,9944,15,40600,21061,20672
9535992,9535980,TXFE7,128,9944,2,40602,21062,20673
9540042,9540042,TXFE7,128,9945,1,40603,21063,20674
9540079,9540067,TXFE7,128,9945,5,40608,21064,20677
9540079,9540069,TXFE7,128,9945,2,40610,21065,20679
9540092,9540084,TXFE7,128,9945,15,40625,21066,20692
9540092,9540084,TXFE7,128,9945,2,40627,21067,20693
9540092,9540088,TXFE7,128,9945,1,40628,21068,20694
9540104,9540092,TXFE7,128,9945,1,40629,21069,20695
9540104,9540092,TXFE7,128,9945,5,40634,21070,20697
9540104,9540092,TXFE7,128,9945,1,40635,21071,20698
9540104,9540092,TXFE7,128,9945,1,40636,21072,20699
9540117,9540113,TXFE7,128,9945,1,40637,21073,20700
9540129,9540126,TXFE7,128,9945,1,40638,21074,20701
9540142,9540132,TXFE7,128,9945,5,40643,21075,20702
9540142,9540134,TXFE7,128,9945,21,40664,21076,20709
9540154,9540142,TXFE7,128,9945,6,40670,21077,20712
9540154,9540142,TXFE7,128,9945,1,40671,21078,20713
9540154,9540142,TXFE7,128,9945,4,40675,21079,20715
9540154,9540142,TXFE7,128,9945,4,40679,21080,20719
9540154,9540142,TXFE7,128,9945,2,40681,21081,20721
9540154,9540142,TXFE7,128,9945,9,40690,21082,20725
9540154,9540142,TXFE7,128,9945,1,40691,21083,20726
9540154,9540142,TXFE7,128,9945,1,40692,21084,20727
9540154,9540142,TXFE7,128,9945,4,40696,21085,20728
9540154,9540142,TXFE7,128,9945,5,40701,21086,20732
9540167,9540159,TXFE7,128,9946,5,40706,21087,20737
9540179,9540167,TXFE7,128,9946,4,40710,21088,20741
9540179,9540167,TXFE7,128,9946,1,40711,21089,20742
9540179,9540168,TXFE7,128,9946,12,40723,21090,20754
9540179,9540170,TXFE7,128,9946,3,40726,21091,20755
9540179,9540171,TXFE7,128,9946,1,40727,21092,20756
9540179,9540171,TXFE7,128,9946,1,40728,21093,20757
9540179,9540171,TXFE7,128,9946,1,40729,21094,20758
9540179,9540171,TXFE7,128,9946,1,40730,21095,20759
9540179,9540172,TXFE7,128,9946,2,40732,21096,20761
9540179,9540172,TXFE7,128,9946,5,40737,21097,20763
9540179,9540172,TXFE7,128,9945,3,40740,21100,20764
9540179,9540173,TXFE7,128,9946,1,40741,21101,20765
9540179,9540173,TXFE7,128,9946,1,40742,21102,20766
9540179,9540174,TXFE7,128,9946,2,40744,21103,20768
9540179,9540174,TXFE7,128,9946,8,40752,21104,20775
9540179,9540175,TXFE7,128,9946,5,40757,21105,20779
9540179,9540177,TXFE7,128,9946,5,40762,21106,20782
9540179,9540178,TXFE7,128,9945,2,40764,21107,20783
9540179,9540179,TXFE7,128,9945,1,40765,21108,20784
9540179,9540179,TXFE7,128,9946,2,40767,21109,20785
9540179,9540179,TXFE7,128,9946,1,40768,21110,20786
9540192,9540180,TXFE7,128,9946,1,40769,21111,20787
9540192,9540181,TXFE7,128,9946,1,40770,21112,20788
9540192,9540183,TXFE7,128,9946,3,40773,21113,20789
9540192,9540187,TXFE7,128,9945,1,40774,21114,20790
9540192,9540187,TXFE7,128,9946,3,40777,21115,20791
9540192,9540187,TXFE7,128,9946,3,40780,21116,20792
9540192,9540192,TXFE7,128,9946,12,40792,21117,20793
9540204,9540192,TXFE7,128,9946,1,40793,21118,20794
9540204,9540194,TXFE7,128,9946,2,40795,21119,20795
9540204,9540194,TXFE7,128,9946,16,40811,21120,20802
9540204,9540194,TXFE7,128,9945,3,40814,21121,20803
9540204,9540195,TXFE7,128,9946,2,40816,21122,20804
9540204,9540198,TXFE7,128,9945,6,40822,21124,20805
9540204,9540199,TXFE7,128,9946,1,40823,21125,20806
9540204,9540199,TXFE7,128,9945,1,40824,21126,20807
9540217,9540204,TXFE7,128,9946,1,40825,21127,20808
9540217,9540205,TXFE7,128,9946,4,40829,21128,20809
9540217,9540206,TXFE7,128,9946,1,40830,21129,20810
9540217,9540206,TXFE7,128,9946,4,40834,21130,20813
9540217,9540206,TXFE7,128,9946,2,40836,21131,20815
9540217,9540212,TXFE7,128,9946,1,40837,21132,20816
9540229,9540219,TXFE7,128,9946,2,40839,21133,20818
9540229,9540224,TXFE7,128,9946,1,40840,21134,20819
9540242,9540231,TXFE7,128,9946,2,40842,21135,20821
9540242,9540231,TXFE7,128,9946,1,40843,21136,20822
9540242,9540241,TXFE7,128,9946,1,40844,21137,20823
9540267,9540263,TXFE7,128,9946,1,40845,21138,20824
9540267,9540263,TXFE7,128,9946,8,40853,21139,20825
9540279,9540267,TXFE7,128,9946,18,40871,21140,20828
9540292,9540288,TXFE7,128,9946,2,40873,21141,20830
9540317,9540312,TXFE7,128,9946,2,40875,21142,20831
9540317,9540313,TXFE7,128,9946,6,40881,21143,20833
9540342,9540333,TXFE7,128,9946,1,40882,21144,20834
9540379,9540378,TXFE7,128,9946,1,40883,21145,20835
9540404,9540392,TXFE7,128,9946,2,40885,21146,20837
9540417,9540412,TXFE7,128,9946,4,40889,21147,20840
9540479,9540477,TXFE7,128,9945,1,40890,21148,20841
9540492,9540490,TXFE7,128,9946,2,40892,21149,20843
9540542,9540529,TXFE7,128,9946,1,40893,21150,20844
9540567,9540555,TXFE7,128,9945,3,40896,21153,20845
9540642,9540636,TXFE7,128,9946,1,40897,21154,20846
9540729,9540721,TXFE7,128,9946,1,40898,21155,20847
9540779,9540769,TXFE7,128,9946,2,40900,21156,20848
9540804,9540795,TXFE7,128,9946,1,40901,21157,20849
9540829,9540824,TXFE7,128,9946,1,40902,21158,20850
9540842,9540830,TXFE7,128,9946,1,40903,21159,20851
9540879,9540879,TXFE7,128,9946,1,40904,21160,20852
9540892,9540880,TXFE7,128,9946,1,40905,21161,20853
9540892,9540884,TXFE7,128,9946,5,40910,21162,20858
9540904,9540896,TXFE7,129,9946,20,40931,21163,20874
9540904,9540896,TXFE7,129,9947,1,40931,21163,20874
9540917,9540908,TXFE7,128,9947,2,40933,21164,20875
9540917,9540908,TXFE7,128,9947,2,40935,21165,20876
9540917,9540909,TXFE7,128,9947,1,40936,21166,20877
9540917,9540909,TXFE7,128,9947,1,40937,21167,20878
9540917,9540910,TXFE7,128,9947,4,40941,21168,20879
9540917,9540910,TXFE7,128,9947,1,40942,21169,20880
9540917,9540910,TXFE7,128,9947,1,40943,21170,20881
9540929,9540919,TXFE7,128,9947,2,40945,21171,20883
9540929,9540922,TXFE7,128,9947,2,40947,21172,20884
9540929,9540927,TXFE7,128,9947,1,40948,21173,20885
9540929,9540929,TXFE7,128,9947,2,40950,21174,20886
9540929,9540929,TXFE7,128,9947,2,40952,21175,20888
9540942,9540931,TXFE7,128,9947,3,40955,21176,20890
9540942,9540936,TXFE7,128,9947,1,40956,21177,20891
9540954,9540948,TXFE7,128,9946,1,40957,21178,20892
9540979,9540971,TXFE7,128,9947,1,40958,21179,20893
9541004,9540994,TXFE7,128,9947,4,40962,21180,20895
9541029,9541028,TXFE7,128,9947,1,40963,21181,20896
9541042,9541035,TXFE7,128,9947,2,40965,21182,20898
9541067,9541060,TXFE7,128,9946,4,40969,21183,20899
9541079,9541071,TXFE7,128,9947,2,40971,21184,20900
9541079,9541072,TXFE7,128,9947,2,40973,21185,20902
9541079,9541072,TXFE7,128,9947,2,40975,21186,20904
9541079,9541074,TXFE7,128,9947,2,40977,21187,20905
9541079,9541074,TXFE7,128,9947,1,40978,21188,20906
9541079,9541075,TXFE7,128,9947,1,40979,21189,20907
9541079,9541076,TXFE7,128,9947,2,40981,21190,20908
9541079,9541077,TXFE7,128,9947,2,40983,21191,20910
9541092,9541080,TXFE7,128,9947,2,40985,21192,20911
9541092,9541080,TXFE7,128,9947,2,40987,21193,20913
9541117,9541112,TXFE7,128,9947,1,40988,21194,20914
9541117,9541113,TXFE7,128,9947,8,40996,21195,20916
9541179,9541168,TXFE7,128,9947,1,40997,21196,20917
9541242,9541234,TXFE7,128,9947,6,41003,21197,20918
9541254,9541250,TXFE7,128,9947,1,41004,21198,20919
9541254,9541250,TXFE7,128,9947,1,41005,21199,20920
9541292,9541280,TXFE7,128,9947,2,41007,21200,20921
9541304,9541300,TXFE7,128,9947,42,41049,21201,20934
9541342,9541338,TXFE7,128,9947,1,41050,21202,20935
9541367,9541356,TXFE7,128,9947,5,41055,21203,20936
9541392,9541380,TXFE7,128,9947,1,41056,21204,20937
9541392,9541387,TXFE7,128,9947,17,41073,21205,20953
9541404,9541392,TXFE7,128,9947,1,41074,21206,20954
9541404,9541393,TXFE7,128,9947,1,41075,21207,20955
9541417,9541415,TXFE7,128,9947,1,41076,21208,20956
9541429,9541422,TXFE7,128,9947,2,41078,21209,20957
9541429,9541426,TXFE7,128,9947,2,41080,21210,20958
9541442,9541430,TXFE7,128,9947,2,41082,21211,20959
9541442,9541436,TXFE7,128,9947,2,41084,21212,20961
9541442,9541441,TXFE7,128,9947,1,41085,21213,20962
9541454,9541442,TXFE7,128,9947,4,41089,21214,20965
9541467,9541454,TXFE7,128,9947,1,41090,21215,20966
9541467,9541455,TXFE7,128,9947,2,41092,21216,20968
9541467,9541461,TXFE7,128,9947,4,41096,21217,20969
9541479,9541467,TXFE7,128,9947,5,41101,21218,20974
9541479,9541468,TXFE7,129,9947,1,41103,21219,20976
9541479,9541468,TXFE7,129,9948,1,41103,21219,20976
9541492,9541483,TXFE7,128,9948,10,41113,21220,20978
9541492,9541483,TXFE7,128,9948,1,41114,21221,20979
9541492,9541483,TXFE7,128,9948,1,41115,21222,20980
9541492,9541484,TXFE7,128,9948,1,41116,21223,20981
9541492,9541484,TXFE7,128,9948,2,41118,21224,20983
9541492,9541487,TXFE7,128,9948,1,41119,21225,20984
9541492,9541488,TXFE7,128,9948,1,41120,21226,20985
9541492,9541489,TXFE7,128,9948,5,41125,21227,20990
9541504,9541492,TXFE7,128,9948,1,41126,21228,20991
9541504,9541493,TXFE7,128,9948,1,41127,21229,20992
9541504,9541493,TXFE7,128,9948,1,41128,21230,20993
9541504,9541493,TXFE7,128,9948,2,41130,21231,20995
9541504,9541494,TXFE7,128,9948,1,41131,21232,20996
9541504,9541494,TXFE7,128,9948,2,41133,21233,20998
9541504,9541495,TXFE7,128,9948,3,41136,21234,20999
9541504,9541496,TXFE7,128,9948,1,41137,21235,21000
9541504,9541496,TXFE7,128,9948,1,41138,21236,21001
9541504,9541497,TXFE7,128,9948,1,41139,21237,21002
9541504,9541497,TXFE7,128,9948,1,41140,21238,21003
9541504,9541499,TXFE7,128,9948,1,41141,21239,21004
9541504,9541500,TXFE7,128,9948,1,41142,21240,21005
9541504,9541500,TXFE7,128,9948,1,41143,21241,21006
9541504,9541503,TXFE7,128,9947,10,41153,21247,21007
9541517,9541505,TXFE7,128,9948,2,41155,21248,21009
9541517,9541505,TXFE7,128,9948,2,41157,21249,21011
9541517,9541508,TXFE7,128,9948,1,41158,21250,21012
9541517,9541509,TXFE7,128,9948,1,41159,21251,21013
9541517,9541509,TXFE7,128,9948,1,41160,21252,21014
9541517,9541509,TXFE7,128,9947,2,41162,21253,21015
9541517,9541510,TXFE7,128,9948,1,41163,21254,21016
9541517,9541513,TXFE7,128,9948,1,41164,21255,21017
9541517,9541513,TXFE7,128,9948,1,41165,21256,21018
9541517,9541513,TXFE7,128,9948,1,41166,21257,21019
9541517,9541514,TXFE7,128,9948,1,41167,21258,21020
9541517,9541514,TXFE7,128,9948,1,41168,21259,21021
9541529,9541521,TXFE7,128,9948,1,41169,21260,21022
9541529,9541523,TXFE7,128,9948,1,41170,21261,21023
9541529,9541523,TXFE7,128,9948,1,41171,21262,21024
9541567,9541555,TXFE7,128,9947,5,41176,21264,21025
9541567,9541558,TXFE7,128,9948,2,41178,21265,21027
9541579,9541575,TXFE7,128,9948,2,41180,21266,21028
9541579,9541575,TXFE7,128,9948,2,41182,21267,21030
9541579,9541576,TXFE7,128,9948,2,41184,21268,21032
9541579,9541578,TXFE7,128,9948,2,41186,21269,21034
9541579,9541578,TXFE7,128,9948,2,41188,21270,21035
9541592,9541580,TXFE7,128,9947,1,41189,21271,21036
9541592,9541583,TXFE7,128,9948,2,41191,21272,21037
9541592,9541589,TXFE7,128,9947,2,41193,21273,21038
9541604,9541604,TXFE7,128,9947,1,41194,21274,21039
9541629,9541629,TXFE7,128,9947,9,41203,21280,21040
9541654,9541642,TXFE7,128,9947,1,41204,21281,21041
9541654,9541653,TXFE7,128,9948,1,41205,21282,21042
9541679,9541678,TXFE7,128,9947,1,41206,21283,21043
9541704,9541692,TXFE7,128,9946,4,41210,21287,21044
9541704,9541692,TXFE7,128,9946,2,41212,21289,21045
9541729,9541718,TXFE7,128,9947,1,41213,21290,21046
9541742,9541742,TXFE7,128,9947,1,41214,21291,21047
9541754,9541746,TXFE7,128,9947,2,41216,21292,21048
9541817,9541806,TXFE7,128,9947,1,41217,21293,21049
9541829,9541822,TXFE7,128,9946,3,41220,21294,21050
9541929,9541920,TXFE7,128,9946,1,41221,21295,21051
9541979,9541975,TXFE7,128,9947,2,41223,21296,21052
9541992,9541985,TXFE7,128,9946,1,41224,21297,21053
9542017,9542014,TXFE7,128,9947,1,41225,21298,21054
9542067,9542060,TXFE7,128,9947,1,41226,21299,21055
9542079,9542079,TXFE7,128,9947,2,41228,21300,21057
9542117,9542111,TXFE7,128,9947,4,41232,21301,21058
9542142,9542135,TXFE7,128,9946,1,41233,21302,21059
9542229,9542228,TXFE7,128,9947,1,41234,21303,21060
9542329,9542323,TXFE7,128,9947,1,41235,21304,21061
9542379,9542368,TXFE7,128,9947,2,41237,21305,21062
9542442,9542441,TXFE7,128,9947,5,41242,21306,21065
9542467,9542464,TXFE7,128,9947,1,41243,21307,21066
9542479,9542476,TXFE7,128,9947,1,41244,21308,21067
9542504,9542499,TXFE7,128,9947,1,41245,21309,21068
9542504,9542499,TXFE7,128,9947,1,41246,21310,21069
9542504,9542501,TXFE7,128,9947,1,41247,21311,21070
9542504,9542501,TXFE7,128,9947,1,41248,21312,21071
9542504,9542503,TXFE7,128,9947,1,41249,21313,21072
9542504,9542504,TXFE7,128,9947,1,41250,21314,21073
9542517,9542504,TXFE7,128,9947,1,41251,21315,21074
9542517,9542506,TXFE7,128,9947,1,41252,21316,21075
9542517,9542507,TXFE7,128,9947,1,41253,21317,21076
9542554,9542543,TXFE7,128,9947,2,41255,21318,21077
9542592,9542591,TXFE7,128,9947,2,41257,21319,21079
9542654,9542650,TXFE7,128,9947,1,41258,21320,21080
9542717,9542708,TXFE7,128,9946,1,41259,21321,21081
9542779,9542779,TXFE7,128,9947,1,41260,21322,21082
9542804,9542795,TXFE7,128,9947,1,41261,21323,21083
9542879,9542871,TXFE7,128,9946,1,41262,21324,21084
9542929,9542926,TXFE7,128,9947,2,41264,21325,21086
9542942,9542942,TXFE7,128,9947,1,41265,21326,21087
9542979,9542977,TXFE7,128,9946,15,41280,21339,21088
9542992,9542979,TXFE7,128,9946,11,41291,21345,21089
9542992,9542990,TXFE7,128,9946,1,41292,21346,21090
9543004,9542992,TXFE7,128,9946,2,41294,21348,21091
9543004,9542992,TXFE7,128,9946,8,41302,21353,21092
9543004,9542992,TXFE7,128,9946,6,41308,21355,21093
9543004,9542992,TXFE7,128,9946,4,41312,21358,21094
9543017,9543005,TXFE7,128,9946,1,41313,21359,21095
9543017,9543005,TXFE7,128,9946,1,41314,21360,21096
9543017,9543008,TXFE7,128,9946,1,41315,21361,21097
9543017,9543010,TXFE7,128,9946,1,41316,21362,21098
9543129,9543118,TXFE7,128,9945,1,41317,21363,21099
9543217,9543210,TXFE7,128,9945,1,41318,21364,21100
9543229,9543217,TXFE7,128,9945,5,41323,21368,21101
9543242,9543230,TXFE7,128,9945,1,41324,21369,21102
9543242,9543232,TXFE7,128,9945,2,41326,21370,21103
9543279,9543274,TXFE7,128,9945,2,41328,21372,21104
9543292,9543287,TXFE7,128,9945,5,41333,21377,21105
9543317,9543312,TXFE7,128,9945,1,41334,21378,21106
9543329,9543326,TXFE7,128,9945,2,41336,21380,21107
9543354,9543352,TXFE7,128,9946,1,41337,21381,21108
9543367,9543357,TXFE7,128,9945,1,41338,21382,21109
9543392,9543390,TXFE7,128,9946,1,41339,21383,21110
9543417,9543414,TXFE7,128,9945,1,41340,21384,21111
9543542,9543541,TXFE7,128,9945,1,41341,21385,21112
9543654,9543643,TXFE7,128,9945,1,41342,21386,21113
9543679,9543674,TXFE7,128,9946,1,41343,21387,21114
9543692,9543684,TXFE7,128,9945,2,41345,21389,21115
9543767,9543761,TXFE7,128,9946,1,41346,21390,21116
9543779,9543773,TXFE7,128,9945,4,41350,21393,21117
9543792,9543780,TXFE7,128,9945,2,41352,21395,21118
9543979,9543976,TXFE7,128,9946,1,41353,21396,21119
9544004,9543997,TXFE7,128,9945,1,41354,21397,21120
9544017,9544016,TXFE7,128,9945,1,41355,21398,21121
9544054,9544049,TXFE7,128,9945,1,41356,21399,21122
9544079,9544074,TXFE7,128,9946,1,41357,21400,21123
9544104,9544093,TXFE7,128,9946,3,41360,21401,21125
9544129,9544127,TXFE7,128,9946,1,41361,21402,21126
9544317,9544314,TXFE7,128,9946,1,41362,21403,21127
9544354,9544350,TXFE7,128,9946,1,41363,21404,21128
9544467,9544459,TXFE7,128,9945,2,41365,21405,21129
9544517,9544513,TXFE7,128,9946,1,41366,21406,21130
9544579,9544572,TXFE7,128,9946,1,41367,21407,21131
9544617,9544614,TXFE7,128,9945,3,41370,21409,21132
9544629,9544628,TXFE7,128,9946,2,41372,21410,21134
9544654,9544644,TXFE7,128,9945,2,41374,21411,21135
9544667,9544661,TXFE7,128,9946,1,41375,21412,21136
9544704,9544701,TXFE7,128,9946,5,41380,21413,21141
9544717,9544713,TXFE7,128,9946,1,41381,21414,21142
9544842,9544840,TXFE7,128,9946,1,41382,21415,21143
9544917,9544914,TXFE7,128,9945,1,41383,21416,21144
9545004,9544993,TXFE7,128,9945,1,41384,21417,21145
9545017,9545005,TXFE7,128,9945,1,41385,21418,21146
9545029,9545024,TXFE7,128,9945,2,41387,21419,21147
9545042,9545040,TXFE7,128,9945,1,41388,21420,21148
9545067,9545059,TXFE7,128,9945,1,41389,21421,21149
9545067,9545059,TXFE7,128,9945,1,41390,21422,21150
9545067,9545059,TXFE7,128,9945,3,41393,21424,21151
9545079,9545067,TXFE7,128,9945,1,41394,21425,21152
9545079,9545067,TXFE7,128,9945,2,41396,21427,21153
9545079,9545072,TXFE7,128,9945,6,41402,21429,21154
9545079,9545076,TXFE7,128,9945,2,41404,21430,21155
9545092,9545079,TXFE7,128,9945,1,41405,21431,21156
9545092,9545084,TXFE7,128,9945,1,41406,21432,21157
9545092,9545084,TXFE7,128,9945,3,41409,21433,21158
9545092,9545084,TXFE7,128,9945,5,41414,21434,21159
9545092,9545084,TXFE7,128,9945,1,41415,21435,21160
9545092,9545090,TXFE7,128,9945,1,41416,21436,21161
9545104,9545092,TXFE7,128,9945,6,41422,21439,21162
9545104,9545092,TXFE7,128,9945,1,41423,21440,21163
9545104,9545092,TXFE7,128,9945,2,41425,21442,21164
9545104,9545092,TXFE7,128,9945,2,41427,21444,21165
9545104,9545092,TXFE7,128,9945,5,41432,21447,21166
9545104,9545092,TXFE7,128,9945,1,41433,21448,21167
9545104,9545092,TXFE7,128,9945,2,41435,21450,21168
9545104,9545092,TXFE7,128,9945,4,41439,21454,21169
9545117,9545107,TXFE7,128,9944,1,41440,21455,21170
9545117,9545112,TXFE7,128,9945,15,41455,21456,21177
9545142,9545140,TXFE7,128,9945,3,41458,21457,21178
9545154,9545143,TXFE7,128,9944,1,41459,21458,21179
9545154,9545148,TXFE7,128,9945,1,41460,21459,21180
9545279,9545267,TXFE7,128,9944,1,41461,21460,21181
9545304,9545293,TXFE7,128,9944,3,41464,21461,21182
9545304,9545304,TXFE7,128,9944,8,41472,21469,21183
9545317,9545314,TXFE7,128,9944,1,41473,21470,21184
9545329,9545325,TXFE7,128,9945,2,41475,21471,21185
9545354,9545354,TXFE7,128,9944,3,41478,21472,21186
9545467,9545460,TXFE7,128,9945,1,41479,21473,21187
9545704,9545700,TXFE7,128,9944,1,41480,21474,21188
9545717,9545706,TXFE7,128,9945,1,41481,21475,21189
9545767,9545763,TXFE7,128,9944,1,41482,21476,21190
9545804,9545799,TXFE7,128,9944,2,41484,21478,21191
9545804,9545802,TXFE7,128,9945,2,41486,21479,21192
9545817,9545814,TXFE7,128,9944,1,41487,21480,21193
9545842,9545838,TXFE7,128,9945,2,41489,21481,21194
9545879,9545878,TXFE7,128,9944,2,41491,21483,21195
9545942,9545940,TXFE7,128,9945,1,41492,21484,21196
9550092,9550084,TXFE7,128,9944,1,41493,21485,21197
9550104,9550097,TXFE7,128,9945,1,41494,21486,21198
9550129,9550118,TXFE7,128,9945,4,41498,21487,21202
9550142,9550130,TXFE7,128,9945,4,41502,21488,21206
9550142,9550142,TXFE7,128,9944,6,41508,21489,21207
9550154,9550146,TXFE7,128,9945,2,41510,21490,21209
9550167,9550157,TXFE7,128,9944,6,41516,21493,21210
9550167,9550160,TXFE7,128,9945,2,41518,21494,21211
9550179,9550170,TXFE7,128,9945,2,41520,21495,21213
9550179,9550171,TXFE7,128,9945,1,41521,21496,21214
9550192,9550191,TXFE7,128,9945,1,41522,21497,21215
9550217,9550210,TXFE7,128,9944,6,41528,21499,21216
9550217,9550210,TXFE7,128,9945,5,41533,21500,21217
9550217,9550212,TXFE7,128,9945,3,41536,21501,21219
9550229,9550223,TXFE7,128,9944,6,41542,21505,21220
9550242,9550234,TXFE7,128,9944,6,41548,21510,21221
9550254,9550247,TXFE7,128,9945,5,41553,21511,21225
9550267,9550264,TXFE7,128,9945,1,41554,21512,21226
9550342,9550331,TXFE7,128,9944,1,41555,21513,21227
9550379,9550372,TXFE7,128,9944,1,41556,21514,21228
9550454,9550447,TXFE7,128,9944,5,41561,21518,21229
9550467,9550455,TXFE7,128,9944,3,41564,21521,21230
9550467,9550457,TXFE7,128,9944,5,41569,21526,21231
9550492,9550480,TXFE7,128,9944,1,41570,21527,21232
9550517,9550512,TXFE7,128,9944,1,41571,21528,21233
9550579,9550579,TXFE7,128,9943,1,41572,21529,21234
9550604,9550602,TXFE7,128,9943,1,41573,21530,21235
9550617,9550608,TXFE7,128,9944,1,41574,21531,21236
9550629,9550624,TXFE7,128,9943,1,41575,21532,21237
9550642,9550631,TXFE7,128,9944,2,41577,21533,21239
9550642,9550638,TXFE7,128,9943,1,41578,21534,21240
9550654,9550652,TXFE7,128,9944,1,41579,21535,21241
9550667,9550656,TXFE7,128,9943,1,41580,21536,21242
9550679,9550669,TXFE7,128,9944,1,41581,21537,21243
9550679,9550672,TXFE7,128,9943,1,41582,21538,21244
9550679,9550673,TXFE7,128,9943,2,41584,21540,21245
9550692,9550689,TXFE7,128,9943,1,41585,21541,21246
9550767,9550758,TXFE7,128,9944,1,41586,21542,21247
9550779,9550777,TXFE7,128,9944,1,41587,21543,21248
9550842,9550837,TXFE7,128,9943,1,41588,21544,21249
9550992,9550988,TXFE7,128,9943,1,41589,21545,21250
9551017,9551016,TXFE7,128,9944,2,41591,21546,21252
9551029,9551028,TXFE7,128,9943,1,41592,21547,21253
9551054,9551052,TXFE7,128,9943,1,41593,21548,21254
9551154,9551146,TXFE7,128,9944,1,41594,21549,21255
9551179,9551171,TXFE7,128,9943,1,41595,21550,21256
9551179,9551174,TXFE7,128,9943,1,41596,21551,21257
9551192,9551190,TXFE7,128,9943,1,41597,21552,21258
9551204,9551192,TXFE7,128,9943,2,41599,21553,21259
9551204,9551194,TXFE7,128,9943,1,41600,21554,21260
9551404,9551404,TXFE7,128,9943,1,41601,21555,21261
9551467,9551455,TXFE7,128,9943,1,41602,21556,21262
9551617,9551608,TXFE7,128,9943,5,41607,21559,21263
9551617,9551616,TXFE7,128,9943,1,41608,21560,21264
9551792,9551787,TXFE7,128,9943,2,41610,21561,21265
9551804,9551793,TXFE7,128,9944,2,41612,21562,21267
9551879,9551870,TXFE7,128,9943,1,41613,21563,21268
9552092,9552082,TXFE7,128,9943,1,41614,21564,21269
9552217,9552207,TXFE7,128,9943,2,41616,21565,21270
9552354,9552349,TXFE7,128,9943,1,41617,21566,21271
9552392,9552380,TXFE7,128,9944,1,41618,21567,21272
9552442,9552430,TXFE7,128,9943,1,41619,21568,21273
9552529,9552518,TXFE7,128,9943,1,41620,21569,21274
9552542,9552539,TXFE7,128,9943,2,41622,21571,21275
9552554,9552542,TXFE7,128,9944,1,41623,21572,21276
9552642,9552638,TXFE7,128,9943,1,41624,21573,21277
9552904,9552898,TXFE7,128,9944,1,41625,21574,21278
9552967,9552955,TXFE7,128,9944,2,41627,21575,21280
9553167,9553155,TXFE7,128,9944,1,41628,21576,21281
9553229,9553228,TXFE7,128,9944,1,41629,21577,21282
9553254,9553253,TXFE7,128,9944,9,41638,21578,21286
9553267,9553262,TXFE7,128,9944,1,41639,21579,21287
9553329,9553323,TXFE7,128,9944,1,41640,21580,21288
9553379,9553370,TXFE7,128,9944,1,41641,21581,21289
9553692,9553688,TXFE7,128,9943,1,41642,21582,21290
9553704,9553704,TXFE7,128,9943,1,41643,21583,21291
9553717,9553716,TXFE7,128,9943,1,41644,21584,21292
9553729,9553721,TXFE7,128,9944,2,41646,21585,21294
9553729,9553728,TXFE7,128,9943,1,41647,21586,21295
9553742,9553741,TXFE7,128,9943,1,41648,21587,21296
9553779,9553767,TXFE7,128,9943,37,41685,21611,21297
9553792,9553784,TXFE7,128,9942,3,41688,21614,21298
9553804,9553797,TXFE7,128,9942,1,41689,21615,21299
9553842,9553837,TXFE7,128,9942,3,41692,21618,21300
9553892,9553883,TXFE7,128,9942,1,41693,21619,21301
9553892,9553885,TXFE7,128,9943,1,41694,21620,21302
9553892,9553887,TXFE7,128,9942,3,41697,21622,21303
9553892,9553891,TXFE7,128,9942,1,41698,21623,21304
9553904,9553893,TXFE7,128,9942,21,41719,21635,21305
9553904,9553899,TXFE7,128,9943,10,41729,21636,21307
9553917,9553904,TXFE7,128,9942,9,41738,21644,21308
9553954,9553947,TXFE7,128,9941,1,41739,21645,21309
9553967,9553960,TXFE7,128,9942,1,41740,21646,21310
9553979,9553970,TXFE7,128,9942,1,41741,21647,21311
9553979,9553975,TXFE7,128,9942,1,41742,21648,21312
9554004,9553998,TXFE7,128,9942,1,41743,21649,21313
9554004,9554004,TXFE7,128,9942,8,41751,21652,21314
9554017,9554016,TXFE7,128,9942,1,41752,21653,21315
9554029,9554024,TXFE7,128,9942,1,41753,21654,21316
9554079,9554074,TXFE7,128,9942,1,41754,21655,21317
9554092,9554082,TXFE7,128,9941,1,41755,21656,21318
9554129,9554129,TXFE7,128,9942,1,41756,21657,21319
9554154,9554143,TXFE7,128,9942,1,41757,21658,21320
9554267,9554266,TXFE7,128,9942,1,41758,21659,21321
9554304,9554294,TXFE7,128,9942,2,41760,21660,21322
9554317,9554306,TXFE7,128,9942,1,41761,21661,21323
9554429,9554424,TXFE7,128,9942,1,41762,21662,21324
9554429,9554428,TXFE7,128,9942,1,41763,21663,21325
9554442,9554435,TXFE7,128,9942,2,41765,21664,21326
9554454,9554452,TXFE7,128,9942,1,41766,21665,21327
9554467,9554464,TXFE7,128,9942,1,41767,21666,21328
9554492,9554482,TXFE7,128,9942,1,41768,21667,21329
9554517,9554504,TXFE7,128,9942,5,41773,21669,21330
9554529,9554528,TXFE7,128,9942,1,41774,21670,21331
9554592,9554590,TXFE7,128,9942,6,41780,21671,21334
9554592,9554590,TXFE7,128,9942,1,41781,21672,21335
9554604,9554595,TXFE7,128,9942,1,41782,21673,21336
9554754,9554747,TXFE7,128,9942,1,41783,21674,21337
9554804,9554793,TXFE7,128,9942,5,41788,21675,21342
9554817,9554804,TXFE7,128,9942,1,41789,21676,21343
9554817,9554804,TXFE7,128,9942,1,41790,21677,21344
9554829,9554824,TXFE7,128,9942,2,41792,21679,21345
9554967,9554958,TXFE7,128,9942,1,41793,21680,21346
9554967,9554965,TXFE7,128,9942,1,41794,21681,21347
9555042,9555041,TXFE7,128,9942,1,41795,21682,21348
9555092,9555088,TXFE7,128,9943,1,41796,21683,21349
9555167,9555166,TXFE7,128,9943,6,41802,21684,21353
9555179,9555170,TXFE7,128,9943,2,41804,21685,21355
9555192,9555179,TXFE7,128,9943,6,41810,21686,21356
9555642,9555630,TXFE7,128,9943,1,41811,21687,21357
9555667,9555660,TXFE7,128,9944,1,41812,21688,21358
9555792,9555786,TXFE7,128,9943,2,41814,21689,21359
9555804,9555803,TXFE7,128,9943,3,41817,21691,21360
9555892,9555882,TXFE7,128,9944,1,41818,21692,21361
9560067,9560057,TXFE7,128,9944,1,41819,21693,21362
9560067,9560066,TXFE7,128,9944,2,41821,21694,21364
9560079,9560079,TXFE7,128,9944,4,41825,21695,21367
9560142,9560136,TXFE7,128,9944,3,41828,21696,21369
9560154,9560142,TXFE7,128,9944,15,41843,21697,21379
9560317,9560306,TXFE7,128,9944,1,41844,21698,21380
9560367,9560355,TXFE7,128,9944,10,41854,21701,21381
9560367,9560356,TXFE7,128,9944,1,41855,21702,21382
9560429,9560420,TXFE7,128,9944,1,41856,21703,21383
9560542,9560536,TXFE7,128,9944,1,41857,21704,21384
9560754,9560754,TXFE7,128,9944,6,41863,21705,21390
9560854,9560848,TXFE7,128,9944,1,41864,21706,21391
9560854,9560849,TXFE7,128,9944,1,41865,21707,21392
9561067,9561066,TXFE7,128,9943,1,41866,21708,21393
9561429,9561422,TXFE7,128,9943,3,41869,21709,21394
9561429,9561422,TXFE7,128,9943,15,41884,21721,21395
9561442,9561432,TXFE7,128,9943,6,41890,21722,21399
9561617,9561607,TXFE7,128,9943,1,41891,21723,21400
9561717,9561717,TXFE7,128,9943,1,41892,21724,21401
9561879,9561872,TXFE7,128,9944,1,41893,21725,21402
9562029,9562024,TXFE7,128,9943,2,41895,21727,21403
9562042,9562030,TXFE7,128,9943,3,41898,21730,21404
9562092,9562088,TXFE7,128,9943,3,41901,21731,21405
9562342,9562340,TXFE7,128,9943,1,41902,21732,21406
9563204,9563199,TXFE7,128,9943,2,41904,21733,21408
9563704,9563702,TXFE7,128,9943,1,41905,21734,21409
9563717,9563712,TXFE7,128,9943,10,41915,21735,21410
9563892,9563881,TXFE7,128,9943,5,41920,21736,21412
9563967,9563959,TXFE7,128,9943,1,41921,21737,21413
9563979,9563967,TXFE7,128,9942,1,41922,21738,21414
9564017,9564011,TXFE7,128,9943,1,41923,21739,21415
9564017,9564011,TXFE7,128,9943,2,41925,21740,21417
9564017,9564012,TXFE7,128,9943,1,41926,21741,21418
9564154,9564145,TXFE7,128,9942,2,41928,21743,21419
9564479,9564471,TXFE7,128,9942,1,41929,21744,21420
9564479,9564476,TXFE7,128,9943,3,41932,21745,21423
9564492,9564488,TXFE7,128,9942,2,41934,21747,21424
9564504,9564496,TXFE7,128,9942,6,41940,21753,21425
9564517,9564504,TXFE7,128,9942,3,41943,21755,21426
9564517,9564514,TXFE7,128,9942,5,41948,21759,21427
9564529,9564517,TXFE7,128,9942,2,41950,21761,21428
9564529,9564517,TXFE7,128,9942,4,41954,21765,21429
9564542,9564529,TXFE7,128,9942,4,41958,21769,21430
9564542,9564534,TXFE7,128,9942,1,41959,21770,21431
9564542,9564534,TXFE7,128,9942,1,41960,21771,21432
9564542,9564534,TXFE7,128,9942,1,41961,21772,21433
9564542,9564534,TXFE7,128,9942,1,41962,21773,21434
9564542,9564534,TXFE7,128,9942,1,41963,21774,21435
9564542,9564534,TXFE7,128,9942,8,41971,21781,21436
9564554,9564545,TXFE7,128,9942,3,41974,21782,21437
9564579,9564570,TXFE7,128,9941,1,41975,21783,21438
9564617,9564608,TXFE7,128,9942,1,41976,21784,21439
9564642,9564635,TXFE7,128,9941,2,41978,21785,21440
9564654,9564653,TXFE7,128,9942,20,41998,21786,21448
9564704,9564694,TXFE7,128,9941,1,41999,21787,21449
9564704,9564703,TXFE7,128,9942,1,42000,21788,21450
9564742,9564732,TXFE7,128,9941,6,42006,21794,21451
9564842,9564832,TXFE7,128,9941,1,42007,21795,21452
9564992,9564982,TXFE7,128,9941,1,42008,21796,21453
9565092,9565090,TXFE7,128,9941,5,42013,21798,21454
9565154,9565148,TXFE7,128,9941,2,42015,21799,21455
9565554,9565550,TXFE7,128,9942,1,42016,21800,21456
9565742,9565731,TXFE7,128,9942,9,42025,21801,21462
9565754,9565744,TXFE7,128,9942,4,42029,21802,21465
9565779,9565770,TXFE7,128,9942,2,42031,21803,21467
9565817,9565806,TXFE7,128,9942,1,42032,21804,21468
9565842,9565835,TXFE7,128,9942,1,42033,21805,21469
9565867,9565859,TXFE7,128,9942,1,42034,21806,21470
9565904,9565899,TXFE7,128,9942,1,42035,21807,21471
9565917,9565905,TXFE7,128,9942,16,42051,21809,21472
9565967,9565960,TXFE7,128,9943,1,42052,21810,21473
9570004,9565995,TXFE7,128,9941,2,42054,21812,21474
9570017,9570005,TXFE7,128,9942,1,42055,21813,21475
9570042,9570030,TXFE7,129,9942,1,42057,21815,21476
9570042,9570030,TXFE7,129,9941,1,42057,21815,21476
9570054,9570052,TXFE7,128,9943,1,42058,21816,21477
9570067,9570054,TXFE7,128,9941,1,42059,21817,21478
9570104,9570092,TXFE7,128,9942,1,42060,21818,21479
9570192,9570183,TXFE7,128,9942,1,42061,21819,21480
9570204,9570192,TXFE7,128,9943,1,42062,21820,21481
9570242,9570237,TXFE7,128,9942,1,42063,21821,21482
9570367,9570361,TXFE7,128,9942,1,42064,21822,21483
9570379,9570367,TXFE7,128,9942,4,42068,21825,21484
9570517,9570506,TXFE7,128,9941,2,42070,21827,21485
9570629,9570622,TXFE7,128,9942,1,42071,21828,21486
9570742,9570737,TXFE7,128,9941,1,42072,21829,21487
9570804,9570793,TXFE7,128,9942,2,42074,21830,21489
9570817,9570810,TXFE7,128,9942,1,42075,21831,21490
9570979,9570967,TXFE7,128,9942,4,42079,21834,21491
9571104,9571095,TXFE7,128,9941,4,42083,21838,21492
9571192,9571190,TXFE7,128,9942,1,42084,21839,21493
9571379,9571373,TXFE7,128,9942,1,42085,21840,21494
9571417,9571409,TXFE7,128,9942,2,42087,21842,21495
9571492,9571481,TXFE7,128,9942,1,42088,21843,21496
9571554,9571544,TXFE7,128,9942,1,42089,21844,21497
9571567,9571555,TXFE7,128,9942,9,42098,21846,21498
9571729,9571728,TXFE7,128,9943,1,42099,21847,21499
9571754,9571752,TXFE7,128,9941,1,42100,21848,21500
9571779,9571771,TXFE7,128,9942,1,42101,21849,21501
9572017,9572016,TXFE7,128,9942,2,42103,21850,21502
9572267,9572257,TXFE7,128,9942,1,42104,21851,21503
9572367,9572363,TXFE7,128,9942,1,42105,21852,21504
9572392,9572388,TXFE7,128,9942,1,42106,21853,21505
9572629,9572624,TXFE7,128,9942,1,42107,21854,21506
9572692,9572684,TXFE7,128,9942,1,42108,21855,21507
9572742,9572741,TXFE7,128,9942,1,42109,21856,21508
9572867,9572860,TXFE7,128,9942,2,42111,21857,21510
9573042,9573041,TXFE7,128,9942,1,42112,21858,21511
9573129,9573117,TXFE7,128,9942,11,42123,21859,21518
9573442,9573440,TXFE7,128,9941,3,42126,21862,21519
9573454,9573444,TXFE7,128,9941,1,42127,21863,21520
9573467,9573460,TXFE7,128,9942,1,42128,21864,21521
9573479,9573471,TXFE7,128,9941,1,42129,21865,21522
9573504,9573501,TXFE7,128,9942,1,42130,21866,21523
9573567,9573560,TXFE7,128,9942,1,42131,21867,21524
9573867,9573856,TXFE7,128,9942,2,42133,21868,21525
9574204,9574200,TXFE7,128,9942,1,42134,21869,21526
9574204,9574200,TXFE7,128,9942,1,42135,21870,21527
9574329,9574329,TXFE7,128,9942,5,42140,21871,21530
9574342,9574329,TXFE7,128,9942,1,42141,21872,21531
9574342,9574341,TXFE7,128,9942,1,42142,21873,21532
9574492,9574489,TXFE7,128,9942,1,42143,21874,21533
9574754,9574744,TXFE7,128,9942,1,42144,21875,21534
9574779,9574777,TXFE7,128,9942,2,42146,21876,21535
9575167,9575160,TXFE7,128,9943,3,42149,21877,21538
9575404,9575400,TXFE7,128,9942,1,42150,21878,21539
9575529,9575526,TXFE7,128,9943,1,42151,21879,21540
9575692,9575684,TXFE7,128,9942,20,42171,21888,21541
9575842,9575834,TXFE7,128,9942,1,42172,21889,21542
9580242,9580232,TXFE7,128,9942,2,42174,21890,21543
9580929,9580921,TXFE7,128,9942,1,42175,21891,21544
9581329,9581320,TXFE7,128,9943,1,42176,21892,21545
9581367,9581355,TXFE7,128,9943,3,42179,21893,21546
9581554,9581546,TXFE7,128,9943,1,42180,21894,21547
9581629,9581626,TXFE7,128,9943,1,42181,21895,21548
9581729,9581719,TXFE7,128,9943,1,42182,21896,21549
9581792,9581782,TXFE7,128,9942,2,42184,21897,21550
9582304,9582297,TXFE7,128,9943,2,42186,21898,21552
9582954,9582942,TXFE7,128,9942,7,42193,21899,21553
9583017,9583017,TXFE7,128,9943,2,42195,21900,21555
9583267,9583256,TXFE7,128,9942,1,42196,21901,21556
9583279,9583269,TXFE7,128,9942,21,42217,21909,21557
9583292,9583279,TXFE7,128,9942,4,42221,21910,21558
9583292,9583279,TXFE7,128,9942,27,42248,21924,21559
9583754,9583752,TXFE7,128,9941,4,42252,21928,21560
9583804,9583803,TXFE7,128,9942,1,42253,21929,21561
9583854,9583843,TXFE7,128,9942,1,42254,21930,21562
9583917,9583916,TXFE7,128,9941,5,42259,21933,21563
9583967,9583955,TXFE7,128,9941,5,42264,21936,21564
9583979,9583969,TXFE7,128,9941,5,42269,21937,21565
9583979,9583976,TXFE7,128,9941,4,42273,21939,21566
9584017,9584012,TXFE7,128,9941,5,42278,21942,21567
9584017,9584015,TXFE7,128,9941,1,42279,21943,21568
9584042,9584040,TXFE7,128,9941,5,42284,21944,21569
9584067,9584062,TXFE7,128,9941,1,42285,21945,21570
9584079,9584067,TXFE7,128,9941,3,42288,21947,21571
9584104,9584099,TXFE7,128,9941,2,42290,21948,21572
9584117,9584114,TXFE7,128,9941,1,42291,21949,21573
9584167,9584158,TXFE7,128,9942,5,42296,21950,21575
9584342,9584333,TXFE7,128,9941,2,42298,21951,21576
9584442,9584434,TXFE7,128,9941,2,42300,21952,21577
9584679,9584672,TXFE7,128,9941,6,42306,21958,21578
9584679,9584672,TXFE7,128,9941,4,42310,21962,21579
9584679,9584672,TXFE7,128,9941,1,42311,21963,21580
9584679,9584672,TXFE7,128,9941,1,42312,21964,21581
9584679,9584672,TXFE7,128,9941,4,42316,21967,21582
9584679,9584672,TXFE7,128,9941,1,42317,21968,21583
9584679,9584672,TXFE7,128,9941,34,42351,21983,21584
9584679,9584674,TXFE7,128,9941,2,42353,21984,21585
9584692,9584679,TXFE7,128,9941,4,42357,21985,21586
9584692,9584679,TXFE7,128,9941,2,42359,21986,21587
9584692,9584679,TXFE7,128,9941,4,42363,21987,21588
9584692,9584679,TXFE7,128,9941,1,42364,21988,21589
9584692,9584679,TXFE7,128,9941,1,42365,21989,21590
9584692,9584679,TXFE7,128,9941,1,42366,21990,21591
9584729,9584723,TXFE7,128,9941,2,42368,21991,21593
9584842,9584840,TXFE7,128,9941,10,42378,21992,21598
9585292,9585282,TXFE7,128,9941,11,42389,21993,21603
9585304,9585297,TXFE7,128,9941,1,42390,21994,21604
9585367,9585367,TXFE7,128,9941,8,42398,21995,21608
9585454,9585446,TXFE7,128,9941,1,42399,21996,21609
9585617,9585604,TXFE7,128,9941,9,42408,22004,21610
9585642,9585638,TXFE7,128,9941,4,42412,22005,21612
9585667,9585662,TXFE7,128,9941,1,42413,22006,21613
9585992,9585980,TXFE7,128,9941,1,42414,22007,21614
9590029,9590019,TXFE7,128,9941,1,42415,22008,21615
9590042,9590041,TXFE7,128,9941,5,42420,22009,21616
9590054,9590043,TXFE7,128,9941,1,42421,22010,21617
9590079,9590072,TXFE7,128,9941,1,42422,22011,21618
9590129,9590119,TXFE7,128,9940,1,42423,22012,21619
9590129,9590120,TXFE7,128,9940,1,42424,22013,21620
9590179,9590173,TXFE7,128,9940,2,42426,22014,21621
9590192,9590190,TXFE7,128,9940,2,42428,22015,21622
9590229,9590217,TXFE7,128,9941,2,42430,22016,21624
9590229,9590221,TXFE7,128,9940,2,42432,22017,21625
9590342,9590334,TXFE7,128,9940,1,42433,22018,21626
9590404,9590397,TXFE7,128,9941,1,42434,22019,21627
9590442,9590435,TXFE7,128,9940,2,42436,22020,21628
9590504,9590494,TXFE7,128,9941,1,42437,22021,21629
9590554,9590553,TXFE7,128,9941,1,42438,22022,21630
9590642,9590639,TXFE7,128,9941,1,42439,22023,21631
9590679,9590668,TXFE7,128,9940,1,42440,22024,21632
9590729,9590719,TXFE7,128,9941,3,42443,22025,21633
9590792,9590791,TXFE7,128,9941,1,42444,22026,21634
9590804,9590800,TXFE7,128,9941,1,42445,22027,21635
9590917,9590905,TXFE7,128,9941,1,42446,22028,21636
9591104,9591094,TXFE7,128,9940,1,42447,22029,21637
9591179,9591173,TXFE7,128,9941,3,42450,22030,21639
9591204,9591204,TXFE7,128,9940,2,42452,22031,21640
9591292,9591286,TXFE7,128,9941,1,42453,22032,21641
9591329,9591325,TXFE7,128,9940,2,42455,22033,21642
9591392,9591386,TXFE7,128,9940,20,42475,22049,21643
9591454,9591452,TXFE7,128,9940,1,42476,22050,21644
9591467,9591455,TXFE7,128,9940,6,42482,22056,21645
9591492,9591489,TXFE7,128,9940,2,42484,22057,21646
9591517,9591512,TXFE7,128,9940,1,42485,22058,21647
9591542,9591531,TXFE7,128,9940,1,42486,22059,21648
9591554,9591544,TXFE7,128,9940,2,42488,22061,21649
9591579,9591575,TXFE7,128,9941,9,42497,22062,21658
9591592,9591592,TXFE7,128,9940,2,42499,22064,21659
9591617,9591605,TXFE7,128,9940,10,42509,22073,21660
9591667,9591656,TXFE7,128,9940,1,42510,22074,21661
9591679,9591667,TXFE7,128,9940,1,42511,22075,21662
9591692,9591680,TXFE7,128,9940,73,42584,22108,21663
9591817,9591810,TXFE7,128,9939,1,42585,22109,21664
9591842,9591836,TXFE7,128,9939,1,42586,22110,21665
9591854,9591848,TXFE7,128,9939,1,42587,22111,21666
9591867,9591859,TXFE7,128,9939,1,42588,22112,21667
9591879,9591868,TXFE7,128,9939,1,42589,22113,21668
9591892,9591885,TXFE7,128,9939,1,42590,22114,21669
9591904,9591892,TXFE7,128,9939,1,42591,22115,21670
9591929,9591924,TXFE7,128,9939,1,42592,22116,21671
9591992,9591980,TXFE7,128,9940,1,42593,22117,21672
9591992,9591983,TXFE7,128,9939,1,42594,22118,21673
9592017,9592008,TXFE7,128,9939,1,42595,22119,21674
9592092,9592084,TXFE7,128,9939,1,42596,22120,21675
9592104,9592095,TXFE7,128,9939,1,42597,22121,21676
9592179,9592176,TXFE7,128,9940,1,42598,22122,21677
9592192,9592181,TXFE7,128,9939,1,42599,22123,21678
9592192,9592185,TXFE7,128,9939,1,42600,22124,21679
9592217,9592207,TXFE7,128,9939,1,42601,22125,21680
9592279,9592270,TXFE7,128,9939,1,42602,22126,21681
9592329,9592321,TXFE7,128,9939,2,42604,22128,21682
9592342,9592330,TXFE7,128,9940,1,42605,22129,21683
9592392,9592386,TXFE7,128,9939,3,42608,22131,21684
9592392,9592391,TXFE7,128,9939,1,42609,22132,21685
9592442,9592431,TXFE7,128,9940,1,42610,22133,21686
9592442,9592435,TXFE7,128,9940,8,42618,22134,21694
9592454,9592442,TXFE7,128,9940,1,42619,22135,21695
9592479,9592474,TXFE7,128,9940,2,42621,22137,21696
9592479,9592479,TXFE7,128,9940,2,42623,22139,21697
9592492,9592480,TXFE7,128,9940,1,42624,22140,21698
9592529,9592522,TXFE7,128,9940,1,42625,22141,21699
9592542,9592541,TXFE7,128,9940,2,42627,22143,21700
9592567,9592559,TXFE7,128,9940,1,42628,22144,21701
9592717,9592706,TXFE7,128,9940,1,42629,22145,21702
9592717,9592709,TXFE7,128,9941,2,42631,22146,21703
9592717,9592709,TXFE7,128,9941,8,42639,22147,21709
9592717,9592709,TXFE7,128,9941,1,42640,22148,21710
9592717,9592709,TXFE7,128,9941,2,42642,22149,21712
9592717,9592709,TXFE7,128,9941,3,42645,22150,21715
9592717,9592709,TXFE7,128,9941,1,42646,22151,21716
9592717,9592709,TXFE7,128,9941,1,42647,22152,21717
9592804,9592803,TXFE7,128,9941,2,42649,22153,21718
9592854,9592851,TXFE7,128,9941,1,42650,22154,21719
9592929,9592917,TXFE7,128,9941,3,42653,22156,21720
9592942,9592934,TXFE7,128,9941,3,42656,22159,21721
9593417,9593407,TXFE7,128,9941,1,42657,22160,21722
9593442,9593441,TXFE7,128,9941,7,42664,22161,21727
9593554,9593543,TXFE7,128,9941,1,42665,22162,21728
9593617,9593604,TXFE7,128,9941,1,42666,22163,21729
9593667,9593656,TXFE7,128,9940,2,42668,22165,21730
9594167,9594154,TXFE7,128,9940,2,42670,22166,21731
9594304,9594295,TXFE7,128,9940,1,42671,22167,21732
9594454,9594448,TXFE7,128,9940,2,42673,22168,21733
9594729,9594727,TXFE7,128,9940,1,42674,22169,21734
9594729,9594728,TXFE7,128,9940,1,42675,22170,21735
9594804,9594804,TXFE7,128,9940,1,42676,22171,21736
9594992,9594983,TXFE7,128,9940,2,42678,22173,21737
9595154,9595143,TXFE7,128,9940,1,42679,22174,21738
9595254,9595244,TXFE7,128,9941,1,42680,22175,21739
9595429,9595421,TXFE7,128,9940,1,42681,22176,21740
9595804,9595800,TXFE7,128,9940,11,42692,22182,21741
9595829,9595824,TXFE7,128,9941,10,42702,22183,21746
9595867,9595855,TXFE7,128,9941,1,42703,22184,21747
9595917,9595907,TXFE7,128,9941,3,42706,22185,21750
9595917,9595912,TXFE7,128,9941,1,42707,22186,21751
10000004,10000004,TXFE7,128,9940,2,42709,22187,21752
10000017,10000015,TXFE7,128,9941,3,42712,22188,21753
10000067,10000059,TXFE7,128,9940,3,42715,22190,21754
10000079,10000078,TXFE7,128,9941,2,42717,22191,21756
10000192,10000182,TXFE7,128,9941,11,42728,22192,21759
10000204,10000192,TXFE7,128,9941,3,42731,22193,21760
10000204,10000203,TXFE7,128,9940,10,42741,22200,21761
10000217,10000212,TXFE7,128,9941,15,42756,22201,21774
10000229,10000217,TXFE7,128,9941,3,42759,22202,21775
10000229,10000223,TXFE7,128,9940,2,42761,22204,21776
10000242,10000232,TXFE7,128,9941,3,42764,22205,21778
10000279,10000267,TXFE7,128,9941,2,42766,22206,21779
10000379,10000370,TXFE7,128,9941,1,42767,22207,21780
10000379,10000374,TXFE7,128,9941,4,42771,22210,21781
10000504,10000503,TXFE7,128,9941,2,42773,22211,21782
10000517,10000504,TXFE7,128,9941,1,42774,22212,21783
10000654,10000642,TXFE7,128,9942,1,42775,22213,21784
10000704,10000693,TXFE7,128,9941,1,42776,22214,21785
10000867,10000865,TXFE7,128,9941,1,42777,22215,21786
10000904,10000893,TXFE7,128,9942,1,42778,22216,21787
10001204,10001194,TXFE7,128,9942,1,42779,22217,21788
10001342,10001337,TXFE7,128,9941,2,42781,22218,21789
10001479,10001470,TXFE7,128,9941,1,42782,22219,21790
10001542,10001536,TXFE7,128,9942,1,42783,22220,21791
10001554,10001549,TXFE7,128,9941,3,42786,22221,21792
10001829,10001824,TXFE7,128,9942,2,42788,22222,21793
10001904,10001892,TXFE7,128,9942,1,42789,22223,21794
10001929,10001925,TXFE7,128,9941,1,42790,22224,21795
10002442,10002437,TXFE7,128,9941,1,42791,22225,21796
10002717,10002713,TXFE7,128,9941,1,42792,22226,21797
10002792,10002782,TXFE7,128,9941,1,42793,22227,21798
10003004,10003002,TXFE7,128,9941,1,42794,22228,21799
10003042,10003033,TXFE7,128,9941,1,42795,22229,21800
10003067,10003067,TXFE7,128,9941,4,42799,22231,21801
10003167,10003163,TXFE7,128,9941,10,42809,22236,21802
10003217,10003209,TXFE7,128,9941,7,42816,22240,21803
10003229,10003217,TXFE7,128,9941,3,42819,22241,21804
10003242,10003231,TXFE7,128,9941,1,42820,22242,21805
10003304,10003299,TXFE7,128,9941,1,42821,22243,21806
10003329,10003323,TXFE7,128,9941,1,42822,22244,21807
10003367,10003355,TXFE7,128,9941,36,42858,22260,21808
10003367,10003356,TXFE7,128,9941,1,42859,22261,21809
10003404,10003399,TXFE7,128,9941,1,42860,22262,21810
10003429,10003422,TXFE7,128,9940,1,42861,22263,21811
10003454,10003449,TXFE7,128,9941,1,42862,22264,21812
10003654,10003645,TXFE7,128,9940,2,42864,22265,21813
10003679,10003679,TXFE7,128,9941,1,42865,22266,21814
10003692,10003692,TXFE7,128,9941,11,42876,22267,21818
10003867,10003858,TXFE7,128,9941,8,42884,22268,21819
10003879,10003872,TXFE7,128,9940,1,42885,22269,21820
10003942,10003938,TXFE7,128,9941,1,42886,22270,21821
10003967,10003961,TXFE7,128,9940,1,42887,22271,21822
10003979,10003973,TXFE7,128,9940,6,42893,22273,21823
10004567,10004556,TXFE7,128,9940,1,42894,22274,21824
10004679,10004675,TXFE7,128,9941,1,42895,22275,21825
10005204,10005202,TXFE7,128,9940,1,42896,22276,21826
10005704,10005699,TXFE7,128,9941,20,42916,22277,21831
10005804,10005802,TXFE7,128,9941,3,42919,22278,21834
10005954,10005948,TXFE7,128,9941,11,42930,22279,21839
10010042,10010041,TXFE7,128,9941,2,42932,22280,21840
10010079,10010078,TXFE7,128,9940,1,42933,22281,21841
10010217,10010211,TXFE7,128,9941,3,42936,22282,21842
10010254,10010243,TXFE7,128,9941,1,42937,22283,21843
10010317,10010310,TXFE7,128,9941,1,42938,22284,21844
10010354,10010353,TXFE7,128,9941,1,42939,22285,21845
10010567,10010557,TXFE7,128,9941,2,42941,22286,21847
10010629,10010620,TXFE7,128,9941,1,42942,22287,21848
10010654,10010645,TXFE7,128,9941,1,42943,22288,21849
10010829,10010822,TXFE7,128,9941,2,42945,22289,21850
10011142,10011134,TXFE7,128,9941,1,42946,22290,21851
10011254,10011250,TXFE7,128,9941,3,42949,22291,21854
10011779,10011778,TXFE7,128,9941,1,42950,22292,21855
10012104,10012097,TXFE7,128,9940,2,42952,22293,21856
10012129,10012127,TXFE7,128,9940,5,42957,22294,21857
10012217,10012205,TXFE7,128,9940,3,42960,22295,21858
10012267,10012261,TXFE7,128,9940,1,42961,22296,21859
10012304,10012298,TXFE7,128,9941,1,42962,22297,21860
10012942,10012940,TXFE7,128,9940,1,42963,22298,21861
10013242,10013241,TXFE7,128,9941,4,42967,22299,21863
10013292,10013285,TXFE7,128,9941,4,42971,22300,21864
10013342,10013336,TXFE7,128,9941,1,42972,22301,21865
10013379,10013367,TXFE7,128,9940,1,42973,22302,21866
10013992,10013981,TXFE7,128,9940,1,42974,22303,21867
10014117,10014113,TXFE7,128,9940,2,42976,22304,21868
10014679,10014674,TXFE7,128,9941,1,42977,22305,21869
10015304,10015304,TXFE7,128,9941,1,42978,22306,21870
10015404,10015392,TXFE7,128,9941,2,42980,22307,21871
10015404,10015396,TXFE7,128,9941,3,42983,22308,21872
10015417,10015404,TXFE7,128,9941,4,42987,22309,21876
10015417,10015404,TXFE7,128,9941,3,42990,22310,21879
10015417,10015404,TXFE7,128,9941,5,42995,22311,21884
10015417,10015404,TXFE7,128,9941,1,42996,22312,21885
10015417,10015404,TXFE7,128,9941,1,42997,22313,21886
10015429,10015417,TXFE7,128,9941,1,42998,22314,21887
10015429,10015417,TXFE7,128,9941,1,42999,22315,21888
10015429,10015417,TXFE7,128,9941,2,43001,22316,21890
10015429,10015417,TXFE7,128,9941,1,43002,22317,21891
10015454,10015453,TXFE7,128,9941,1,43003,22318,21892
10015467,10015456,TXFE7,128,9941,1,43004,22319,21893
10015467,10015457,TXFE7,128,9941,1,43005,22320,21894
10015479,10015469,TXFE7,128,9941,1,43006,22321,21895
10015917,10015906,TXFE7,128,9942,1,43007,22322,21896
10020067,10020056,TXFE7,128,9942,2,43009,22323,21897
10020079,10020073,TXFE7,128,9942,3,43012,22324,21898
10020242,10020232,TXFE7,128,9941,1,43013,22325,21899
10020367,10020359,TXFE7,128,9941,1,43014,22326,21900
10020392,10020382,TXFE7,128,9941,1,43015,22327,21901
10021004,10020996,TXFE7,128,9942,1,43016,22328,21902
10021042,10021033,TXFE7,128,9942,3,43019,22329,21904
10021779,10021771,TXFE7,128,9942,1,43020,22330,21905
10021829,10021825,TXFE7,128,9942,1,43021,22331,21906
10021854,10021851,TXFE7,128,9942,1,43022,22332,21907
10022154,10022142,TXFE7,128,9942,5,43027,22333,21909
10022404,10022397,TXFE7,128,9941,1,43028,22334,21910
10022954,10022943,TXFE7,128,9941,1,43029,22335,21911
10022967,10022966,TXFE7,128,9941,1,43030,22336,21912
10022979,10022968,TXFE7,128,9941,1,43031,22337,21913
10022992,10022984,TXFE7,128,9941,1,43032,22338,21914
10022992,10022984,TXFE7,128,9941,2,43034,22339,21915
10022992,10022984,TXFE7,128,9941,2,43036,22341,21916
10022992,10022986,TXFE7,128,9941,4,43040,22342,21917
10022992,10022991,TXFE7,128,9941,2,43042,22343,21918
10023004,10022992,TXFE7,128,9941,3,43045,22346,21919
10023004,10022992,TXFE7,128,9941,7,43052,22348,21920
10023004,10022992,TXFE7,128,9941,4,43056,22349,21921
10023004,10022992,TXFE7,128,9941,2,43058,22351,21922
10023004,10022992,TXFE7,128,9941,1,43059,22352,21923
10023004,10022992,TXFE7,128,9941,4,43063,22355,21924
10023004,10022992,TXFE7,128,9941,15,43078,22366,21925
10023367,10023366,TXFE7,128,9940,1,43079,22367,21926
10023554,10023549,TXFE7,128,9941,8,43087,22368,21928
10023704,10023699,TXFE7,128,9940,1,43088,22369,21929
10023929,10023922,TXFE7,128,9940,1,43089,22370,21930
10023942,10023931,TXFE7,128,9940,2,43091,22371,21931
10024254,10024243,TXFE7,128,9940,1,43092,22372,21932
10024292,10024279,TXFE7,128,9941,4,43096,22373,21936
10024504,10024495,TXFE7,128,9941,1,43097,22374,21937
10025479,10025475,TXFE7,128,9941,1,43098,22375,21938
10025504,10025495,TXFE7,128,9941,1,43099,22376,21939
10025829,10025826,TXFE7,128,9940,1,43100,22377,21940
10025954,10025947,TXFE7,128,9941,2,43102,22378,21942
10030142,10030135,TXFE7,128,9940,1,43103,22379,21943
10030242,10030233,TXFE7,128,9941,1,43104,22380,21944
10030629,10030620,TXFE7,128,9941,2,43106,22381,21946
10030704,10030696,TXFE7,128,9941,5,43111,22382,21950
10030967,10030964,TXFE7,128,9941,1,43112,22383,21951
10031029,10031020,TXFE7,128,9941,1,43113,22384,21952
10031042,10031034,TXFE7,128,9941,1,43114,22385,21953
10031117,10031110,TXFE7,128,9941,1,43115,22386,21954
10031329,10031324,TXFE7,128,9941,3,43118,22387,21957
10031604,10031593,TXFE7,128,9941,1,43119,22388,21958
10031679,10031677,TXFE7,128,9940,1,43120,22389,21959
10031679,10031677,TXFE7,128,9940,1,43121,22390,21960
10031742,10031742,TXFE7,128,9941,1,43122,22391,21961
10031817,10031816,TXFE7,128,9940,1,43123,22392,21962
10031867,10031859,TXFE7,128,9941,2,43125,22393,21964
10031967,10031957,TXFE7,128,9941,6,43131,22394,21969
10032042,10032033,TXFE7,128,9941,2,43133,22395,21971
10032404,10032400,TXFE7,128,9940,2,43135,22396,21972
10032417,10032404,TXFE7,128,9940,4,43139,22397,21973
10032417,10032404,TXFE7,128,9940,3,43142,22399,21974
10032567,10032559,TXFE7,128,9941,4,43146,22400,21977
10032967,10032960,TXFE7,128,9940,1,43147,22401,21978
10033417,10033405,TXFE7,128,9940,1,43148,22402,21979
10033642,10033639,TXFE7,128,9940,1,43149,22403,21980
10033667,10033658,TXFE7,128,9940,1,43150,22404,21981
10033679,10033670,TXFE7,128,9940,5,43155,22407,21982
10033704,10033699,TXFE7,128,9940,1,43156,22408,21983
10033754,10033742,TXFE7,128,9940,1,43157,22409,21984
10033754,10033743,TXFE7,128,9940,1,43158,22410,21985
10033754,10033754,TXFE7,128,9940,1,43159,22411,21986
10033767,10033762,TXFE7,128,9941,4,43163,22412,21989
10033804,10033796,TXFE7,128,9940,1,43164,22413,21990
10033954,10033948,TXFE7,128,9940,7,43171,22415,21991
10034004,10034002,TXFE7,128,9940,4,43175,22416,21992
10034017,10034006,TXFE7,128,9940,1,43176,22417,21993
10034079,10034073,TXFE7,128,9940,3,43179,22419,21994
10034179,10034178,TXFE7,128,9940,2,43181,22421,21995
10034192,10034184,TXFE7,128,9940,1,43182,22422,21996
10034217,10034214,TXFE7,128,9940,1,43183,22423,21997
10034317,10034309,TXFE7,128,9940,1,43184,22424,21998
10034329,10034325,TXFE7,128,9940,1,43185,22425,21999
10034392,10034387,TXFE7,128,9940,1,43186,22426,22000
10034542,10034532,TXFE7,128,9940,30,43216,22445,22001
10034567,10034554,TXFE7,128,9940,4,43220,22448,22002
10034592,10034580,TXFE7,128,9940,2,43222,22449,22003
10034654,10034645,TXFE7,128,9940,4,43226,22453,22004
10034717,10034714,TXFE7,128,9940,1,43227,22454,22005
10034729,10034722,TXFE7,128,9940,9,43236,22462,22006
10034742,10034739,TXFE7,128,9940,1,43237,22463,22007
10034767,10034758,TXFE7,128,9940,2,43239,22464,22008
10034804,10034792,TXFE7,128,9940,1,43240,22465,22009
10034817,10034810,TXFE7,128,9940,1,43241,22466,22010
10034867,10034861,TXFE7,128,9940,1,43242,22467,22011
10035142,10035137,TXFE7,128,9940,5,43247,22470,22012
10035167,10035166,TXFE7,128,9940,1,43248,22471,22013
10035192,10035190,TXFE7,128,9940,1,43249,22472,22014
10035292,10035284,TXFE7,128,9940,1,43250,22473,22015
10035579,10035572,TXFE7,128,9940,1,43251,22474,22016
10035817,10035812,TXFE7,128,9940,1,43252,22475,22017
10035867,10035854,TXFE7,128,9941,4,43256,22476,22020
10035904,10035896,TXFE7,128,9940,1,43257,22477,22021
10035929,10035926,TXFE7,128,9940,1,43258,22478,22022
10035954,10035945,TXFE7,128,9940,1,43259,22479,22023
10035992,10035992,TXFE7,128,9941,4,43263,22480,22025
10040442,10040438,TXFE7,128,9941,27,43290,22481,22047
10040454,10040451,TXFE7,128,9941,1,43291,22482,22048
10040467,10040462,TXFE7,128,9941,1,43292,22483,22049
10040479,10040476,TXFE7,129,9941,2,43295,22485,22050
10040479,10040476,TXFE7,129,9940,1,43295,22485,22050
10041554,10041545,TXFE7,128,9940,1,43296,22486,22051
10041642,10041630,TXFE7,128,9940,1,43297,22487,22052
10041654,10041646,TXFE7,128,9940,2,43299,22489,22053
10041729,10041718,TXFE7,128,9941,2,43301,22490,22055
10041742,10041735,TXFE7,128,9940,1,43302,22491,22056
10041767,10041757,TXFE7,128,9941,4,43306,22492,22057
10041767,10041757,TXFE7,128,9940,1,43307,22493,22058
10041792,10041782,TXFE7,128,9940,6,43313,22496,22059
10041867,10041858,TXFE7,128,9940,3,43316,22499,22060
10041904,10041898,TXFE7,128,9940,1,43317,22500,22061
10041979,10041968,TXFE7,128,9940,2,43319,22501,22062
10041979,10041971,TXFE7,128,9940,1,43320,22502,22063
10042229,10042225,TXFE7,128,9940,1,43321,22503,22064
10042279,10042270,TXFE7,128,9940,1,43322,22504,22065
10042279,10042275,TXFE7,128,9940,2,43324,22505,22066
10042367,10042366,TXFE7,128,9940,1,43325,22506,22067
10042454,10042453,TXFE7,128,9940,1,43326,22507,22068
10042629,10042623,TXFE7,128,9940,1,43327,22508,22069
10042867,10042864,TXFE7,128,9940,1,43328,22509,22070
10042892,10042891,TXFE7,128,9940,1,43329,22510,22071
10043029,10043027,TXFE7,128,9941,2,43331,22511,22072
10043079,10043073,TXFE7,128,9940,5,43336,22513,22073
10043092,10043080,TXFE7,128,9940,1,43337,22514,22074
10043317,10043307,TXFE7,128,9940,1,43338,22515,22075
10043342,10043340,TXFE7,128,9940,1,43339,22516,22076
10043417,10043408,TXFE7,128,9940,1,43340,22517,22077
10043654,10043645,TXFE7,128,9940,1,43341,22518,22078
10043842,10043840,TXFE7,128,9939,1,43342,22519,22079
10043854,10043845,TXFE7,128,9939,5,43347,22520,22080
10043854,10043846,TXFE7,128,9939,5,43352,22525,22081
10043854,10043847,TXFE7,128,9939,5,43357,22529,22082
10043854,10043849,TXFE7,128,9939,1,43358,22530,22083
10043854,10043849,TXFE7,128,9939,5,43363,22531,22084
10043854,10043850,TXFE7,128,9939,5,43368,22534,22085
10044054,10044050,TXFE7,128,9940,4,43372,22535,22086
10044154,10044147,TXFE7,128,9940,2,43374,22536,22087
10044204,10044204,TXFE7,128,9939,2,43376,22537,22088
10044279,10044272,TXFE7,128,9939,1,43377,22538,22089
10044542,10044539,TXFE7,128,9939,1,43378,22539,22090
10044567,10044564,TXFE7,128,9939,3,43381,22540,22091
10044679,10044670,TXFE7,128,9940,1,43382,22541,22092
10044692,10044685,TXFE7,128,9939,2,43384,22542,22093
10044717,10044709,TXFE7,128,9939,1,43385,22543,22094
10044717,10044710,TXFE7,128,9939,1,43386,22544,22095
10044829,10044818,TXFE7,128,9940,4,43390,22545,22099
10045129,10045117,TXFE7,128,9939,69,43459,22581,22100
10045129,10045123,TXFE7,128,9939,1,43460,22582,22101
10045167,10045158,TXFE7,128,9939,2,43462,22583,22102
10045342,10045336,TXFE7,128,9939,1,43463,22584,22103
10045517,10045512,TXFE7,128,9939,6,43469,22585,22109
10045642,10045639,TXFE7,128,9939,15,43484,22586,22112
10045692,10045680,TXFE7,128,9938,1,43485,22587,22113
10045704,10045694,TXFE7,128,9938,1,43486,22588,22114
10045704,10045695,TXFE7,128,9938,1,43487,22589,22115
10045704,10045696,TXFE7,128,9938,1,43488,22590,22116
10045704,10045698,TXFE7,128,9938,2,43490,22592,22117
10045704,10045700,TXFE7,128,9938,2,43492,22593,22118
10045704,10045703,TXFE7,128,9938,2,43494,22595,22119
10045717,10045705,TXFE7,128,9938,4,43498,22599,22120
10045717,10045708,TXFE7,128,9938,5,43503,22604,22121
10045717,10045708,TXFE7,128,9938,5,43508,22606,22122
10045717,10045710,TXFE7,128,9938,5,43513,22610,22123
10045717,10045711,TXFE7,128,9938,1,43514,22611,22124
10045729,10045717,TXFE7,128,9938,4,43518,22612,22125
10045729,10045717,TXFE7,128,9938,5,43523,22615,22126
10045729,10045721,TXFE7,128,9938,2,43525,22617,22127
10045729,10045721,TXFE7,128,9938,1,43526,22618,22128
10045742,10045729,TXFE7,128,9938,10,43536,22624,22129
10045742,10045729,TXFE7,128,9938,3,43539,22627,22130
10045742,10045730,TXFE7,128,9938,1,43540,22628,22131
10045742,10045732,TXFE7,128,9938,1,43541,22629,22132
10045742,10045736,TXFE7,128,9938,12,43553,22636,22133
10045754,10045742,TXFE7,128,9938,1,43554,22637,22134
10045754,10045742,TXFE7,128,9938,7,43561,22638,22135
10045754,10045742,TXFE7,128,9938,4,43565,22640,22136
10045754,10045742,TXFE7,128,9938,1,43566,22641,22137
10045754,10045742,TXFE7,128,9938,5,43571,22646,22138
10045754,10045754,TXFE7,128,9938,3,43574,22649,22139
10045767,10045754,TXFE7,128,9938,2,43576,22650,22140
10045767,10045754,TXFE7,128,9938,1,43577,22651,22141
10045767,10045754,TXFE7,128,9938,2,43579,22653,22142
10045767,10045767,TXFE7,128,9938,8,43587,22659,22143
10045779,10045778,TXFE7,128,9938,1,43588,22660,22144
10045792,10045784,TXFE7,128,9937,6,43594,22664,22145
10045804,10045794,TXFE7,128,9937,10,43604,22670,22146
10045817,10045808,TXFE7,128,9937,1,43605,22671,22147
10045842,10045830,TXFE7,128,9937,2,43607,22672,22148
10045842,10045831,TXFE7,128,9938,7,43614,22673,22151
10045842,10045832,TXFE7,128,9937,4,43618,22674,22152
10045842,10045835,TXFE7,128,9937,30,43648,22690,22153
10045842,10045839,TXFE7,128,9937,1,43649,22691,22154
10045842,10045840,TXFE7,128,9937,1,43650,22692,22155
10045854,10045846,TXFE7,128,9937,1,43651,22693,22156
10045854,10045851,TXFE7,128,9937,2,43653,22694,22157
10045854,10045852,TXFE7,128,9937,1,43654,22695,22158
10045867,10045862,TXFE7,128,9937,1,43655,22696,22159
10045892,10045882,TXFE7,128,9937,1,43656,22697,22160
10045904,10045892,TXFE7,128,9937,1,43657,22698,22161
10045904,10045904,TXFE7,128,9937,1,43658,22699,22162
10045917,10045906,TXFE7,128,9937,1,43659,22700,22163
10045917,10045915,TXFE7,128,9937,1,43660,22701,22164
10045979,10045977,TXFE7,128,9937,2,43662,22702,22165
10045992,10045986,TXFE7,128,9937,1,43663,22703,22166
10050004,10045996,TXFE7,128,9937,1,43664,22704,22167
10050017,10050007,TXFE7,128,9937,1,43665,22705,22168
10050029,10050019,TXFE7,128,9938,1,43666,22706,22169
10050042,10050040,TXFE7,128,9937,3,43669,22707,22170
10050054,10050053,TXFE7,128,9937,1,43670,22708,22171
10050067,10050058,TXFE7,128,9937,1,43671,22709,22172
10050079,10050072,TXFE7,128,9937,2,43673,22711,22173
10050079,10050073,TXFE7,128,9937,2,43675,22712,22174
10050079,10050075,TXFE7,128,9937,1,43676,22713,22175
10050079,10050076,TXFE7,128,9937,2,43678,22715,22176
10050079,10050076,TXFE7,128,9937,1,43679,22716,22177
10050079,10050078,TXFE7,128,9937,2,43681,22718,22178
10050092,10050085,TXFE7,128,9938,3,43684,22719,22181
10050104,10050101,TXFE7,128,9937,10,43694,22725,22182
10050104,10050104,TXFE7,128,9937,1,43695,22726,22183
10050117,10050105,TXFE7,128,9937,1,43696,22727,22184
10050129,10050122,TXFE7,128,9937,1,43697,22728,22185
10050142,10050132,TXFE7,128,9937,1,43698,22729,22186
10050154,10050150,TXFE7,128,9937,1,43699,22730,22187
10050154,10050153,TXFE7,128,9937,1,43700,22731,22188
10050167,10050154,TXFE7,128,9938,5,43705,22732,22193
10050167,10050156,TXFE7,128,9938,1,43706,22733,22194
10050167,10050165,TXFE7,128,9937,1,43707,22734,22195
10050179,10050171,TXFE7,128,9937,1,43708,22735,22196
10050217,10050209,TXFE7,128,9937,10,43718,22739,22197
10050217,10050215,TXFE7,128,9938,1,43719,22740,22198
10050229,10050223,TXFE7,128,9938,1,43720,22741,22199
10050229,10050225,TXFE7,128,9938,2,43722,22742,22201
10050242,10050238,TXFE7,128,9937,5,43727,22745,22202
10050254,10050245,TXFE7,128,9938,1,43728,22746,22203
10050304,10050294,TXFE7,128,9938,1,43729,22747,22204
10050317,10050307,TXFE7,128,9937,1,43730,22748,22205
10050317,10050309,TXFE7,128,9938,4,43734,22749,22208
10050329,10050325,TXFE7,128,9938,1,43735,22750,22209
10050342,10050331,TXFE7,128,9938,4,43739,22751,22210
10050342,10050332,TXFE7,128,9938,8,43747,22752,22216
10050354,10050342,TXFE7,128,9938,1,43748,22753,22217
10050354,10050343,TXFE7,128,9938,4,43752,22754,22218
10050354,10050348,TXFE7,128,9938,2,43754,22756,22219
10050367,10050365,TXFE7,128,9939,5,43759,22757,22220
10050392,10050387,TXFE7,128,9939,2,43761,22758,22221
10050417,10050410,TXFE7,128,9938,1,43762,22759,22222
10050479,10050468,TXFE7,128,9938,1,43763,22760,22223
10050479,10050470,TXFE7,128,9939,1,43764,22761,22224
10050504,10050502,TXFE7,128,9938,1,43765,22762,22225
10050579,10050571,TXFE7,128,9938,1,43766,22763,22226
10050679,10050679,TXFE7,128,9938,1,43767,22764,22227
10050767,10050760,TXFE7,128,9939,1,43768,22765,22228
10050842,10050837,TXFE7,128,9938,5,43773,22769,22229
10050917,10050916,TXFE7,128,9938,1,43774,22770,22230
10050992,10050985,TXFE7,128,9938,1,43775,22771,22231
10051092,10051082,TXFE7,128,9938,1,43776,22772,22232
10051092,10051087,TXFE7,128,9938,1,43777,22773,22233
10051279,10051270,TXFE7,128,9939,1,43778,22774,22234
10051279,10051277,TXFE7,128,9938,1,43779,22775,22235
10051317,10051312,TXFE7,128,9938,1,43780,22776,22236
10051342,10051336,TXFE7,128,9939,1,43781,22777,22237
10051342,10051340,TXFE7,128,9938,5,43786,22781,22238
10051442,10051442,TXFE7,128,9939,1,43787,22782,22239
10051479,10051476,TXFE7,128,9938,1,43788,22783,22240
10051829,10051827,TXFE7,128,9939,1,43789,22784,22241
10051929,10051923,TXFE7,128,9939,1,43790,22785,22242
10051942,10051934,TXFE7,128,9938,1,43791,22786,22243
10052004,10052004,TXFE7,128,9939,1,43792,22787,22244
10052117,10052108,TXFE7,128,9939,1,43793,22788,22245
10052379,10052376,TXFE7,128,9939,1,43794,22789,22246
10052417,10052407,TXFE7,128,9938,1,43795,22790,22247
10052429,10052419,TXFE7,128,9939,3,43798,22791,22248
10052554,10052542,TXFE7,128,9938,2,43800,22793,22249
10052692,10052687,TXFE7,128,9939,5,43805,22794,22253
10052729,10052722,TXFE7,128,9939,2,43807,22795,22254
10052742,10052734,TXFE7,128,9939,1,43808,22796,22255
10052779,10052775,TXFE7,128,9938,1,43809,22797,22256
10052854,10052852,TXFE7,128,9939,20,43829,22798,22272
10052854,10052854,TXFE7,128,9938,1,43830,22799,22273
10052892,10052881,TXFE7,128,9938,1,43831,22800,22274
10053317,10053308,TXFE7,128,9938,1,43832,22801,22275
10053317,10053313,TXFE7,128,9939,4,43836,22802,22279
10053354,10053348,TXFE7,128,9938,7,43843,22809,22280
10053517,10053506,TXFE7,128,9938,1,43844,22810,22281
10053579,10053578,TXFE7,128,9939,1,43845,22811,22282
10053604,10053595,TXFE7,128,9939,1,43846,22812,22283
10053842,10053841,TXFE7,128,9939,1,43847,22813,22284
10053942,10053930,TXFE7,128,9939,1,43848,22814,22285
10054017,10054015,TXFE7,128,9939,1,43849,22815,22286
10054079,10054073,TXFE7,128,9938,5,43854,22819,22287
10054129,10054118,TXFE7,128,9938,1,43855,22820,22288
10054129,10054122,TXFE7,128,9939,3,43858,22821,22291
10054167,10054157,TXFE7,128,9938,1,43859,22822,22292
10054329,10054328,TXFE7,128,9939,1,43860,22823,22293
10054392,10054386,TXFE7,128,9938,2,43862,22825,22294
10054617,10054604,TXFE7,128,9938,1,43863,22826,22295
10055079,10055076,TXFE7,128,9938,1,43864,22827,22296
10055092,10055087,TXFE7,128,9939,1,43865,22828,22297
10055154,10055149,TXFE7,128,9938,1,43866,22829,22298
10055204,10055199,TXFE7,128,9938,1,43867,22830,22299
10055204,10055201,TXFE7,128,9938,1,43868,22831,22300
10055304,10055295,TXFE7,128,9939,1,43869,22832,22301
10055329,10055326,TXFE7,128,9938,1,43870,22833,22302
10055567,10055558,TXFE7,128,9938,5,43875,22836,22303
10055879,10055869,TXFE7,128,9939,1,43876,22837,22304
10055954,10055951,TXFE7,128,9938,1,43877,22838,22305
10060054,10060048,TXFE7,128,9938,1,43878,22839,22306
10060067,10060057,TXFE7,128,9939,1,43879,22840,22307
10060154,10060150,TXFE7,128,9939,4,43883,22841,22311
10060179,10060176,TXFE7,128,9939,1,43884,22842,22312
10060229,10060222,TXFE7,128,9939,3,43887,22843,22314
10060267,10060260,TXFE7,128,9939,1,43888,22844,22315
10060279,10060268,TXFE7,128,9939,1,43889,22845,22316
10060292,10060286,TXFE7,128,9939,1,43890,22846,22317
10060292,10060289,TXFE7,128,9939,14,43904,22847,22325
10060379,10060368,TXFE7,128,9940,1,43905,22848,22326
10060429,10060427,TXFE7,128,9939,1,43906,22849,22327
10060504,10060504,TXFE7,128,9940,2,43908,22850,22328
10061092,10061084,TXFE7,128,9939,1,43909,22851,22329
10061104,10061098,TXFE7,128,9940,2,43911,22852,22331
10061754,10061750,TXFE7,128,9940,4,43915,22853,22335
10062179,10062169,TXFE7,128,9940,8,43923,22854,22342
10062192,10062180,TXFE7,128,9940,1,43924,22855,22343
10062329,10062327,TXFE7,128,9939,1,43925,22856,22344
10062879,10062867,TXFE7,128,9939,1,43926,22857,22345
10063154,10063150,TXFE7,128,9939,4,43930,22858,22346
10063542,10063532,TXFE7,128,9940,5,43935,22859,22350
10063567,10063554,TXFE7,128,9939,5,43940,22861,22351
10063717,10063705,TXFE7,128,9939,1,43941,22862,22352
10063717,10063714,TXFE7,128,9939,1,43942,22863,22353
10063954,10063946,TXFE7,128,9939,1,43943,22864,22354
10063992,10063989,TXFE7,128,9940,1,43944,22865,22355
10064067,10064058,TXFE7,128,9939,20,43964,22878,22356
10064079,10064067,TXFE7,128,9939,4,43968,22879,22357
10064079,10064067,TXFE7,128,9939,4,43972,22881,22358
10064167,10064156,TXFE7,128,9939,2,43974,22883,22359
10064192,10064192,TXFE7,128,9939,1,43975,22884,22360
10064254,10064243,TXFE7,128,9939,2,43977,22885,22362
10064329,10064317,TXFE7,128,9939,1,43978,22886,22363
10064417,10064413,TXFE7,128,9939,1,43979,22887,22364
10064504,10064504,TXFE7,128,9939,1,43980,22888,22365
10065279,10065279,TXFE7,128,9939,1,43981,22889,22366
10065379,10065372,TXFE7,128,9939,1,43982,22890,22367
10065642,10065635,TXFE7,128,9939,3,43985,22892,22368
10065729,10065717,TXFE7,128,9939,1,43986,22893,22369
10065804,10065796,TXFE7,128,9939,1,43987,22894,22370
10070029,10070026,TXFE7,128,9939,1,43988,22895,22371
10070117,10070109,TXFE7,128,9939,1,43989,22896,22372
10070192,10070180,TXFE7,128,9939,1,43990,22897,22373
10070617,10070608,TXFE7,128,9939,1,43991,22898,22374
10070617,10070616,TXFE7,128,9939,1,43992,22899,22375
10070829,10070822,TXFE7,128,9939,1,43993,22900,22376
10070842,10070836,TXFE7,128,9939,1,43994,22901,22377
10071004,10071003,TXFE7,128,9939,1,43995,22902,22378
10071029,10071027,TXFE7,128,9939,1,43996,22903,22379
10071304,10071295,TXFE7,128,9939,1,43997,22904,22380
10071417,10071406,TXFE7,128,9939,2,43999,22905,22381
10071567,10071563,TXFE7,128,9939,1,44000,22906,22382
10071567,10071564,TXFE7,128,9939,1,44001,22907,22383
10071567,10071564,TXFE7,128,9939,1,44002,22908,22384
10071567,10071564,TXFE7,128,9939,8,44010,22913,22385
10071567,10071564,TXFE7,128,9939,4,44014,22916,22386
10071592,10071579,TXFE7,128,9939,1,44015,22917,22387
10071704,10071694,TXFE7,128,9939,1,44016,22918,22388
10071979,10071979,TXFE7,128,9939,1,44017,22919,22389
10072342,10072340,TXFE7,128,9939,2,44019,22920,22391
10072967,10072966,TXFE7,128,9939,1,44020,22921,22392
10073367,10073365,TXFE7,128,9939,1,44021,22922,22393
10073392,10073381,TXFE7,128,9938,1,44022,22923,22394
10073404,10073402,TXFE7,128,9939,1,44023,22924,22395
10073417,10073410,TXFE7,128,9938,20,44043,22934,22396
10073429,10073417,TXFE7,128,9938,44,44087,22961,22397
10073529,10073529,TXFE7,128,9937,56,44143,22999,22398
10073542,10073530,TXFE7,128,9936,7,44150,23005,22399
10073542,10073538,TXFE7,128,9937,1,44151,23006,22400
10073554,10073543,TXFE7,128,9936,2,44153,23008,22401
10073554,10073544,TXFE7,128,9936,1,44154,23009,22402
10073554,10073546,TXFE7,128,9936,3,44157,23012,22403
10073554,10073548,TXFE7,128,9936,1,44158,23013,22404
10073554,10073553,TXFE7,128,9937,1,44159,23014,22405
10073567,10073555,TXFE7,128,9936,3,44162,23017,22406
10073567,10073557,TXFE7,128,9936,1,44163,23018,22407
10073567,10073559,TXFE7,128,9936,1,44164,23019,22408
10073579,10073567,TXFE7,128,9936,2,44166,23020,22409
10073604,10073594,TXFE7,128,9936,2,44168,23021,22410
10073617,10073605,TXFE7,128,9936,7,44175,23025,22411
10073617,10073611,TXFE7,128,9936,1,44176,23026,22412
10073629,10073623,TXFE7,128,9937,1,44177,23027,22413
10073679,10073676,TXFE7,128,9936,1,44178,23028,22414
10073717,10073710,TXFE7,128,9937,2,44180,23029,22415
10073754,10073752,TXFE7,128,9936,9,44189,23038,22416
10073779,10073774,TXFE7,128,9937,1,44190,23039,22417
10073842,10073834,TXFE7,128,9937,1,44191,23040,22418
10073854,10073847,TXFE7,128,9936,1,44192,23041,22419
10073917,10073909,TXFE7,128,9937,1,44193,23042,22420
10073929,10073928,TXFE7,128,9937,4,44197,23043,22424
10073992,10073983,TXFE7,128,9936,1,44198,23044,22425
10074004,10073993,TXFE7,128,9936,2,44200,23046,22426
10074004,10073994,TXFE7,128,9936,2,44202,23047,22427
10074004,10073994,TXFE7,128,9936,2,44204,23048,22428
10074004,10073996,TXFE7,128,9936,1,44205,23049,22429
10074004,10073998,TXFE7,128,9936,1,44206,23050,22430
10074004,10074002,TXFE7,128,9936,1,44207,23051,22431
10074067,10074061,TXFE7,128,9937,1,44208,23052,22432
10074079,10074071,TXFE7,128,9938,4,44212,23053,22434
10074079,10074072,TXFE7,128,9937,2,44214,23054,22435
10074079,10074073,TXFE7,128,9937,2,44216,23055,22436
10074092,10074080,TXFE7,128,9937,1,44217,23056,22437
10074117,10074115,TXFE7,128,9937,1,44218,23057,22438
10074142,10074136,TXFE7,128,9938,1,44219,23058,22439
10074179,10074169,TXFE7,128,9937,1,44220,23059,22440
10074179,10074171,TXFE7,128,9937,2,44222,23060,22441
10074179,10074176,TXFE7,128,9937,2,44224,23062,22442
10074192,10074181,TXFE7,128,9938,1,44225,23063,22443
10074192,10074189,TXFE7,128,9937,1,44226,23064,22444
10074204,10074201,TXFE7,128,9937,1,44227,23065,22445
10074379,10074375,TXFE7,128,9937,2,44229,23066,22446
10074529,10074518,TXFE7,128,9937,1,44230,23067,22447
10074642,10074639,TXFE7,128,9937,1,44231,23068,22448
10074667,10074659,TXFE7,128,9937,1,44232,23069,22449
10074704,10074698,TXFE7,128,9937,8,44240,23073,22450
10074742,10074737,TXFE7,128,9937,1,44241,23074,22451
10074767,10074763,TXFE7,128,9937,5,44246,23077,22452
10074804,10074804,TXFE7,128,9937,5,44251,23082,22453
10074829,10074826,TXFE7,128,9937,1,44252,23083,22454
10074854,10074844,TXFE7,128,9936,1,44253,23084,22455
10074867,10074862,TXFE7,128,9937,1,44254,23085,22456
10075079,10075072,TXFE7,128,9936,2,44256,23086,22457
10075079,10075076,TXFE7,128,9936,2,44258,23087,22458
10075079,10075077,TXFE7,128,9936,2,44260,23088,22459
10075079,10075078,TXFE7,128,9936,2,44262,23089,22460
10075092,10075080,TXFE7,128,9936,2,44264,23090,22461
10075254,10075245,TXFE7,128,9937,1,44265,23091,22462
10075292,10075292,TXFE7,128,9936,1,44266,23092,22463
10075304,10075293,TXFE7,128,9936,1,44267,23093,22464
10075329,10075326,TXFE7,128,9936,1,44268,23094,22465
10075354,10075348,TXFE7,128,9937,1,44269,23095,22466
10075404,10075402,TXFE7,128,9936,5,44274,23096,22467
10075417,10075404,TXFE7,128,9936,1,44275,23097,22468
10075492,10075487,TXFE7,128,9936,1,44276,23098,22469
10075617,10075616,TXFE7,128,9936,1,44277,23099,22470
10075979,10075974,TXFE7,128,9936,2,44279,23100,22471
10080017,10080008,TXFE7,128,9936,1,44280,23101,22472
10080029,10080020,TXFE7,128,9937,2,44282,23102,22474
10080029,10080023,TXFE7,128,9936,1,44283,23103,22475
10080029,10080023,TXFE7,128,9936,1,44284,23104,22476
10080029,10080025,TXFE7,128,9936,1,44285,23105,22477
10080029,10080026,TXFE7,128,9936,1,44286,23106,22478
10080029,10080027,TXFE7,128,9936,1,44287,23107,22479
10080029,10080027,TXFE7,128,9936,1,44288,23108,22480
10080029,10080029,TXFE7,128,9936,1,44289,23109,22481
10080042,10080031,TXFE7,128,9936,1,44290,23110,22482
10080042,10080032,TXFE7,128,9936,1,44291,23111,22483
10080079,10080078,TXFE7,128,9936,1,44292,23112,22484
10080192,10080189,TXFE7,128,9936,1,44293,23113,22485
10080217,10080214,TXFE7,128,9937,1,44294,23114,22486
10080242,10080232,TXFE7,128,9936,1,44295,23115,22487
10080317,10080310,TXFE7,128,9936,1,44296,23116,22488
10080342,10080337,TXFE7,128,9936,1,44297,23117,22489
10080417,10080417,TXFE7,128,9937,1,44298,23118,22490
10080529,10080528,TXFE7,128,9936,1,44299,23119,22491
10080529,10080529,TXFE7,128,9936,1,44300,23120,22492
10080542,10080531,TXFE7,128,9936,1,44301,23121,22493
10080579,10080573,TXFE7,128,9936,1,44302,23122,22494
10080579,10080574,TXFE7,128,9936,2,44304,23123,22495
10080579,10080576,TXFE7,128,9936,1,44305,23124,22496
10080579,10080577,TXFE7,128,9936,2,44307,23125,22497
10080592,10080580,TXFE7,128,9936,2,44309,23126,22498
10080592,10080586,TXFE7,128,9936,1,44310,23127,22499
10080642,10080636,TXFE7,128,9936,1,44311,23128,22500
10080729,10080718,TXFE7,128,9936,1,44312,23129,22501
10080767,10080766,TXFE7,128,9936,2,44314,23130,22502
10080967,10080956,TXFE7,128,9936,1,44315,23131,22503
10080979,10080970,TXFE7,128,9937,1,44316,23132,22504
10081004,10080997,TXFE7,128,9937,1,44317,23133,22505
10081079,10081072,TXFE7,128,9936,2,44319,23134,22506
10081079,10081076,TXFE7,128,9936,2,44321,23135,22507
10081192,10081183,TXFE7,128,9937,1,44322,23136,22508
10081192,10081185,TXFE7,128,9937,1,44323,23137,22509
10081279,10081271,TXFE7,128,9937,20,44343,23138,22519
10081304,10081302,TXFE7,128,9936,2,44345,23139,22520
10081417,10081412,TXFE7,128,9936,1,44346,23140,22521
10081454,10081445,TXFE7,128,9937,1,44347,23141,22522
10081467,10081455,TXFE7,128,9936,89,44436,23183,22523
10081467,10081459,TXFE7,128,9936,1,44437,23184,22524
10081479,10081472,TXFE7,128,9935,2,44439,23186,22525
10081492,10081479,TXFE7,128,9935,4,44443,23188,22526
10081492,10081480,TXFE7,128,9935,5,44448,23192,22527
10081492,10081488,TXFE7,128,9935,1,44449,23193,22528
10081492,10081488,TXFE7,128,9935,1,44450,23194,22529
10081492,10081491,TXFE7,128,9935,1,44451,23195,22530
10081504,10081492,TXFE7,128,9935,4,44455,23198,22531
10081504,10081500,TXFE7,128,9935,2,44457,23199,22532
10081504,10081502,TXFE7,128,9936,1,44458,23200,22533
10081517,10081505,TXFE7,128,9935,4,44462,23201,22534
10081517,10081506,TXFE7,128,9935,1,44463,23202,22535
10081517,10081506,TXFE7,128,9935,1,44464,23203,22536
10081517,10081509,TXFE7,128,9935,1,44465,23204,22537
10081517,10081515,TXFE7,128,9935,1,44466,23205,22538
10081517,10081517,TXFE7,128,9936,2,44468,23206,22540
10081542,10081530,TXFE7,128,9935,1,44469,23207,22541
10081554,10081546,TXFE7,128,9935,1,44470,23208,22542
10081554,10081553,TXFE7,128,9935,1,44471,23209,22543
10081567,10081554,TXFE7,128,9936,1,44472,23210,22544
10081604,10081598,TXFE7,128,9935,1,44473,23211,22545
10081604,10081604,TXFE7,128,9935,1,44474,23212,22546
10081629,10081623,TXFE7,128,9936,1,44475,23213,22547
10081792,10081785,TXFE7,128,9935,5,44480,23215,22548
10081817,10081816,TXFE7,128,9935,1,44481,23216,22549
10081829,10081818,TXFE7,128,9935,2,44483,23218,22550
10081829,10081828,TXFE7,128,9935,1,44484,23219,22551
10081854,10081852,TXFE7,128,9935,1,44485,23220,22552
10081892,10081885,TXFE7,128,9935,1,44486,23221,22553
10081904,10081903,TXFE7,128,9935,1,44487,23222,22554
10081942,10081931,TXFE7,128,9935,3,44490,23225,22555
10081954,10081950,TXFE7,128,9935,1,44491,23226,22556
10081954,10081952,TXFE7,128,9935,1,44492,23227,22557
10081954,10081953,TXFE7,128,9935,1,44493,23228,22558
10081967,10081955,TXFE7,128,9935,1,44494,23229,22559
10082017,10082009,TXFE7,128,9935,1,44495,23230,22560
10082042,10082033,TXFE7,128,9935,1,44496,23231,22561
10082054,10082052,TXFE7,128,9935,1,44497,23232,22562
10082092,10082084,TXFE7,128,9935,1,44498,23233,22563
10082104,10082096,TXFE7,128,9935,1,44499,23234,22564
10082104,10082098,TXFE7,128,9935,2,44501,23236,22565
10082179,10082178,TXFE7,128,9935,1,44502,23237,22566
10082192,10082180,TXFE7,128,9935,1,44503,23238,22567
10082204,10082196,TXFE7,128,9935,1,44504,23239,22568
10082242,10082241,TXFE7,128,9935,17,44521,23247,22569
10082254,10082242,TXFE7,128,9935,6,44527,23251,22570
10082254,10082242,TXFE7,128,9935,15,44542,23263,22571
10082267,10082259,TXFE7,128,9935,1,44543,23264,22572
10082267,10082260,TXFE7,128,9934,1,44544,23265,22573
10082279,10082270,TXFE7,128,9934,1,44545,23266,22574
10082279,10082270,TXFE7,128,9934,1,44546,23267,22575
10082279,10082273,TXFE7,128,9934,1,44547,23268,22576
10082279,10082276,TXFE7,128,9934,1,44548,23269,22577
10082292,10082282,TXFE7,128,9934,1,44549,23270,22578
10082292,10082285,TXFE7,128,9934,1,44550,23271,22579
10082292,10082285,TXFE7,128,9934,7,44557,23276,22580
10082292,10082286,TXFE7,128,9934,2,44559,23277,22581
10082292,10082291,TXFE7,128,9934,1,44560,23278,22582
10082304,10082292,TXFE7,128,9934,1,44561,23279,22583
10082304,10082295,TXFE7,128,9934,1,44562,23280,22584
10082304,10082301,TXFE7,128,9934,3,44565,23282,22585
10082317,10082314,TXFE7,128,9934,1,44566,23283,22586
10082317,10082316,TXFE7,128,9934,1,44567,23284,22587
10082329,10082317,TXFE7,128,9934,2,44569,23285,22588
10082329,10082321,TXFE7,128,9934,1,44570,23286,22589
10082329,10082324,TXFE7,128,9934,1,44571,23287,22590
10082329,10082327,TXFE7,128,9934,10,44581,23296,22591
10082342,10082330,TXFE7,128,9934,2,44583,23298,22592
10082342,10082330,TXFE7,128,9934,1,44584,23299,22593
10082342,10082332,TXFE7,128,9934,1,44585,23300,22594
10082342,10082334,TXFE7,128,9934,1,44586,23301,22595
10082342,10082334,TXFE7,128,9934,1,44587,23302,22596
10082342,10082335,TXFE7,128,9934,1,44588,23303,22597
10082342,10082335,TXFE7,128,9934,1,44589,23304,22598
10082342,10082337,TXFE7,128,9934,1,44590,23305,22599
10082342,10082338,TXFE7,128,9934,1,44591,23306,22600
10082342,10082339,TXFE7,128,9934,1,44592,23307,22601
10082342,10082340,TXFE7,128,9934,2,44594,23309,22602
10082342,10082340,TXFE7,128,9934,1,44595,23310,22603
10082354,10082350,TXFE7,128,9934,1,44596,23311,22604
10082354,10082350,TXFE7,128,9934,1,44597,23312,22605
10082354,10082351,TXFE7,128,9934,1,44598,23313,22606
10082367,10082355,TXFE7,128,9934,2,44600,23315,22607
10082367,10082357,TXFE7,128,9934,1,44601,23316,22608
10082367,10082359,TXFE7,128,9934,1,44602,23317,22609
10082392,10082382,TXFE7,128,9934,1,44603,23318,22610
10082429,10082421,TXFE7,128,9934,1,44604,23319,22611
10082467,10082458,TXFE7,128,9934,1,44605,23320,22612
10082467,10082461,TXFE7,128,9934,1,44606,23321,22613
10082479,10082467,TXFE7,128,9935,4,44610,23322,22616
10082479,10082467,TXFE7,128,9935,1,44611,23323,22617
10082479,10082476,TXFE7,128,9935,2,44613,23324,22619
10082492,10082479,TXFE7,128,9935,1,44614,23325,22620
10082492,10082481,TXFE7,128,9935,1,44615,23326,22621
10082492,10082482,TXFE7,128,9934,1,44616,23327,22622
10082504,10082495,TXFE7,128,9934,2,44618,23328,22623
10082517,10082507,TXFE7,128,9934,1,44619,23329,22624
10082542,10082540,TXFE7,128,9935,1,44620,23330,22625
10082554,10082548,TXFE7,128,9934,8,44628,23333,22626
10082554,10082549,TXFE7,128,9934,2,44630,23334,22627
10082554,10082550,TXFE7,128,9934,12,44642,23338,22628
10082554,10082551,TXFE7,128,9934,9,44651,23342,22629
10082567,10082557,TXFE7,128,9935,1,44652,23343,22630
10082579,10082569,TXFE7,128,9935,1,44653,23344,22631
10082592,10082583,TXFE7,128,9935,1,44654,23345,22632
10082592,10082586,TXFE7,128,9934,1,44655,23346,22633
10082654,10082644,TXFE7,128,9935,1,44656,23347,22634
10082654,10082648,TXFE7,128,9934,3,44659,23349,22635
10082654,10082651,TXFE7,128,9934,1,44660,23350,22636
10082679,10082671,TXFE7,128,9935,1,44661,23351,22637
10082729,10082717,TXFE7,128,9935,1,44662,23352,22638
10082754,10082748,TXFE7,128,9934,1,44663,23353,22639
10082779,10082769,TXFE7,128,9934,1,44664,23354,22640
10082779,10082775,TXFE7,128,9934,1,44665,23355,22641
10082867,10082862,TXFE7,128,9934,1,44666,23356,22642
10083004,10083001,TXFE7,128,9934,1,44667,23357,22643
10083142,10083134,TXFE7,128,9935,2,44669,23358,22645
10083154,10083147,TXFE7,128,9935,1,44670,23359,22646
10083204,10083197,TXFE7,128,9934,2,44672,23361,22647
10083342,10083330,TXFE7,128,9934,1,44673,23362,22648
10083342,10083332,TXFE7,128,9934,6,44679,23363,22649
10083367,10083355,TXFE7,128,9934,21,44700,23378,22650
10083429,10083422,TXFE7,128,9934,2,44702,23379,22652
10083479,10083478,TXFE7,128,9934,1,44703,23380,22653
10083492,10083490,TXFE7,128,9934,1,44704,23381,22654
10083529,10083521,TXFE7,128,9934,1,44705,23382,22655
10083642,10083632,TXFE7,128,9934,1,44706,23383,22656
10083654,10083649,TXFE7,128,9934,3,44709,23385,22657
10083767,10083765,TXFE7,128,9934,1,44710,23386,22658
10083817,10083806,TXFE7,128,9934,2,44712,23388,22659
10083842,10083831,TXFE7,128,9934,1,44713,23389,22660
10083842,10083840,TXFE7,128,9934,2,44715,23391,22661
10083954,10083950,TXFE7,128,9934,1,44716,23392,22662
10083967,10083963,TXFE7,128,9934,1,44717,23393,22663
10083967,10083965,TXFE7,128,9934,2,44719,23395,22664
10083992,10083984,TXFE7,128,9934,2,44721,23397,22665
10084004,10083994,TXFE7,128,9935,3,44724,23398,22667
10084017,10084014,TXFE7,128,9935,4,44728,23399,22668
10084042,10084040,TXFE7,128,9934,1,44729,23400,22669
10084054,10084044,TXFE7,128,9934,1,44730,23401,22670
10084054,10084049,TXFE7,128,9934,1,44731,23402,22671
10084079,10084078,TXFE7,128,9934,2,44733,23403,22672
10084092,10084083,TXFE7,128,9935,41,44774,23404,22682
10084104,10084095,TXFE7,128,9935,10,44784,23405,22685
10084104,10084097,TXFE7,128,9934,1,44785,23406,22686
10084117,10084104,TXFE7,128,9935,1,44786,23407,22687
10084117,10084104,TXFE7,128,9935,1,44787,23408,22688
10084154,10084143,TXFE7,128,9934,1,44788,23409,22689
10084242,10084240,TXFE7,128,9935,1,44789,23410,22690
10084279,10084278,TXFE7,128,9934,1,44790,23411,22691
10084292,10084280,TXFE7,128,9934,1,44791,23412,22692
10084304,10084304,TXFE7,128,9934,1,44792,23413,22693
10084404,10084402,TXFE7,128,9934,1,44793,23414,22694
10084417,10084410,TXFE7,128,9934,1,44794,23415,22695
10084454,10084446,TXFE7,128,9935,1,44795,23416,22696
10084517,10084510,TXFE7,128,9934,2,44797,23417,22697
10084554,10084548,TXFE7,128,9935,1,44798,23418,22698
10084579,10084570,TXFE7,128,9935,14,44812,23419,22709
10084604,10084592,TXFE7,128,9935,2,44814,23420,22710
10084617,10084609,TXFE7,128,9934,1,44815,23421,22711
10084704,10084703,TXFE7,128,9935,1,44816,23422,22712
10084879,10084872,TXFE7,129,9935,1,44818,23424,22713
10084879,10084872,TXFE7,129,9934,1,44818,23424,22713
10084879,10084877,TXFE7,128,9934,1,44819,23425,22714
10084904,10084897,TXFE7,128,9936,1,44820,23426,22715
10084917,10084911,TXFE7,128,9934,2,44822,23427,22716
10085067,10085058,TXFE7,128,9935,1,44823,23428,22717
10085092,10085080,TXFE7,128,9935,1,44824,23429,22718
10085254,10085254,TXFE7,128,9934,2,44826,23430,22719
10085254,10085254,TXFE7,128,9935,2,44828,23431,22721
10085304,10085292,TXFE7,128,9934,2,44830,23432,22722
10085329,10085317,TXFE7,128,9935,1,44831,23433,22723
10085329,10085319,TXFE7,128,9935,1,44832,23434,22724
10085367,10085361,TXFE7,128,9934,1,44833,23435,22725
10085404,10085394,TXFE7,128,9935,1,44834,23436,22726
10085504,10085494,TXFE7,128,9935,1,44835,23437,22727
10085517,10085511,TXFE7,128,9935,1,44836,23438,22728
10085542,10085541,TXFE7,128,9934,1,44837,23439,22729
10085567,10085562,TXFE7,128,9935,1,44838,23440,22730
10085592,10085590,TXFE7,128,9935,3,44841,23441,22731
10085704,10085700,TXFE7,128,9934,1,44842,23442,22732
10085867,10085863,TXFE7,128,9934,1,44843,23443,22733
10085892,10085880,TXFE7,128,9935,1,44844,23444,22734
10085917,10085916,TXFE7,128,9934,1,44845,23445,22735
10085967,10085954,TXFE7,128,9934,2,44847,23447,22736
10090042,10090041,TXFE7,128,9934,1,44848,23448,22737
10090054,10090049,TXFE7,128,9935,1,44849,23449,22738
10090054,10090053,TXFE7,128,9934,1,44850,23450,22739
10090054,10090053,TXFE7,128,9934,1,44851,23451,22740
10090079,10090074,TXFE7,128,9934,2,44853,23453,22741
10090079,10090075,TXFE7,128,9934,1,44854,23454,22742
10090079,10090075,TXFE7,128,9934,2,44856,23455,22743
10090092,10090082,TXFE7,128,9934,2,44858,23456,22744
10090092,10090091,TXFE7,128,9934,2,44860,23457,22745
10090104,10090096,TXFE7,128,9934,1,44861,23458,22746
10090117,10090107,TXFE7,128,9934,1,44862,23459,22747
10090154,10090143,TXFE7,128,9935,1,44863,23460,22748
10090154,10090149,TXFE7,128,9934,1,44864,23461,22749
10090154,10090150,TXFE7,128,9935,10,44874,23462,22755
10090154,10090154,TXFE7,128,9934,1,44875,23463,22756
10090179,10090172,TXFE7,128,9934,1,44876,23464,22757
10090192,10090184,TXFE7,128,9934,1,44877,23465,22758
10090204,10090195,TXFE7,128,9934,4,44881,23466,22759
10090217,10090207,TXFE7,128,9935,1,44882,23467,22760
10090217,10090214,TXFE7,128,9934,1,44883,23468,22761
10090229,10090219,TXFE7,128,9934,1,44884,23469,22762
10090229,10090223,TXFE7,128,9934,1,44885,23470,22763
10090229,10090224,TXFE7,128,9934,1,44886,23471,22764
10090242,10090236,TXFE7,128,9934,1,44887,23472,22765
10090254,10090251,TXFE7,128,9934,1,44888,23473,22766
10090267,10090264,TXFE7,128,9934,1,44889,23474,22767
10090279,10090275,TXFE7,128,9934,1,44890,23475,22768
10090292,10090288,TXFE7,128,9934,1,44891,23476,22769
10090317,10090312,TXFE7,128,9934,1,44892,23477,22770
10090342,10090339,TXFE7,128,9934,1,44893,23478,22771
10090354,10090348,TXFE7,128,9934,1,44894,23479,22772
10090367,10090363,TXFE7,128,9934,1,44895,23480,22773
10090404,10090398,TXFE7,128,9934,1,44896,23481,22774
10090417,10090415,TXFE7,128,9934,1,44897,23482,22775
10090429,10090422,TXFE7,128,9934,1,44898,23483,22776
10090442,10090433,TXFE7,128,9934,1,44899,23484,22777
10090454,10090453,TXFE7,128,9934,1,44900,23485,22778
10090467,10090460,TXFE7,128,9934,1,44901,23486,22779
10090467,10090465,TXFE7,128,9934,1,44902,23487,22780
10090492,10090482,TXFE7,128,9934,1,44903,23488,22781
10090554,10090550,TXFE7,128,9934,1,44904,23489,22782
10090567,10090560,TXFE7,128,9934,4,44908,23491,22783
10090692,10090692,TXFE7,128,9934,1,44909,23492,22784
10090754,10090745,TXFE7,128,9934,2,44911,23494,22785
10090767,10090765,TXFE7,128,9935,1,44912,23495,22786
10091017,10091012,TXFE7,128,9935,2,44914,23496,22787
10091154,10091151,TXFE7,128,9935,2,44916,23497,22789
10091167,10091161,TXFE7,128,9935,1,44917,23498,22790
10091179,10091170,TXFE7,128,9934,2,44919,23500,22791
10091492,10091481,TXFE7,128,9934,5,44924,23505,22792
10091554,10091544,TXFE7,128,9934,1,44925,23506,22793
10091567,10091556,TXFE7,128,9934,3,44928,23508,22794
10091704,10091702,TXFE7,128,9934,1,44929,23509,22795
10091717,10091710,TXFE7,128,9935,1,44930,23510,22796
10091804,10091800,TXFE7,128,9935,1,44931,23511,22797
10091879,10091874,TXFE7,128,9935,15,44946,23512,22809
10091892,10091887,TXFE7,128,9935,1,44947,23513,22810
10092004,10092003,TXFE7,128,9935,1,44948,23514,22811
10092054,10092049,TXFE7,128,9935,1,44949,23515,22812
10092079,10092067,TXFE7,128,9935,3,44952,23516,22815
10092079,10092077,TXFE7,128,9936,1,44953,23517,22816
10092129,10092123,TXFE7,128,9935,2,44955,23519,22817
10092179,10092178,TXFE7,128,9935,1,44956,23520,22818
10092217,10092204,TXFE7,128,9935,1,44957,23521,22819
10092267,10092257,TXFE7,128,9935,1,44958,23522,22820
10092279,10092270,TXFE7,128,9935,1,44959,23523,22821
10092304,10092298,TXFE7,128,9935,5,44964,23524,22822
10092479,10092477,TXFE7,128,9934,1,44965,23525,22823
10092517,10092514,TXFE7,128,9935,1,44966,23526,22824
10092854,10092849,TXFE7,128,9935,1,44967,23527,22825
10092892,10092890,TXFE7,128,9934,2,44969,23529,22826
10092929,10092926,TXFE7,128,9935,1,44970,23530,22827
10092942,10092930,TXFE7,128,9935,1,44971,23531,22828
10093004,10093000,TXFE7,128,9935,1,44972,23532,22829
10093067,10093061,TXFE7,128,9935,1,44973,23533,22830
10093129,10093119,TXFE7,128,9935,1,44974,23534,22831
10093142,10093130,TXFE7,128,9934,20,44994,23541,22832
10093229,10093221,TXFE7,128,9935,1,44995,23542,22833
10093467,10093458,TXFE7,128,9934,1,44996,23543,22834
10093754,10093742,TXFE7,128,9934,10,45006,23552,22835
10093779,10093767,TXFE7,128,9934,3,45009,23555,22836
10093992,10093985,TXFE7,128,9934,2,45011,23557,22837
10094054,10094054,TXFE7,128,9934,1,45012,23558,22838
10094142,10094134,TXFE7,128,9934,1,45013,23559,22839
10094254,10094251,TXFE7,128,9934,1,45014,23560,22840
10094292,10094291,TXFE7,128,9934,2,45016,23562,22841
10094317,10094311,TXFE7,128,9934,2,45018,23564,22842
10094367,10094358,TXFE7,128,9935,1,45019,23565,22843
10094379,10094375,TXFE7,128,9934,1,45020,23566,22844
10094629,10094622,TXFE7,128,9934,1,45021,23567,22845
10094729,10094728,TXFE7,128,9935,1,45022,23568,22846
10094754,10094746,TXFE7,128,9935,1,45023,23569,22847
10094792,10094787,TXFE7,128,9934,1,45024,23570,22848
10094954,10094942,TXFE7,128,9934,1,45025,23571,22849
10095267,10095260,TXFE7,128,9934,17,45042,23584,22850
10095304,10095293,TXFE7,128,9934,2,45044,23585,22851
10095329,10095324,TXFE7,128,9934,1,45045,23586,22852
10095367,10095361,TXFE7,128,9935,2,45047,23587,22853
10095379,10095371,TXFE7,128,9934,1,45048,23588,22854
10095392,10095390,TXFE7,128,9934,5,45053,23593,22855
10095404,10095400,TXFE7,128,9934,1,45054,23594,22856
10095417,10095412,TXFE7,128,9934,1,45055,23595,22857
10095504,10095500,TXFE7,128,9934,1,45056,23596,22858
10095517,10095509,TXFE7,128,9934,1,45057,23597,22859
10095554,10095543,TXFE7,128,9934,1,45058,23598,22860
10095617,10095607,TXFE7,128,9934,1,45059,23599,22861
10095617,10095611,TXFE7,128,9934,1,45060,23600,22862
10095617,10095616,TXFE7,128,9934,4,45064,23601,22863
10095629,10095620,TXFE7,128,9935,1,45065,23602,22864
10095654,10095644,TXFE7,128,9934,4,45069,23603,22865
10095654,10095648,TXFE7,128,9934,1,45070,23604,22866
10095704,10095704,TXFE7,128,9934,2,45072,23606,22867
10095879,10095869,TXFE7,128,9934,1,45073,23607,22868
10095892,10095879,TXFE7,128,9934,3,45076,23608,22870
10095917,10095907,TXFE7,128,9934,2,45078,23609,22871
10095917,10095916,TXFE7,128,9934,1,45079,23610,22872
10095979,10095972,TXFE7,128,9934,5,45084,23612,22873
10100029,10100018,TXFE7,128,9934,1,45085,23613,22874
10100042,10100034,TXFE7,128,9935,1,45086,23614,22875
10100067,10100059,TXFE7,128,9934,1,45087,23615,22876
10100067,10100065,TXFE7,128,9934,4,45091,23617,22877
10100092,10100088,TXFE7,128,9934,3,45094,23618,22878
10100154,10100154,TXFE7,128,9934,10,45104,23622,22879
10100179,10100174,TXFE7,128,9934,1,45105,23623,22880
10100179,10100179,TXFE7,128,9933,1,45106,23624,22881
10100192,10100183,TXFE7,128,9933,1,45107,23625,22882
10100192,10100185,TXFE7,128,9933,2,45109,23627,22883
10100192,10100186,TXFE7,128,9933,4,45113,23631,22884
10100192,10100188,TXFE7,128,9933,1,45114,23632,22885
10100192,10100189,TXFE7,128,9933,1,45115,23633,22886
10100204,10100193,TXFE7,128,9933,6,45121,23636,22887
10100204,10100194,TXFE7,128,9934,2,45123,23637,22889
10100204,10100203,TXFE7,128,9934,1,45124,23638,22890
10100217,10100208,TXFE7,128,9933,1,45125,23639,22891
10100217,10100213,TXFE7,128,9933,1,45126,23640,22892
10100229,10100227,TXFE7,128,9933,1,45127,23641,22893
10100254,10100243,TXFE7,128,9933,2,45129,23642,22894
10100254,10100243,TXFE7,128,9933,1,45130,23643,22895
10100254,10100251,TXFE7,128,9934,4,45134,23644,22897
10100292,10100290,TXFE7,128,9933,1,45135,23645,22898
10100404,10100398,TXFE7,128,9933,1,45136,23646,22899
10100404,10100404,TXFE7,128,9934,1,45137,23647,22900
10100429,10100426,TXFE7,128,9933,1,45138,23648,22901
10100454,10100450,TXFE7,128,9934,1,45139,23649,22902
10100492,10100487,TXFE7,128,9933,1,45140,23650,22903
10100492,10100491,TXFE7,128,9934,1,45141,23651,22904
10100579,10100574,TXFE7,128,9934,1,45142,23652,22905
10100604,10100598,TXFE7,128,9934,1,45143,23653,22906
10100629,10100617,TXFE7,128,9934,4,45147,23654,22908
10100642,10100629,TXFE7,128,9934,1,45148,23655,22909
10100654,10100648,TXFE7,128,9934,1,45149,23656,22910
10100704,10100702,TXFE7,128,9934,2,45151,23657,22912
10100704,10100702,TXFE7,128,9934,1,45152,23658,22913
10100717,10100714,TXFE7,128,9935,1,45153,23659,22914
10100729,10100725,TXFE7,129,9934,1,45155,23661,22915
10100729,10100725,TXFE7,129,9933,1,45155,23661,22915
10101029,10101023,TXFE7,128,9935,1,45156,23662,22916
10101054,10101052,TXFE7,128,9934,1,45157,23663,22917
10101217,10101210,TXFE7,128,9934,2,45159,23664,22918
10101317,10101306,TXFE7,128,9934,1,45160,23665,22919
10101479,10101476,TXFE7,128,9934,1,45161,23666,22920
10101517,10101509,TXFE7,128,9934,2,45163,23667,22921
10101517,10101512,TXFE7,128,9934,2,45165,23668,22922
10101517,10101513,TXFE7,128,9934,1,45166,23669,22923
10101604,10101598,TXFE7,128,9934,1,45167,23670,22924
10101679,10101671,TXFE7,128,9935,2,45169,23671,22925
10101867,10101866,TXFE7,128,9934,1,45170,23672,22926
10101954,10101946,TXFE7,128,9935,1,45171,23673,22927
10101992,10101980,TXFE7,128,9934,3,45174,23674,22928
10101992,10101984,TXFE7,128,9934,1,45175,23675,22929
10102092,10102084,TXFE7,128,9934,2,45177,23676,22930
10102167,10102159,TXFE7,128,9934,2,45179,23678,22931
10102304,10102302,TXFE7,128,9935,14,45193,23679,22938
10102392,10102390,TXFE7,128,9934,1,45194,23680,22939
10102529,10102527,TXFE7,128,9934,5,45199,23684,22940
10102617,10102609,TXFE7,128,9934,2,45201,23686,22941
10102629,10102624,TXFE7,128,9935,1,45202,23687,22942
10102667,10102657,TXFE7,128,9934,2,45204,23688,22943
10102667,10102661,TXFE7,128,9934,1,45205,23689,22944
10102729,10102723,TXFE7,128,9934,1,45206,23690,22945
10103092,10103089,TXFE7,128,9934,1,45207,23691,22946
10103192,10103182,TXFE7,128,9934,1,45208,23692,22947
10103754,10103751,TXFE7,128,9934,6,45214,23698,22948
10103754,10103752,TXFE7,128,9934,5,45219,23701,22949
10103904,10103895,TXFE7,128,9934,4,45223,23703,22950
10103979,10103967,TXFE7,128,9934,2,45225,23704,22951
10104242,10104232,TXFE7,128,9934,1,45226,23705,22952
10104242,10104241,TXFE7,128,9934,8,45234,23709,22953
10104329,10104320,TXFE7,128,9934,8,45242,23710,22954
10104379,10104372,TXFE7,128,9934,1,45243,23711,22955
10104392,10104384,TXFE7,128,9934,1,45244,23712,22956
10104429,10104417,TXFE7,128,9934,2,45246,23713,22957
10104429,10104424,TXFE7,128,9934,6,45252,23716,22958
10104479,10104468,TXFE7,128,9934,5,45257,23720,22959
10104542,10104532,TXFE7,128,9934,1,45258,23721,22960
10104617,10104607,TXFE7,128,9934,2,45260,23722,22961
10104629,10104621,TXFE7,128,9934,1,45261,23723,22962
10104704,10104698,TXFE7,128,9934,10,45271,23726,22963
10104892,10104880,TXFE7,128,9934,6,45277,23727,22969
10105142,10105130,TXFE7,128,9934,1,45278,23728,22970
10105242,10105232,TXFE7,128,9934,3,45281,23729,22971
10105317,10105307,TXFE7,128,9934,3,45284,23730,22972
10105317,10105311,TXFE7,128,9934,5,45289,23731,22973
10105554,10105547,TXFE7,128,9935,1,45290,23732,22974
10105579,10105575,TXFE7,128,9935,1,45291,23733,22975
10105617,10105611,TXFE7,128,9935,1,45292,23734,22976
10105629,10105629,TXFE7,128,9935,1,45293,23735,22977
10105642,10105631,TXFE7,128,9934,1,45294,23736,22978
10105892,10105883,TXFE7,128,9934,1,45295,23737,22979
10105967,10105956,TXFE7,128,9934,3,45298,23738,22980
10110067,10110055,TXFE7,128,9935,1,45299,23739,22981
10110092,10110085,TXFE7,128,9934,1,45300,23740,22982
10110092,10110086,TXFE7,128,9934,1,45301,23741,22983
10110129,10110120,TXFE7,128,9934,4,45305,23743,22984
10110192,10110188,TXFE7,128,9935,1,45306,23744,22985
10110467,10110458,TXFE7,128,9934,2,45308,23745,22986
10110629,10110624,TXFE7,128,9934,1,45309,23746,22987
10111079,10111072,TXFE7,128,9934,1,45310,23747,22988
10111279,10111268,TXFE7,128,9935,1,45311,23748,22989
10111417,10111405,TXFE7,128,9935,1,45312,23749,22990
10111479,10111478,TXFE7,128,9935,1,45313,23750,22991
10111717,10111704,TXFE7,128,9935,1,45314,23751,22992
10111767,10111759,TXFE7,128,9935,1,45315,23752,22993
10111804,10111801,TXFE7,128,9935,2,45317,23753,22995
10112054,10112052,TXFE7,128,9935,25,45342,23754,23010
10112067,10112054,TXFE7,128,9935,38,45380,23755,23035
10112067,10112059,TXFE7,128,9935,1,45381,23756,23036
10112067,10112063,TXFE7,128,9936,1,45382,23757,23037
10112117,10112110,TXFE7,128,9936,2,45384,23758,23039
10112179,10112171,TXFE7,128,9935,2,45386,23759,23040
10112217,10112216,TXFE7,128,9936,1,45387,23760,23041
10112267,10112258,TXFE7,128,9935,1,45388,23761,23042
10112504,10112504,TXFE7,128,9935,1,45389,23762,23043
10112517,10112514,TXFE7,128,9936,1,45390,23763,23044
10112642,10112634,TXFE7,128,9936,1,45391,23764,23045
10112904,10112897,TXFE7,128,9936,1,45392,23765,23046
10112917,10112905,TXFE7,128,9936,1,45393,23766,23047
10113029,10113029,TXFE7,128,9936,1,45394,23767,23048
10113129,10113123,TXFE7,128,9935,3,45397,23770,23049
10114429,10114420,TXFE7,128,9936,1,45398,23771,23050
10114517,10114514,TXFE7,128,9935,1,45399,23772,23051
10114704,10114702,TXFE7,128,9935,1,45400,23773,23052
10114904,10114896,TXFE7,128,9936,21,45421,23774,23063
10115042,10115039,TXFE7,128,9936,1,45422,23775,23064
10115079,10115077,TXFE7,128,9936,1,45423,23776,23065
10115192,10115183,TXFE7,128,9936,1,45424,23777,23066
10115192,10115190,TXFE7,128,9935,1,45425,23778,23067
10115292,10115291,TXFE7,128,9936,9,45434,23779,23072
10115354,10115348,TXFE7,128,9936,8,45442,23780,23078
10115392,10115390,TXFE7,128,9937,1,45443,23781,23079
10115479,10115478,TXFE7,128,9937,1,45444,23782,23080
10115542,10115536,TXFE7,128,9936,1,45445,23783,23081
10115542,10115542,TXFE7,128,9937,2,45447,23784,23083
10115592,10115585,TXFE7,128,9937,1,45448,23785,23084
10115617,10115609,TXFE7,128,9937,1,45449,23786,23085
10115679,10115673,TXFE7,128,9937,2,45451,23787,23087
10115842,10115832,TXFE7,128,9937,9,45460,23788,23089
10115929,10115917,TXFE7,128,9937,1,45461,23789,23090
10120104,10120100,TXFE7,128,9937,1,45462,23790,23091
10120342,10120335,TXFE7,128,9937,2,45464,23791,23092
10120367,10120365,TXFE7,128,9937,2,45466,23792,23093
10120454,10120445,TXFE7,128,9937,20,45486,23793,23104
10120467,10120459,TXFE7,128,9937,1,45487,23794,23105
10120467,10120459,TXFE7,128,9937,2,45489,23795,23106
10120467,10120459,TXFE7,128,9937,23,45512,23796,23123
10120467,10120465,TXFE7,128,9937,2,45514,23797,23124
10120542,10120531,TXFE7,128,9937,1,45515,23798,23125
10120592,10120587,TXFE7,128,9937,1,45516,23799,23126
10120604,10120602,TXFE7,128,9938,1,45517,23800,23127
10120617,10120606,TXFE7,128,9938,1,45518,23801,23128
10120642,10120635,TXFE7,128,9938,1,45519,23802,23129
10120642,10120640,TXFE7,128,9938,1,45520,23803,23130
10120692,10120686,TXFE7,128,9937,1,45521,23804,23131
10120829,10120820,TXFE7,128,9937,1,45522,23805,23132
10120867,10120855,TXFE7,128,9938,2,45524,23806,23134
10120917,10120906,TXFE7,128,9938,1,45525,23807,23135
10120954,10120954,TXFE7,128,9937,1,45526,23808,23136
10121042,10121030,TXFE7,128,9938,3,45529,23809,23137
10121067,10121066,TXFE7,128,9938,1,45530,23810,23138
10121229,10121228,TXFE7,128,9938,2,45532,23811,23140
10121267,10121262,TXFE7,128,9938,1,45533,23812,23141
10121267,10121263,TXFE7,128,9938,3,45536,23813,23144
10121292,10121282,TXFE7,128,9938,1,45537,23814,23145
10121392,10121392,TXFE7,128,9938,1,45538,23815,23146
10121417,10121409,TXFE7,128,9938,20,45558,23816,23159
10121479,10121468,TXFE7,128,9938,1,45559,23817,23160
10121529,10121528,TXFE7,128,9938,1,45560,23818,23161
10121579,10121574,TXFE7,128,9937,1,45561,23819,23162
10121679,10121669,TXFE7,128,9938,1,45562,23820,23163
10121717,10121705,TXFE7,128,9938,21,45583,23821,23177
10121754,10121745,TXFE7,128,9939,2,45585,23822,23179
10121767,10121757,TXFE7,128,9939,2,45587,23823,23181
10121779,10121767,TXFE7,128,9939,2,45589,23824,23182
10121867,10121863,TXFE7,128,9939,1,45590,23825,23183
10121879,10121868,TXFE7,128,9938,2,45592,23827,23184
10121892,10121890,TXFE7,128,9938,1,45593,23828,23185
10122017,10122007,TXFE7,128,9939,1,45594,23829,23186
10122067,10122063,TXFE7,128,9938,1,45595,23830,23187
10122204,10122201,TXFE7,128,9939,1,45596,23831,23188
10122342,10122336,TXFE7,128,9938,3,45599,23833,23189
10122517,10122511,TXFE7,128,9939,1,45600,23834,23190
10122892,10122880,TXFE7,128,9938,1,45601,23835,23191
10123129,10123124,TXFE7,128,9939,1,45602,23836,23192
10123467,10123464,TXFE7,128,9939,1,45603,23837,23193
10123567,10123558,TXFE7,128,9939,1,45604,23838,23194
10123654,10123645,TXFE7,128,9939,1,45605,23839,23195
10123667,10123663,TXFE7,128,9938,2,45607,23841,23196
10123879,10123870,TXFE7,128,9938,1,45608,23842,23197
10123942,10123938,TXFE7,128,9938,1,45609,23843,23198
10123942,10123941,TXFE7,128,9939,1,45610,23844,23199
10123979,10123976,TXFE7,128,9938,5,45615,23849,23200
10124104,10124102,TXFE7,128,9938,2,45617,23851,23201
10124154,10124151,TXFE7,128,9938,1,45618,23852,23202
10124167,10124159,TXFE7,128,9938,4,45622,23855,23203
10124179,10124168,TXFE7,128,9938,10,45632,23861,23204
10124192,10124179,TXFE7,128,9938,5,45637,23865,23205
10124304,10124297,TXFE7,128,9938,5,45642,23866,23209
10124304,10124300,TXFE7,128,9937,1,45643,23867,23210
10124329,10124324,TXFE7,128,9938,5,45648,23868,23212
10124367,10124362,TXFE7,128,9938,5,45653,23869,23215
10124379,10124367,TXFE7,128,9938,3,45656,23870,23217
10124392,10124382,TXFE7,128,9938,1,45657,23871,23218
10124392,10124387,TXFE7,128,9939,5,45662,23872,23223
10124417,10124411,TXFE7,128,9938,1,45663,23873,23224
10124417,10124412,TXFE7,128,9939,5,45668,23874,23227
10124604,10124592,TXFE7,128,9938,1,45669,23875,23228
10124742,10124731,TXFE7,128,9938,1,45670,23876,23229
10124779,10124778,TXFE7,128,9938,1,45671,23877,23230
10124854,10124847,TXFE7,128,9938,1,45672,23878,23231
10124879,10124875,TXFE7,128,9938,1,45673,23879,23232
10124892,10124887,TXFE7,128,9938,1,45674,23880,23233
10124904,10124892,TXFE7,128,9938,1,45675,23881,23234
10125104,10125098,TXFE7,128,9939,61,45736,23882,23277
10125117,10125104,TXFE7,128,9939,3,45739,23883,23280
10125142,10125137,TXFE7,128,9939,1,45740,23884,23281
10125179,10125174,TXFE7,128,9939,2,45742,23885,23282
10125217,10125205,TXFE7,128,9939,3,45745,23886,23283
10125229,10125219,TXFE7,128,9939,2,45747,23887,23284
10125229,10125224,TXFE7,128,9940,1,45748,23888,23285
10125229,10125226,TXFE7,128,9940,1,45749,23889,23286
10125229,10125227,TXFE7,128,9940,3,45752,23890,23288
10125242,10125233,TXFE7,128,9940,1,45753,23891,23289
10125242,10125234,TXFE7,128,9940,2,45755,23892,23291
10125242,10125235,TXFE7,128,9940,1,45756,23893,23292
10125242,10125237,TXFE7,128,9940,1,45757,23894,23293
10125254,10125243,TXFE7,128,9940,5,45762,23895,23296
10125267,10125263,TXFE7,128,9940,1,45763,23896,23297
10125279,10125271,TXFE7,128,9940,1,45764,23897,23298
10125292,10125282,TXFE7,128,9939,3,45767,23898,23299
10125292,10125282,TXFE7,128,9940,1,45768,23899,23300
10125304,10125302,TXFE7,128,9940,1,45769,23900,23301
10125304,10125304,TXFE7,128,9939,1,45770,23901,23302
10125329,10125325,TXFE7,128,9940,2,45772,23902,23303
10125392,10125390,TXFE7,128,9940,5,45777,23903,23308
10125454,10125448,TXFE7,128,9940,1,45778,23904,23309
10125467,10125460,TXFE7,128,9940,4,45782,23905,23310
10125567,10125561,TXFE7,128,9940,1,45783,23906,23311
10125717,10125708,TXFE7,128,9940,1,45784,23907,23312
10125754,10125751,TXFE7,128,9940,1,45785,23908,23313
10125767,10125755,TXFE7,128,9940,5,45790,23909,23316
10125804,10125795,TXFE7,128,9940,4,45794,23910,23319
10125829,10125818,TXFE7,128,9940,1,45795,23911,23320
10125867,10125855,TXFE7,128,9940,5,45800,23912,23325
10130017,10130013,TXFE7,128,9939,1,45801,23913,23326
10130042,10130033,TXFE7,128,9940,2,45803,23914,23327
10130067,10130059,TXFE7,128,9940,1,45804,23915,23328
10130179,10130177,TXFE7,128,9940,1,45805,23916,23329
10130304,10130301,TXFE7,128,9939,1,45806,23917,23330
10130442,10130441,TXFE7,128,9939,1,45807,23918,23331
10130517,10130510,TXFE7,128,9939,1,45808,23919,23332
10130542,10130531,TXFE7,128,9940,1,45809,23920,23333
10130667,10130655,TXFE7,128,9940,1,45810,23921,23334
10130704,10130693,TXFE7,128,9940,50,45860,23922,23370
10130717,10130704,TXFE7,128,9940,3,45863,23923,23373
10130717,10130713,TXFE7,128,9940,1,45864,23924,23374
10130792,10130781,TXFE7,128,9941,4,45868,23925,23377
10130792,10130783,TXFE7,128,9940,1,45869,23926,23378
10130817,10130808,TXFE7,128,9941,1,45870,23927,23379
10130817,10130811,TXFE7,128,9940,1,45871,23928,23380
10130829,10130819,TXFE7,128,9941,1,45872,23929,23381
10130829,10130821,TXFE7,128,9941,1,45873,23930,23382
10130842,10130833,TXFE7,128,9941,2,45875,23931,23384
10130854,10130843,TXFE7,128,9941,4,45879,23932,23385
10130854,10130845,TXFE7,128,9941,2,45881,23933,23387
10130854,10130847,TXFE7,128,9940,1,45882,23934,23388
10130854,10130854,TXFE7,128,9940,2,45884,23935,23389
10130867,10130859,TXFE7,128,9941,2,45886,23936,23391
10130892,10130887,TXFE7,128,9940,1,45887,23937,23392
10130904,10130894,TXFE7,128,9941,6,45893,23938,23393
10130917,10130913,TXFE7,128,9940,1,45894,23939,23394
10130929,10130917,TXFE7,128,9940,1,45895,23940,23395
10130967,10130958,TXFE7,129,9940,1,45897,23941,23397
10130967,10130958,TXFE7,129,9941,1,45897,23941,23397
10130967,10130966,TXFE7,128,9941,3,45900,23942,23398
10131017,10131005,TXFE7,128,9941,1,45901,23943,23399
10131092,10131083,TXFE7,128,9940,1,45902,23944,23400
10131104,10131094,TXFE7,128,9941,1,45903,23945,23401
10131117,10131116,TXFE7,128,9940,3,45906,23947,23402
10131129,10131128,TXFE7,128,9939,25,45931,23956,23403
10131167,10131158,TXFE7,128,9940,1,45932,23957,23404
10131192,10131184,TXFE7,128,9940,2,45934,23958,23406
10131204,10131199,TXFE7,128,9939,2,45936,23959,23407
10131229,10131219,TXFE7,128,9940,2,45938,23960,23409
10131367,10131355,TXFE7,128,9939,1,45939,23961,23410
10131854,10131849,TXFE7,128,9939,9,45948,23968,23411
10131867,10131866,TXFE7,128,9939,1,45949,23969,23412
10132217,10132208,TXFE7,128,9939,1,45950,23970,23413
10132429,10132428,TXFE7,128,9939,1,45951,23971,23414
10132542,10132530,TXFE7,128,9938,1,45952,23972,23415
10132579,10132568,TXFE7,128,9938,1,45953,23973,23416
10132992,10132981,TXFE7,128,9939,4,45957,23974,23418
10133042,10133040,TXFE7,128,9938,2,45959,23975,23419
10133067,10133057,TXFE7,128,9938,1,45960,23976,23420
10133517,10133508,TXFE7,128,9939,1,45961,23977,23421
10133667,10133655,TXFE7,128,9939,1,45962,23978,23422
10133667,10133661,TXFE7,128,9939,1,45963,23979,23423
10133754,10133752,TXFE7,128,9939,1,45964,23980,23424
10134192,10134181,TXFE7,128,9939,2,45966,23981,23426
10134654,10134643,TXFE7,128,9938,1,45967,23982,23427
10134804,10134794,TXFE7,128,9938,2,45969,23983,23428
10134992,10134986,TXFE7,128,9938,1,45970,23984,23429
10135592,10135583,TXFE7,128,9938,1,45971,23985,23430
10135654,10135645,TXFE7,128,9938,1,45972,23986,23431
10140079,10140067,TXFE7,128,9939,2,45974,23987,23432
10140179,10140172,TXFE7,128,9938,1,45975,23988,23433
10141017,10141015,TXFE7,128,9938,1,45976,23989,23434
10141079,10141073,TXFE7,128,9938,2,45978,23990,23435
10141104,10141092,TXFE7,128,9938,36,46014,24016,23436
10141104,10141096,TXFE7,128,9938,5,46019,24018,23437
10141404,10141404,TXFE7,128,9937,10,46029,24020,23438
10141842,10141840,TXFE7,128,9937,1,46030,24021,23439
10142029,10142024,TXFE7,128,9937,2,46032,24023,23440
10142104,10142101,TXFE7,128,9938,1,46033,24024,23441
10142467,10142463,TXFE7,128,9938,1,46034,24025,23442
10142529,10142521,TXFE7,128,9938,2,46036,24026,23444
10142792,10142787,TXFE7,128,9938,1,46037,24027,23445
10143104,10143102,TXFE7,128,9938,2,46039,24028,23447
10143317,10143309,TXFE7,128,9938,1,46040,24029,23448
10143467,10143461,TXFE7,128,9938,1,46041,24030,23449
10143567,10143563,TXFE7,128,9937,1,46042,24031,23450
10143567,10143564,TXFE7,128,9937,1,46043,24032,23451
10143642,10143637,TXFE7,128,9938,2,46045,24033,23453
10143692,10143682,TXFE7,128,9937,15,46060,24047,23454
10143917,10143908,TXFE7,128,9937,1,46061,24048,23455
10144267,10144260,TXFE7,128,9937,2,46063,24050,23456
10144429,10144417,TXFE7,128,9937,1,46064,24051,23457
10144454,10144450,TXFE7,128,9937,31,46095,24062,23458
10145342,10145335,TXFE7,128,9936,1,46096,24063,23459
10145392,10145381,TXFE7,128,9936,1,46097,24064,23460
10145504,10145504,TXFE7,128,9937,1,46098,24065,23461
10150092,10150083,TXFE7,128,9937,2,46100,24066,23462
10150154,10150148,TXFE7,128,9937,1,46101,24067,23463
10150179,10150167,TXFE7,128,9937,4,46105,24068,23465
10150192,10150179,TXFE7,128,9937,1,46106,24069,23466
10150517,10150515,TXFE7,128,9937,1,46107,24070,23467
10150879,10150875,TXFE7,128,9937,2,46109,24071,23469
10151029,10151028,TXFE7,128,9937,1,46110,24072,23470
10151292,10151284,TXFE7,128,9937,1,46111,24073,23471
10151917,10151904,TXFE7,128,9936,4,46115,24076,23472
10151917,10151904,TXFE7,128,9936,4,46119,24080,23473
10151917,10151906,TXFE7,128,9936,7,46126,24085,23474
10151929,10151917,TXFE7,128,9936,2,46128,24087,23475
10151929,10151917,TXFE7,128,9936,3,46131,24090,23476
10152367,10152355,TXFE7,128,9936,1,46132,24091,23477
10152704,10152695,TXFE7,128,9936,1,46133,24092,23478
10152717,10152705,TXFE7,128,9936,28,46161,24109,23479
10152829,10152829,TXFE7,128,9935,1,46162,24110,23480
10152854,10152845,TXFE7,128,9935,3,46165,24113,23481
10152867,10152855,TXFE7,128,9935,3,46168,24116,23482
10152867,10152857,TXFE7,128,9935,3,46171,24117,23483
10152867,10152859,TXFE7,128,9935,1,46172,24118,23484
10152929,10152920,TXFE7,128,9935,2,46174,24119,23485
10152929,10152925,TXFE7,128,9935,1,46175,24120,23486
10152954,10152944,TXFE7,128,9935,1,46176,24121,23487
10153029,10153028,TXFE7,128,9935,13,46189,24130,23488
10153142,10153134,TXFE7,128,9935,2,46191,24132,23489
10153154,10153148,TXFE7,128,9936,1,46192,24133,23490
10153179,10153173,TXFE7,128,9935,1,46193,24134,23491
10153279,10153275,TXFE7,128,9935,1,46194,24135,23492
10153304,10153297,TXFE7,128,9935,1,46195,24136,23493
10153304,10153299,TXFE7,128,9935,1,46196,24137,23494
10153317,10153306,TXFE7,128,9935,1,46197,24138,23495
10153317,10153311,TXFE7,128,9935,2,46199,24140,23496
10153404,10153404,TXFE7,128,9935,1,46200,24141,23497
10153417,10153415,TXFE7,128,9935,1,46201,24142,23498
10153454,10153447,TXFE7,128,9935,1,46202,24143,23499
10153467,10153457,TXFE7,128,9935,3,46205,24146,23500
10153492,10153490,TXFE7,128,9935,3,46208,24149,23501
10153579,10153579,TXFE7,128,9936,1,46209,24150,23502
10153629,10153621,TXFE7,128,9935,1,46210,24151,23503
10153717,10153709,TXFE7,128,9935,2,46212,24152,23504
10153817,10153805,TXFE7,128,9935,1,46213,24153,23505
10153817,10153806,TXFE7,128,9935,1,46214,24154,23506
10154167,10154162,TXFE7,128,9935,1,46215,24155,23507
10154204,10154201,TXFE7,128,9935,7,46222,24159,23508
10154279,10154268,TXFE7,128,9935,1,46223,24160,23509
10154329,10154321,TXFE7,128,9935,1,46224,24161,23510
10154329,10154328,TXFE7,128,9935,1,46225,24162,23511
10154354,10154348,TXFE7,128,9935,1,46226,24163,23512
10154367,10154363,TXFE7,128,9935,1,46227,24164,23513
10154392,10154383,TXFE7,128,9935,1,46228,24165,23514
10154442,10154431,TXFE7,128,9935,1,46229,24166,23515
10154442,10154438,TXFE7,128,9935,1,46230,24167,23516
10154454,10154447,TXFE7,128,9935,3,46233,24169,23517
10154604,10154598,TXFE7,128,9935,1,46234,24170,23518
10154604,10154598,TXFE7,128,9935,1,46235,24171,23519
10154604,10154602,TXFE7,128,9935,1,46236,24172,23520
10154717,10154706,TXFE7,128,9936,1,46237,24173,23521
10154767,10154763,TXFE7,128,9935,1,46238,24174,23522
10154879,10154872,TXFE7,128,9935,1,46239,24175,23523
10155154,10155149,TXFE7,128,9935,1,46240,24176,23524
10155192,10155190,TXFE7,128,9935,1,46241,24177,23525
10155204,10155192,TXFE7,128,9935,2,46243,24179,23526
10155267,10155261,TXFE7,128,9935,1,46244,24180,23527
10155279,10155278,TXFE7,128,9935,1,46245,24181,23528
10155317,10155314,TXFE7,128,9935,1,46246,24182,23529
10155367,10155365,TXFE7,128,9935,1,46247,24183,23530
10155679,10155674,TXFE7,128,9935,1,46248,24184,23531
10155742,10155730,TXFE7,128,9935,2,46250,24185,23532
10155792,10155783,TXFE7,128,9934,2,46252,24187,23533
10155804,10155800,TXFE7,128,9935,2,46254,24188,23534
10155804,10155801,TXFE7,128,9934,4,46258,24191,23535
10155904,10155902,TXFE7,128,9934,1,46259,24192,23536
10155917,10155908,TXFE7,128,9935,1,46260,24193,23537
10155917,10155910,TXFE7,128,9934,1,46261,24194,23538
10160154,10160151,TXFE7,128,9935,2,46263,24195,23539
10160217,10160209,TXFE7,128,9934,1,46264,24196,23540
10160229,10160219,TXFE7,128,9934,4,46268,24197,23541
10160229,10160225,TXFE7,128,9935,1,46269,24198,23542
10160329,10160317,TXFE7,128,9934,3,46272,24200,23543
10160442,10160436,TXFE7,128,9935,4,46276,24201,23547
10160454,10160442,TXFE7,128,9935,1,46277,24202,23548
10160454,10160442,TXFE7,128,9935,1,46278,24203,23549
10160479,10160474,TXFE7,128,9935,1,46279,24204,23550
10160667,10160666,TXFE7,128,9936,1,46280,24205,23551
10160717,10160715,TXFE7,128,9935,1,46281,24206,23552
10160817,10160809,TXFE7,128,9935,4,46285,24208,23553
10160842,10160835,TXFE7,128,9935,3,46288,24211,23554
10160892,10160880,TXFE7,128,9936,3,46291,24212,23555
10161042,10161040,TXFE7,128,9935,1,46292,24213,23556
10161054,10161051,TXFE7,128,9935,4,46296,24216,23557
10161067,10161066,TXFE7,128,9935,1,46297,24217,23558
10161229,10161224,TXFE7,128,9935,1,46298,24218,23559
10161292,10161283,TXFE7,129,9935,4,46306,24224,23560
10161292,10161283,TXFE7,129,9934,4,46306,24224,23560
10161304,10161292,TXFE7,128,9935,1,46307,24225,23561
10161454,10161449,TXFE7,128,9935,1,46308,24226,23562
10162254,10162244,TXFE7,128,9935,1,46309,24227,23563
10162379,10162378,TXFE7,128,9935,10,46319,24228,23565
10162592,10162582,TXFE7,128,9935,10,46329,24229,23569
10162604,10162597,TXFE7,128,9935,13,46342,24230,23575
10162692,10162680,TXFE7,128,9935,2,46344,24231,23576
10162742,10162735,TXFE7,128,9935,2,46346,24232,23577
10162892,10162886,TXFE7,128,9935,4,46350,24235,23578
10162904,10162892,TXFE7,128,9935,1,46351,24236,23579
10162942,10162934,TXFE7,128,9935,1,46352,24237,23580
10162979,10162972,TXFE7,128,9935,1,46353,24238,23581
10163104,10163102,TXFE7,128,9935,1,46354,24239,23582
10163592,10163591,TXFE7,128,9935,1,46355,24240,23583
10163917,10163915,TXFE7,128,9935,1,46356,24241,23584
10164042,10164039,TXFE7,128,9934,4,46360,24245,23585
10164079,10164078,TXFE7,128,9934,1,46361,24246,23586
10164117,10164109,TXFE7,128,9934,1,46362,24247,23587
10164454,10164445,TXFE7,128,9935,1,46363,24248,23588
10165042,10165040,TXFE7,128,9934,5,46368,24252,23589
10165104,10165098,TXFE7,128,9934,1,46369,24253,23590
10165117,10165105,TXFE7,128,9934,61,46430,24290,23591
10165167,10165161,TXFE7,128,9934,1,46431,24291,23592
10165192,10165188,TXFE7,128,9934,1,46432,24292,23593
10165204,10165193,TXFE7,128,9933,1,46433,24293,23594
10165217,10165206,TXFE7,128,9933,1,46434,24294,23595
10165217,10165214,TXFE7,128,9934,1,46435,24295,23596
10165217,10165216,TXFE7,128,9933,2,46437,24296,23597
10165229,10165218,TXFE7,128,9933,6,46443,24299,23598
10165242,10165236,TXFE7,128,9933,8,46451,24304,23599
10165242,10165242,TXFE7,128,9934,2,46453,24305,23600
10165254,10165243,TXFE7,128,9933,2,46455,24307,23601
10165254,10165243,TXFE7,128,9933,2,46457,24309,23602
10165254,10165246,TXFE7,128,9933,2,46459,24311,23603
10165304,10165298,TXFE7,128,9933,1,46460,24312,23604
10165342,10165337,TXFE7,128,9933,1,46461,24313,23605
10165367,10165361,TXFE7,128,9934,1,46462,24314,23606
10165404,10165393,TXFE7,128,9934,1,46463,24315,23607
10165404,10165403,TXFE7,128,9933,1,46464,24316,23608
10165417,10165408,TXFE7,128,9933,1,46465,24317,23609
10165429,10165422,TXFE7,128,9933,1,46466,24318,23610
10165442,10165432,TXFE7,128,9933,3,46469,24321,23611
10165467,10165465,TXFE7,128,9933,1,46470,24322,23612
10165529,10165529,TXFE7,128,9933,2,46472,24324,23613
10165554,10165551,TXFE7,128,9933,1,46473,24325,23614
10165592,10165580,TXFE7,128,9933,2,46475,24326,23615
10165642,10165640,TXFE7,128,9934,1,46476,24327,23616
10165679,10165679,TXFE7,128,9933,1,46477,24328,23617
10165729,10165722,TXFE7,128,9933,65,46542,24369,23618
10165729,10165722,TXFE7,128,9933,1,46543,24370,23619
10165742,10165734,TXFE7,128,9932,2,46545,24372,23620
10165754,10165748,TXFE7,128,9932,2,46547,24374,23621
10165754,10165750,TXFE7,128,9932,1,46548,24375,23622
10165754,10165752,TXFE7,128,9932,6,46554,24379,23623
10165767,10165755,TXFE7,128,9932,1,46555,24380,23624
10165767,10165755,TXFE7,128,9932,2,46557,24382,23625
10165767,10165756,TXFE7,128,9932,1,46558,24383,23626
10165767,10165760,TXFE7,128,9933,1,46559,24384,23627
10165767,10165764,TXFE7,128,9933,2,46561,24385,23629
10165767,10165765,TXFE7,128,9932,1,46562,24386,23630
10165779,10165768,TXFE7,128,9932,15,46577,24400,23631
10165779,10165769,TXFE7,128,9932,11,46588,24408,23632
10165779,10165770,TXFE7,128,9932,1,46589,24409,23633
10165792,10165779,TXFE7,128,9932,4,46593,24413,23634
10165792,10165779,TXFE7,128,9932,9,46602,24422,23635
10165792,10165791,TXFE7,128,9932,1,46603,24423,23636
10165817,10165805,TXFE7,128,9932,2,46605,24424,23637
10165842,10165834,TXFE7,128,9932,2,46607,24425,23638
10165854,10165846,TXFE7,128,9932,1,46608,24426,23639
10165954,10165943,TXFE7,128,9932,2,46610,24428,23640
10165967,10165955,TXFE7,128,9932,1,46611,24429,23641
10165992,10165991,TXFE7,128,9932,3,46614,24430,23642
10170004,10165999,TXFE7,128,9932,1,46615,24431,23643
10170004,10170004,TXFE7,128,9932,2,46617,24432,23644
10170042,10170036,TXFE7,128,9932,4,46621,24433,23645
10170042,10170037,TXFE7,128,9933,1,46622,24434,23646
10170042,10170038,TXFE7,128,9932,1,46623,24435,23647
10170042,10170041,TXFE7,128,9932,2,46625,24436,23648
10170092,10170091,TXFE7,128,9932,1,46626,24437,23649
10170104,10170092,TXFE7,128,9932,1,46627,24438,23650
10170104,10170093,TXFE7,128,9932,1,46628,24439,23651
10170117,10170116,TXFE7,128,9932,2,46630,24441,23652
10170129,10170120,TXFE7,128,9932,4,46634,24442,23653
10170129,10170126,TXFE7,128,9932,2,46636,24443,23654
10170142,10170141,TXFE7,128,9932,2,46638,24445,23655
10170142,10170141,TXFE7,128,9932,1,46639,24446,23656
10170142,10170141,TXFE7,128,9932,1,46640,24447,23657
10170154,10170145,TXFE7,128,9932,1,46641,24448,23658
10170154,10170145,TXFE7,128,9932,1,46642,24449,23659
10170192,10170187,TXFE7,128,9932,1,46643,24450,23660
10170192,10170188,TXFE7,128,9932,5,46648,24451,23661
10170354,10170343,TXFE7,128,9932,2,46650,24452,23662
10170392,10170383,TXFE7,128,9932,2,46652,24453,23663
10170392,10170388,TXFE7,128,9933,1,46653,24454,23664
10170454,10170452,TXFE7,128,9933,1,46654,24455,23665
10170529,10170522,TXFE7,128,9933,2,46656,24456,23666
10170529,10170522,TXFE7,128,9933,17,46673,24457,23676
10170542,10170530,TXFE7,128,9933,1,46674,24458,23677
10170542,10170537,TXFE7,128,9933,1,46675,24459,23678
10170604,10170601,TXFE7,128,9934,1,46676,24460,23679
10170642,10170638,TXFE7,128,9933,1,46677,24461,23680
10170692,10170687,TXFE7,128,9933,1,46678,24462,23681
10171079,10171068,TXFE7,128,9933,7,46685,24466,23682
10171092,10171079,TXFE7,128,9933,4,46689,24470,23683
10171117,10171108,TXFE7,128,9933,2,46691,24471,23685
10171117,10171111,TXFE7,128,9934,1,46692,24472,23686
10171129,10171124,TXFE7,128,9933,1,46693,24473,23687
10171242,10171231,TXFE7,128,9933,1,46694,24474,23688
10171292,10171280,TXFE7,128,9932,2,46696,24475,23689
10171317,10171310,TXFE7,128,9933,3,46699,24476,23692
10171379,10171374,TXFE7,128,9933,2,46701,24477,23693
10171529,10171519,TXFE7,128,9933,1,46702,24478,23694
10171567,10171558,TXFE7,128,9933,2,46704,24480,23695
10171579,10171569,TXFE7,128,9933,1,46705,24481,23696
10172304,10172296,TXFE7,128,9934,1,46706,24482,23697
10172317,10172312,TXFE7,128,9933,6,46712,24486,23698
10172342,10172330,TXFE7,128,9934,2,46714,24487,23699
10172579,10172569,TXFE7,128,9933,2,46716,24488,23700
10172579,10172570,TXFE7,128,9933,2,46718,24489,23701
10172579,10172571,TXFE7,128,9933,2,46720,24490,23702
10172579,10172572,TXFE7,128,9933,2,46722,24492,23703
10172579,10172573,TXFE7,128,9933,2,46724,24494,23704
10172892,10172883,TXFE7,128,9933,1,46725,24495,23705
10172967,10172963,TXFE7,128,9934,2,46727,24496,23706
10173104,10173093,TXFE7,128,9933,1,46728,24497,23707
10173229,10173225,TXFE7,128,9933,1,46729,24498,23708
10173254,10173243,TXFE7,128,9933,1,46730,24499,23709
10173329,10173328,TXFE7,128,9933,5,46735,24504,23710
10173379,10173369,TXFE7,128,9933,1,46736,24505,23711
10173454,10173443,TXFE7,128,9933,3,46739,24506,23712
10173592,10173588,TXFE7,128,9933,1,46740,24507,23713
10173617,10173616,TXFE7,128,9933,1,46741,24508,23714
10173629,10173621,TXFE7,128,9933,1,46742,24509,23715
10173679,10173675,TXFE7,128,9933,2,46744,24511,23716
10173704,10173694,TXFE7,128,9933,3,46747,24514,23717
10173767,10173756,TXFE7,128,9933,1,46748,24515,23718
10173767,10173759,TXFE7,128,9933,1,46749,24516,23719
10173792,10173790,TXFE7,128,9933,1,46750,24517,23720
10173804,10173792,TXFE7,128,9933,1,46751,24518,23721
10173804,10173797,TXFE7,128,9932,1,46752,24519,23722
10173904,10173896,TXFE7,128,9933,13,46765,24520,23729
10174104,10174096,TXFE7,128,9932,1,46766,24521,23730
10174117,10174110,TXFE7,128,9933,1,46767,24522,23731
10174204,10174199,TXFE7,128,9933,3,46770,24523,23733
10174242,10174230,TXFE7,128,9933,1,46771,24524,23734
10174479,10174473,TXFE7,128,9933,1,46772,24525,23735
10174667,10174666,TXFE7,128,9933,20,46792,24526,23746
10174679,10174670,TXFE7,128,9933,1,46793,24527,23747
10174754,10174742,TXFE7,128,9933,1,46794,24528,23748
10174804,10174800,TXFE7,128,9932,1,46795,24529,23749
10174879,10174878,TXFE7,128,9932,1,46796,24530,23750
10174904,10174901,TXFE7,128,9932,3,46799,24533,23751
10174904,10174901,TXFE7,128,9932,3,46802,24534,23752
10174904,10174901,TXFE7,128,9932,2,46804,24535,23753
10174904,10174901,TXFE7,128,9932,1,46805,24536,23754
10174904,10174901,TXFE7,128,9932,2,46807,24538,23755
10174904,10174901,TXFE7,128,9932,2,46809,24540,23756
10174904,10174901,TXFE7,128,9932,52,46861,24568,23757
10174917,10174906,TXFE7,128,9931,6,46867,24574,23758
10174942,10174941,TXFE7,128,9931,1,46868,24575,23759
10174967,10174966,TXFE7,128,9931,1,46869,24576,23760
10174979,10174968,TXFE7,128,9931,1,46870,24577,23761
10174992,10174985,TXFE7,128,9932,37,46907,24578,23776
10175017,10175007,TXFE7,128,9933,1,46908,24579,23777
10175029,10175017,TXFE7,128,9932,1,46909,24580,23778
10175029,10175018,TXFE7,128,9932,4,46913,24583,23779
10175029,10175018,TXFE7,128,9932,1,46914,24584,23780
10175042,10175039,TXFE7,128,9932,1,46915,24585,23781
10175042,10175041,TXFE7,128,9932,1,46916,24586,23782
10175054,10175044,TXFE7,128,9932,3,46919,24588,23783
10175079,10175070,TXFE7,128,9932,3,46922,24589,23784
10175079,10175070,TXFE7,128,9933,2,46924,24590,23785
10175092,10175084,TXFE7,128,9932,5,46929,24591,23786
10175154,10175143,TXFE7,128,9932,1,46930,24592,23787
10175204,10175199,TXFE7,128,9931,6,46936,24596,23788
10175254,10175251,TXFE7,128,9931,9,46945,24603,23789
10175292,10175289,TXFE7,128,9931,1,46946,24604,23790
10175342,10175339,TXFE7,128,9931,1,46947,24605,23791
10175367,10175365,TXFE7,128,9932,1,46948,24606,23792
10175367,10175365,TXFE7,128,9931,1,46949,24607,23793
10175392,10175381,TXFE7,128,9931,2,46951,24609,23794
10175442,10175442,TXFE7,128,9931,1,46952,24610,23795
10175492,10175485,TXFE7,128,9931,1,46953,24611,23796
10175504,10175501,TXFE7,128,9931,1,46954,24612,23797
10175529,10175528,TXFE7,128,9932,4,46958,24613,23800
10175592,10175585,TXFE7,128,9931,3,46961,24615,23801
10175604,10175598,TXFE7,128,9931,1,46962,24616,23802
10175679,10175675,TXFE7,128,9932,1,46963,24617,23803
10175717,10175710,TXFE7,128,9931,1,46964,24618,23804
10175842,10175840,TXFE7,128,9931,1,46965,24619,23805
10175892,10175883,TXFE7,128,9931,1,46966,24620,23806
10175967,10175962,TXFE7,128,9932,1,46967,24621,23807
10180054,10180052,TXFE7,128,9931,2,46969,24623,23808
10180067,10180066,TXFE7,128,9931,2,46971,24624,23809
10180092,10180080,TXFE7,128,9931,4,46975,24627,23810
10180092,10180090,TXFE7,128,9932,4,46979,24628,23813
10180129,10180117,TXFE7,128,9932,1,46980,24629,23814
10180154,10180146,TXFE7,128,9932,1,46981,24630,23815
10180154,10180153,TXFE7,128,9932,1,46982,24631,23816
10180167,10180160,TXFE7,128,9932,2,46984,24632,23818
10180179,10180167,TXFE7,128,9932,1,46985,24633,23819
10180179,10180167,TXFE7,128,9932,10,46995,24634,23824
10180204,10180204,TXFE7,128,9932,8,47003,24637,23825
10180217,10180207,TXFE7,128,9932,2,47005,24639,23826
10180317,10180308,TXFE7,128,9932,1,47006,24640,23827
10180354,10180350,TXFE7,128,9933,1,47007,24641,23828
10180417,10180408,TXFE7,128,9933,4,47011,24642,23830
10180417,10180408,TXFE7,128,9933,2,47013,24643,23831
10180417,10180408,TXFE7,128,9933,15,47028,24644,23837
10180429,10180417,TXFE7,128,9933,2,47030,24645,23838
10180429,10180417,TXFE7,128,9933,1,47031,24646,23839
10180429,10180417,TXFE7,128,9933,1,47032,24647,23840
10180429,10180417,TXFE7,128,9933,6,47038,24648,23843
10180429,10180417,TXFE7,128,9933,2,47040,24649,23845
10180429,10180417,TXFE7,128,9933,2,47042,24650,23847
10180467,10180456,TXFE7,128,9933,5,47047,24653,23848
10180479,10180479,TXFE7,128,9933,11,47058,24657,23849
10180517,10180509,TXFE7,128,9933,1,47059,24658,23850
10180542,10180539,TXFE7,128,9933,1,47060,24659,23851
10180592,10180590,TXFE7,128,9934,2,47062,24660,23852
10180667,10180659,TXFE7,128,9934,1,47063,24661,23853
10180704,10180692,TXFE7,128,9934,1,47064,24662,23854
10180817,10180810,TXFE7,128,9933,1,47065,24663,23855
10180867,10180865,TXFE7,128,9933,2,47067,24664,23856
10180979,10180971,TXFE7,128,9934,4,47071,24665,23859
10181017,10181015,TXFE7,128,9934,2,47073,24666,23860
10181029,10181017,TXFE7,128,9934,19,47092,24667,23875
10181054,10181046,TXFE7,128,9934,5,47097,24670,23876
10181054,10181054,TXFE7,128,9934,5,47102,24671,23877
10181067,10181056,TXFE7,128,9934,1,47103,24672,23878
10181104,10181097,TXFE7,128,9934,1,47104,24673,23879
10181204,10181192,TXFE7,128,9934,1,47105,24674,23880
10181204,10181194,TXFE7,128,9933,2,47107,24675,23881
10181529,10181517,TXFE7,128,9933,2,47109,24677,23882
10181592,10181586,TXFE7,128,9934,1,47110,24678,23883
10181642,10181633,TXFE7,128,9934,1,47111,24679,23884
10181829,10181819,TXFE7,128,9934,1,47112,24680,23885
10181879,10181869,TXFE7,128,9934,4,47116,24681,23886
10181892,10181879,TXFE7,128,9934,1,47117,24682,23887
10181892,10181884,TXFE7,128,9934,1,47118,24683,23888
10182067,10182063,TXFE7,128,9933,5,47123,24685,23889
10182129,10182127,TXFE7,128,9933,1,47124,24686,23890
10182192,10182191,TXFE7,128,9933,6,47130,24692,23891
10182192,10182191,TXFE7,128,9933,1,47131,24693,23892
10182204,10182197,TXFE7,128,9933,1,47132,24694,23893
10182379,10182369,TXFE7,128,9934,1,47133,24695,23894
10182392,10182391,TXFE7,128,9934,1,47134,24696,23895
10182492,10182483,TXFE7,128,9933,2,47136,24697,23896
10182704,10182697,TXFE7,128,9934,1,47137,24698,23897
10183042,10183033,TXFE7,128,9934,1,47138,24699,23898
10183067,10183063,TXFE7,128,9934,1,47139,24700,23899
10183142,10183131,TXFE7,128,9934,2,47141,24701,23900
10183467,10183457,TXFE7,128,9933,2,47143,24702,23901
10183829,10183824,TXFE7,128,9933,1,47144,24703,23902
10184092,10184092,TXFE7,128,9934,2,47146,24704,23904
10184404,10184392,TXFE7,128,9933,19,47165,24716,23905
10184404,10184404,TXFE7,128,9933,1,47166,24717,23906
10184417,10184404,TXFE7,128,9933,1,47167,24718,23907
10184417,10184404,TXFE7,128,9933,3,47170,24720,23908
10184417,10184404,TXFE7,128,9933,1,47171,24721,23909
10184417,10184404,TXFE7,128,9933,1,47172,24722,23910
10184417,10184404,TXFE7,128,9933,3,47175,24724,23911
10184442,10184429,TXFE7,128,9933,2,47177,24725,23913
10184579,10184567,TXFE7,128,9933,1,47178,24726,23914
10184592,10184582,TXFE7,128,9933,1,47179,24727,23915
10184717,10184715,TXFE7,128,9932,1,47180,24728,23916
10184767,10184765,TXFE7,128,9932,5,47185,24730,23917
10184854,10184843,TXFE7,128,9932,2,47187,24732,23918
10184942,10184939,TXFE7,128,9933,1,47188,24733,23919
10184979,10184969,TXFE7,128,9932,1,47189,24734,23920
10185017,10185009,TXFE7,128,9932,10,47199,24741,23921
10185042,10185037,TXFE7,128,9932,1,47200,24742,23922
10185067,10185055,TXFE7,128,9932,1,47201,24743,23923
10185067,10185057,TXFE7,128,9932,5,47206,24745,23924
10185092,10185087,TXFE7,128,9932,1,47207,24746,23925
10185267,10185261,TXFE7,128,9933,1,47208,24747,23926
10185429,10185418,TXFE7,128,9933,2,47210,24748,23928
10185567,10185566,TXFE7,128,9932,2,47212,24750,23929
10185592,10185590,TXFE7,128,9932,1,47213,24751,23930
10185617,10185608,TXFE7,128,9932,1,47214,24752,23931
10185742,10185732,TXFE7,128,9932,5,47219,24754,23932
10185779,10185769,TXFE7,128,9932,1,47220,24755,23933
10185779,10185777,TXFE7,128,9932,5,47225,24759,23934
10185792,10185779,TXFE7,128,9932,13,47238,24770,23935
10185904,10185897,TXFE7,128,9931,2,47240,24771,23936
10185992,10185992,TXFE7,128,9931,8,47248,24772,23937
10190092,10190085,TXFE7,128,9931,1,47249,24773,23938
10190092,10190086,TXFE7,128,9931,1,47250,24774,23939
10190092,10190088,TXFE7,128,9931,1,47251,24775,23940
10190092,10190089,TXFE7,128,9931,1,47252,24776,23941
10190092,10190090,TXFE7,128,9931,2,47254,24777,23942
10190092,10190091,TXFE7,128,9931,1,47255,24778,23943
10190129,10190128,TXFE7,128,9931,2,47257,24779,23944
10190167,10190157,TXFE7,128,9931,1,47258,24780,23945
10190179,10190175,TXFE7,128,9932,1,47259,24781,23946
10190192,10190188,TXFE7,128,9931,1,47260,24782,23947
10190217,10190207,TXFE7,128,9931,3,47263,24783,23948
10190292,10190289,TXFE7,128,9932,1,47264,24784,23949
10190354,10190353,TXFE7,128,9931,10,47274,24785,23950
10190442,10190430,TXFE7,128,9932,50,47324,24786,23968
10190442,10190433,TXFE7,128,9931,1,47325,24787,23969
10190454,10190442,TXFE7,128,9932,1,47326,24788,23970
10190492,10190480,TXFE7,128,9932,3,47329,24789,23971
10190492,10190486,TXFE7,128,9933,2,47331,24790,23972
10190504,10190496,TXFE7,128,9932,1,47332,24791,23973
10190579,10190570,TXFE7,128,9932,2,47334,24793,23974
10190617,10190615,TXFE7,128,9932,1,47335,24794,23975
10190679,10190679,TXFE7,128,9932,10,47345,24801,23976
10190704,10190702,TXFE7,128,9932,5,47350,24802,23977
10190742,10190732,TXFE7,128,9932,4,47354,24805,23978
10190804,10190794,TXFE7,128,9931,1,47355,24806,23979
10190817,10190804,TXFE7,128,9932,4,47359,24807,23981
10190879,10190870,TXFE7,128,9932,2,47361,24808,23982
10190879,10190870,TXFE7,128,9932,1,47362,24809,23983
10190904,10190893,TXFE7,128,9932,1,47363,24810,23984
10191217,10191210,TXFE7,128,9932,3,47366,24811,23985
10191229,10191218,TXFE7,128,9932,1,47367,24812,23986
10191317,10191310,TXFE7,128,9932,1,47368,24813,23987
10191567,10191566,TXFE7,128,9933,2,47370,24814,23989
10191642,10191636,TXFE7,128,9933,1,47371,24815,23990
10191842,10191836,TXFE7,128,9932,2,47373,24816,23991
10191904,10191893,TXFE7,128,9932,13,47386,24823,23992
10191992,10191984,TXFE7,128,9933,2,47388,24824,23993
10192042,10192031,TXFE7,128,9932,5,47393,24829,23994
10192054,10192050,TXFE7,128,9933,6,47399,24830,23996
10192179,10192173,TXFE7,128,9932,1,47400,24831,23997
10192304,10192298,TXFE7,128,9932,1,47401,24832,23998
10192767,10192757,TXFE7,128,9932,1,47402,24833,23999
10192767,10192762,TXFE7,128,9932,1,47403,24834,24000
10192804,10192798,TXFE7,128,9932,1,47404,24835,24001
10192992,10192980,TXFE7,128,9933,26,47430,24836,24017
10193054,10193053,TXFE7,128,9933,1,47431,24837,24018
10193067,10193061,TXFE7,128,9933,5,47436,24839,24019
10193142,10193139,TXFE7,128,9933,1,47437,24840,24020
10193179,10193179,TXFE7,128,9934,1,47438,24841,24021
10193242,10193237,TXFE7,128,9933,1,47439,24842,24022
10193367,10193359,TXFE7,128,9933,8,47447,24843,24023
10193829,10193820,TXFE7,128,9934,2,47449,24844,24025
10193829,10193820,TXFE7,128,9934,4,47453,24845,24029
10193829,10193820,TXFE7,128,9934,2,47455,24846,24031
10193829,10193820,TXFE7,128,9934,2,47457,24847,24033
10193829,10193820,TXFE7,128,9934,15,47472,24848,24041
10193842,10193829,TXFE7,128,9934,2,47474,24849,24043
10193842,10193829,TXFE7,128,9934,1,47475,24850,24044
10193842,10193829,TXFE7,128,9934,1,47476,24851,24045
10193842,10193829,TXFE7,128,9934,2,47478,24852,24047
10193842,10193829,TXFE7,128,9934,4,47482,24853,24051
10193854,10193849,TXFE7,128,9934,1,47483,24854,24052
10193929,10193922,TXFE7,128,9934,5,47488,24857,24053
10194004,10193992,TXFE7,128,9934,1,47489,24858,24054
10194354,10194342,TXFE7,128,9934,2,47491,24860,24055
10194554,10194547,TXFE7,128,9934,1,47493,24862,24057
10194567,10194555,TXFE7,128,9934,1,47494,24863,24058
10194792,10194788,TXFE7,128,9934,1,47501,24870,24063
10194804,10194801,TXFE7,128,9933,1,47502,24871,24064
10194929,10194919,TXFE7,128,9933,5,47507,24873,24065
10195729,10195722,TXFE7,128,9934,2,47509,24874,24067
10195792,10195790,TXFE7,128,9934,4,47513,24875,24069
10195929,10195925,TXFE7,128,9934,5,47518,24876,24073
10195967,10195966,TXFE7,128,9933,1,47519,24877,24074
10200142,10200140,TXFE7,128,9933,1,47520,24878,24075
10200304,10200300,TXFE7,128,9933,1,47521,24879,24076
10200354,10200342,TXFE7,128,9933,2,47523,24881,24077
10200404,10200399,TXFE7,128,9933,1,47524,24882,24078
10200517,10200515,TXFE7,128,9933,1,47525,24883,24079
10200567,10200558,TXFE7,128,9934,1,47526,24884,24080
10200567,10200559,TXFE7,128,9934,1,47527,24885,24081
10200579,10200575,TXFE7,128,9933,8,47535,24890,24082
10200592,10200579,TXFE7,128,9933,1,47536,24891,24083
10200592,10200579,TXFE7,128,9933,5,47541,24896,24084
10200679,10200677,TXFE7,128,9932,2,47543,24897,24085
10200954,10200949,TXFE7,128,9932,1,47544,24898,24086
10200967,10200959,TXFE7,128,9932,1,47545,24899,24087
10200967,10200959,TXFE7,128,9932,1,47546,24900,24088
10200967,10200959,TXFE7,128,9932,1,47547,24901,24089
10200967,10200959,TXFE7,128,9932,1,47548,24902,24090
10200979,10200967,TXFE7,128,9932,3,47551,24905,24091
10200979,10200967,TXFE7,128,9932,2,47553,24906,24092
10200979,10200967,TXFE7,128,9932,2,47555,24907,24093
10200979,10200967,TXFE7,128,9932,1,47556,24908,24094
10200979,10200967,TXFE7,128,9932,6,47562,24913,24095
10200979,10200967,TXFE7,128,9932,1,47563,24914,24096
10200979,10200967,TXFE7,128,9932,1,47564,24915,24097
10200979,10200967,TXFE7,128,9932,1,47565,24916,24098
10201029,10201020,TXFE7,128,9933,1,47566,24917,24099
10201092,10201087,TXFE7,128,9933,3,47569,24918,24100
10201342,10201333,TXFE7,128,9932,1,47570,24919,24101
10201642,10201639,TXFE7,128,9933,1,47571,24920,24102
10201817,10201812,TXFE7,128,9932,1,47572,24921,24103
10201904,10201893,TXFE7,128,9932,1,47573,24922,24104
10202292,10202281,TXFE7,128,9932,1,47574,24923,24105
10202417,10202413,TXFE7,128,9932,1,47575,24924,24106
10202579,10202570,TXFE7,128,9932,1,47576,24925,24107
10202679,10202676,TXFE7,128,9932,5,47581,24929,24108
10202729,10202726,TXFE7,128,9932,1,47582,24930,24109
10202979,10202972,TXFE7,128,9932,1,47583,24931,24110
10203042,10203034,TXFE7,128,9932,1,47584,24932,24111
10203467,10203454,TXFE7,128,9933,5,47589,24933,24113
10203467,10203454,TXFE7,128,9933,1,47590,24934,24114
10203467,10203454,TXFE7,128,9933,1,47591,24935,24115
10203467,10203456,TXFE7,128,9932,1,47592,24936,24116
10203479,10203467,TXFE7,128,9933,4,47596,24937,24120
10203492,10203480,TXFE7,128,9932,5,47601,24942,24121
10203892,10203888,TXFE7,128,9933,1,47602,24943,24122
10203967,10203957,TXFE7,128,9933,1,47603,24944,24123
10204104,10204092,TXFE7,128,9933,23,47626,24945,24134
10204154,10204153,TXFE7,128,9934,1,47627,24946,24135
10204267,10204264,TXFE7,128,9933,2,47629,24948,24136
10204454,10204451,TXFE7,128,9933,1,47630,24949,24137
10204617,10204610,TXFE7,128,9933,1,47631,24950,24138
10204892,10204883,TXFE7,128,9933,1,47632,24951,24139
10204904,10204892,TXFE7,128,9933,3,47635,24952,24140
10205142,10205136,TXFE7,128,9933,1,47636,24953,24141
10205204,10205201,TXFE7,128,9933,1,47637,24954,24142
10205479,10205477,TXFE7,128,9933,1,47638,24955,24143
10210079,10210069,TXFE7,128,9933,12,47650,24963,24144
10210092,10210084,TXFE7,128,9933,2,47652,24964,24145
10210129,10210117,TXFE7,128,9933,12,47664,24965,24148
10210167,10210156,TXFE7,128,9933,1,47665,24966,24149
10210217,10210210,TXFE7,128,9933,1,47666,24967,24150
10210392,10210383,TXFE7,128,9933,3,47669,24969,24151
10210442,10210439,TXFE7,128,9933,1,47670,24970,24152
10210442,10210439,TXFE7,128,9933,1,47671,24971,24153
10210492,10210486,TXFE7,128,9933,2,47673,24972,24154
10211754,10211751,TXFE7,128,9933,1,47674,24973,24155
10211779,10211770,TXFE7,128,9933,2,47676,24974,24156
10211879,10211872,TXFE7,128,9933,5,47681,24977,24157
10211929,10211918,TXFE7,128,9933,1,47682,24978,24158
10211967,10211957,TXFE7,128,9933,1,47683,24979,24159
10211979,10211967,TXFE7,128,9933,1,47684,24980,24160
10212104,10212092,TXFE7,128,9933,1,47685,24981,24161
10212117,10212104,TXFE7,128,9933,2,47687,24982,24162
10212242,10212242,TXFE7,128,9932,1,47688,24983,24163
10212267,10212255,TXFE7,128,9933,1,47689,24984,24164
10212279,10212270,TXFE7,128,9933,1,47690,24985,24165
10212304,10212300,TXFE7,128,9933,3,47693,24986,24166
10212629,10212620,TXFE7,128,9932,10,47703,24994,24167
10212767,10212763,TXFE7,128,9933,1,47704,24995,24168
10212792,10212780,TXFE7,128,9932,1,47705,24996,24169
10212804,10212799,TXFE7,128,9933,5,47710,24997,24171
10213004,10212992,TXFE7,128,9932,1,47711,24998,24172
10213367,10213356,TXFE7,128,9932,1,47712,24999,24173
10213379,10213378,TXFE7,128,9933,2,47714,25000,24175
10213554,10213554,TXFE7,128,9932,9,47723,25004,24176
10213567,10213554,TXFE7,128,9932,4,47727,25005,24177
10213604,10213602,TXFE7,128,9932,11,47738,25011,24178
10213617,10213604,TXFE7,128,9932,1,47739,25012,24179
10213654,10213653,TXFE7,128,9932,1,47740,25013,24180
10213654,10213653,TXFE7,128,9932,11,47751,25020,24181
10213667,10213654,TXFE7,128,9932,1,47752,25021,24182
10213679,10213670,TXFE7,128,9932,1,47753,25022,24183
10213679,10213670,TXFE7,128,9932,1,47754,25023,24184
10213829,10213826,TXFE7,128,9933,1,47755,25024,24185
10214079,10214069,TXFE7,128,9932,5,47760,25026,24186
10214117,10214107,TXFE7,128,9933,2,47762,25027,24187
10214117,10214109,TXFE7,128,9932,2,47764,25029,24188
10214229,10214218,TXFE7,128,9932,1,47765,25030,24189
10214254,10214252,TXFE7,128,9932,1,47766,25031,24190
10214379,10214372,TXFE7,128,9933,1,47767,25032,24191
10214767,10214763,TXFE7,128,9933,1,47768,25033,24192
10214954,10214945,TXFE7,128,9932,1,47769,25034,24193
10214979,10214978,TXFE7,128,9933,10,47779,25035,24200
10214992,10214988,TXFE7,128,9933,1,47780,25036,24201
10215042,10215037,TXFE7,128,9933,1,47781,25037,24202
10215117,10215112,TXFE7,128,9933,1,47782,25038,24203
10215267,10215260,TXFE7,128,9933,1,47783,25039,24204
10215979,10215975,TXFE7,128,9932,1,47784,25040,24205
10220054,10220051,TXFE7,128,9933,1,47785,25041,24206
10220067,10220065,TXFE7,128,9933,1,47786,25042,24207
10220242,10220231,TXFE7,128,9932,6,47792,25048,24208
10220342,10220337,TXFE7,128,9932,5,47797,25052,24209
10220367,10220356,TXFE7,128,9932,4,47801,25053,24210
10220379,10220376,TXFE7,128,9932,4,47805,25056,24211
10220392,10220385,TXFE7,128,9932,5,47810,25060,24212
10220404,10220402,TXFE7,128,9932,5,47815,25062,24213
10220417,10220410,TXFE7,128,9932,22,47837,25066,24214
10220429,10220429,TXFE7,128,9932,1,47838,25067,24215
10220554,10220545,TXFE7,128,9932,2,47840,25068,24217
10220554,10220546,TXFE7,128,9931,1,47841,25069,24218
10220579,10220576,TXFE7,128,9931,6,47847,25070,24219
10220692,10220686,TXFE7,128,9931,1,47848,25071,24220
10221017,10221012,TXFE7,128,9932,2,47850,25072,24222
10221242,10221229,TXFE7,128,9932,2,47852,25073,24223
10221242,10221229,TXFE7,128,9932,1,47853,25074,24224
10221242,10221229,TXFE7,128,9932,3,47856,25075,24227
10221254,10221242,TXFE7,128,9932,1,47857,25076,24228
10221254,10221242,TXFE7,128,9932,4,47861,25077,24229
10221254,10221242,TXFE7,128,9932,1,47862,25078,24230
10221254,10221242,TXFE7,128,9932,2,47864,25079,24231
10221254,10221242,TXFE7,128,9932,27,47891,25080,24242
10221329,10221319,TXFE7,128,9932,2,47893,25081,24243
10221442,10221431,TXFE7,128,9932,1,47894,25082,24244
10221504,10221494,TXFE7,128,9933,1,47895,25083,24245
10221629,10221625,TXFE7,128,9932,1,47896,25084,24246
10221629,10221627,TXFE7,128,9933,4,47900,25085,24250
10221654,10221642,TXFE7,128,9933,4,47904,25086,24251
10221654,10221643,TXFE7,128,9932,4,47908,25089,24252
10221767,10221764,TXFE7,128,9932,1,47909,25090,24253
10221904,10221892,TXFE7,128,9932,1,47910,25091,24254
10221942,10221937,TXFE7,128,9932,1,47911,25092,24255
10222067,10222054,TXFE7,128,9932,1,47912,25093,24256
10222504,10222496,TXFE7,128,9933,1,47913,25094,24257
10222892,10222884,TXFE7,128,9932,1,47914,25095,24258
10222917,10222913,TXFE7,128,9932,2,47916,25097,24259
10223054,10223051,TXFE7,128,9933,1,47917,25098,24260
10223092,10223080,TXFE7,128,9933,2,47919,25099,24261
10223129,10223126,TXFE7,128,9933,1,47920,25100,24262
10223479,10223472,TXFE7,128,9933,2,47922,25101,24263
10223879,10223878,TXFE7,128,9933,25,47947,25102,24271
10223904,10223892,TXFE7,128,9933,4,47951,25103,24275
10224017,10224016,TXFE7,128,9933,3,47954,25104,24276
10224079,10224072,TXFE7,128,9933,1,47955,25105,24277
10224242,10224230,TXFE7,128,9933,9,47964,25106,24281
10224867,10224865,TXFE7,128,9933,4,47968,25110,24282
10225492,10225487,TXFE7,128,9933,5,47973,25111,24285
10225717,10225712,TXFE7,128,9933,13,47986,25112,24291
10230167,10230161,TXFE7,128,9934,1,47987,25113,24292
10230192,10230184,TXFE7,128,9934,2,47989,25114,24294
10230242,10230231,TXFE7,128,9933,2,47991,25116,24295
10230554,10230543,TXFE7,128,9933,2,47993,25117,24296
10230667,10230654,TXFE7,128,9933,1,47994,25118,24297
10230954,10230944,TXFE7,128,9934,10,48004,25119,24305
10231642,10231640,TXFE7,128,9934,2,48006,25120,24307
10231717,10231712,TXFE7,128,9934,1,48007,25121,24308
10231817,10231806,TXFE7,128,9934,1,48008,25122,24309
10231879,10231874,TXFE7,128,9933,1,48009,25123,24310
10231904,10231901,TXFE7,128,9934,1,48010,25124,24311
10232117,10232112,TXFE7,128,9934,1,48011,25125,24312
10232654,10232642,TXFE7,128,9933,4,48015,25129,24313
10233029,10233027,TXFE7,128,9934,4,48019,25130,24317
10233079,10233071,TXFE7,128,9934,3,48022,25131,24320
10233254,10233242,TXFE7,128,9933,20,48042,25140,24321
10233267,10233254,TXFE7,128,9933,1,48043,25141,24322
10233304,10233299,TXFE7,128,9933,1,48044,25142,24323
10233367,10233362,TXFE7,128,9933,4,48048,25145,24324
10233367,10233366,TXFE7,128,9932,20,48068,25162,24325
10233392,10233390,TXFE7,128,9932,1,48069,25163,24326
10233467,10233461,TXFE7,128,9933,1,48070,25164,24327
10233542,10233532,TXFE7,128,9933,1,48071,25165,24328
10233867,10233867,TXFE7,128,9932,8,48079,25169,24329
10233917,10233911,TXFE7,128,9932,27,48106,25186,24330
10233992,10233984,TXFE7,128,9932,1,48107,25187,24331
10234092,10234090,TXFE7,128,9931,2,48109,25188,24332
10234104,10234103,TXFE7,128,9931,2,48111,25189,24333
10234117,10234105,TXFE7,128,9931,2,48113,25190,24334
10234179,10234174,TXFE7,128,9931,1,48114,25191,24335
10234192,10234190,TXFE7,128,9932,1,48115,25192,24336
10234517,10234506,TXFE7,128,9931,1,48116,25193,24337
10234517,10234510,TXFE7,128,9931,2,48118,25194,24338
10234779,10234779,TXFE7,128,9932,1,48119,25195,24339
10235354,10235350,TXFE7,128,9932,1,48120,25196,24340
10235704,10235699,TXFE7,128,9932,1,48121,25197,24341
10235892,10235882,TXFE7,128,9932,3,48124,25198,24342
10235967,10235961,TXFE7,128,9932,1,48125,25199,24343
10240092,10240085,TXFE7,128,9932,2,48127,25200,24344
10240192,10240183,TXFE7,128,9932,1,48128,25201,24345
10240204,10240199,TXFE7,128,9932,1,48129,25202,24346
10240267,10240265,TXFE7,128,9932,1,48130,25203,24347
10240629,10240623,TXFE7,128,9931,1,48131,25204,24348
10240654,10240645,TXFE7,128,9931,37,48168,25205,24349
10240742,10240734,TXFE7,128,9931,1,48169,25206,24350
10240817,10240810,TXFE7,128,9931,90,48259,25272,24351
10240967,10240955,TXFE7,128,9930,2,48261,25273,24352
10240979,10240974,TXFE7,128,9930,1,48262,25274,24353
10240979,10240975,TXFE7,128,9930,8,48270,25278,24354
10240979,10240977,TXFE7,128,9930,1,48271,25279,24355
10240992,10240980,TXFE7,128,9930,2,48273,25280,24356
10240992,10240989,TXFE7,128,9930,1,48274,25281,24357
10240992,10240992,TXFE7,128,9931,1,48275,25282,24358
10240992,10240992,TXFE7,128,9930,1,48276,25283,24359
10241017,10241016,TXFE7,128,9930,1,48277,25284,24360
10241029,10241018,TXFE7,128,9930,2,48279,25285,24361
10241029,10241028,TXFE7,128,9930,12,48291,25294,24362
10241029,10241029,TXFE7,128,9930,2,48293,25296,24363
10241042,10241029,TXFE7,128,9930,1,48294,25297,24364
10241042,10241029,TXFE7,128,9930,11,48305,25305,24365
10241042,10241033,TXFE7,128,9930,9,48314,25308,24366
10241054,10241042,TXFE7,128,9930,4,48318,25311,24367
10241054,10241042,TXFE7,128,9930,10,48328,25314,24368
10241054,10241042,TXFE7,128,9930,4,48332,25317,24369
10241054,10241042,TXFE7,128,9930,2,48334,25319,24370
10241054,10241042,TXFE7,128,9930,10,48344,25328,24371
10241054,10241042,TXFE7,128,9930,78,48422,25378,24372
10241054,10241047,TXFE7,128,9929,3,48425,25380,24373
10241067,10241054,TXFE7,128,9929,2,48427,25381,24374
10241067,10241054,TXFE7,128,9929,8,48435,25388,24375
10241067,10241056,TXFE7,128,9929,5,48440,25393,24376
10241067,10241056,TXFE7,128,9929,1,48441,25394,24377
10241067,10241060,TXFE7,128,9929,1,48442,25395,24378
10241067,10241060,TXFE7,128,9929,3,48445,25396,24379
10241067,10241060,TXFE7,128,9929,1,48446,25397,24380
10241067,10241060,TXFE7,128,9929,2,48448,25399,24381
10241067,10241061,TXFE7,128,9929,1,48449,25400,24382
10241067,10241061,TXFE7,128,9929,1,48450,25401,24383
10241067,10241063,TXFE7,128,9929,1,48451,25402,24384
10241079,10241067,TXFE7,128,9929,1,48452,25403,24385
10241079,10241067,TXFE7,128,9929,2,48454,25404,24386
10241079,10241067,TXFE7,128,9929,4,48458,25407,24387
10241079,10241067,TXFE7,128,9929,1,48459,25408,24388
10241079,10241067,TXFE7,128,9929,1,48460,25409,24389
10241079,10241067,TXFE7,128,9929,5,48465,25414,24390
10241079,10241067,TXFE7,128,9929,4,48469,25418,24391
10241079,10241067,TXFE7,128,9929,1,48470,25419,24392
10241079,10241067,TXFE7,128,9929,2,48472,25421,24393
10241079,10241067,TXFE7,128,9929,1,48473,25422,24394
10241079,10241067,TXFE7,128,9929,2,48475,25423,24395
10241079,10241067,TXFE7,128,9929,1,48476,25424,24396
10241079,10241067,TXFE7,128,9929,1,48477,25425,24397
10241079,10241067,TXFE7,128,9929,1,48478,25426,24398
10241079,10241067,TXFE7,128,9929,1,48479,25427,24399
10241079,10241067,TXFE7,128,9929,2,48481,25428,24400
10241079,10241067,TXFE7,128,9929,6,48487,25430,24401
10241079,10241067,TXFE7,128,9929,4,48491,25431,24402
10241079,10241067,TXFE7,128,9929,2,48493,25432,24403
10241079,10241067,TXFE7,128,9929,2,48495,25433,24404
10241079,10241068,TXFE7,128,9929,1,48496,25434,24405
10241079,10241071,TXFE7,129,9929,1,48504,25441,24406
10241079,10241071,TXFE7,129,9928,7,48504,25441,24406
10241079,10241072,TXFE7,128,9928,10,48514,25447,24407
10241079,10241075,TXFE7,128,9928,10,48524,25454,24408
10241079,10241076,TXFE7,128,9928,9,48533,25460,24409
10241079,10241077,TXFE7,128,9928,1,48534,25461,24410
10241092,10241079,TXFE7,128,9928,1,48535,25462,24411
10241092,10241079,TXFE7,128,9928,10,48545,25466,24412
10241092,10241079,TXFE7,128,9928,2,48547,25468,24413
10241092,10241085,TXFE7,128,9928,6,48553,25472,24414
10241092,10241086,TXFE7,128,9928,2,48555,25474,24415
10241092,10241089,TXFE7,128,9928,2,48557,25476,24416
10241092,10241090,TXFE7,128,9928,1,48558,25477,24417
10241092,10241090,TXFE7,128,9929,1,48559,25478,24418
10241092,10241091,TXFE7,128,9928,1,48560,25479,24419
10241104,10241092,TXFE7,128,9928,11,48571,25484,24420
10241104,10241092,TXFE7,128,9928,15,48586,25491,24421
10241104,10241092,TXFE7,128,9928,6,48592,25496,24422
10241104,10241101,TXFE7,128,9929,1,48593,25497,24423
10241117,10241104,TXFE7,128,9928,5,48598,25499,24424
10241117,10241108,TXFE7,128,9928,1,48599,25500,24425
10241129,10241117,TXFE7,128,9928,1,48600,25501,24426
10241129,10241118,TXFE7,128,9928,2,48602,25503,24427
10241129,10241119,TXFE7,128,9928,1,48603,25504,24428
10241129,10241125,TXFE7,128,9929,1,48604,25505,24429
10241142,10241131,TXFE7,128,9928,1,48605,25506,24430
10241142,10241139,TXFE7,128,9929,10,48615,25507,24434
10241142,10241139,TXFE7,128,9928,2,48617,25509,24435
10241142,10241141,TXFE7,128,9928,2,48619,25511,24436
10241142,10241142,TXFE7,128,9928,2,48621,25513,24437
10241154,10241144,TXFE7,128,9928,1,48622,25514,24438
10241154,10241148,TXFE7,128,9928,1,48623,25515,24439
10241167,10241155,TXFE7,128,9928,1,48624,25516,24440
10241167,10241158,TXFE7,128,9928,1,48625,25517,24441
10241167,10241159,TXFE7,128,9928,1,48626,25518,24442
10241167,10241162,TXFE7,128,9928,1,48627,25519,24443
10241179,10241167,TXFE7,128,9929,1,48628,25520,24444
10241179,10241169,TXFE7,128,9928,1,48629,25521,24445
10241179,10241174,TXFE7,128,9929,2,48631,25522,24446
10241204,10241204,TXFE7,128,9928,1,48632,25523,24447
10241204,10241204,TXFE7,128,9929,1,48633,25524,24448
10241242,10241235,TXFE7,128,9929,3,48636,25525,24450
10241242,10241235,TXFE7,128,9929,3,48639,25526,24451
10241242,10241235,TXFE7,128,9929,1,48640,25527,24452
10241242,10241235,TXFE7,128,9929,2,48642,25528,24453
10241242,10241235,TXFE7,128,9929,3,48645,25529,24455
10241242,10241235,TXFE7,128,9929,3,48648,25530,24457
10241242,10241236,TXFE7,128,9929,1,48649,25531,24458
10241242,10241236,TXFE7,128,9929,1,48650,25532,24459
10241242,10241237,TXFE7,128,9929,1,48651,25533,24460
10241254,10241247,TXFE7,128,9929,1,48652,25534,24461
10241267,10241254,TXFE7,128,9930,4,48656,25535,24464
10241267,10241259,TXFE7,128,9929,1,48657,25536,24465
10241267,10241264,TXFE7,128,9930,7,48664,25537,24469
10241292,10241280,TXFE7,128,9930,2,48666,25538,24470
10241304,10241298,TXFE7,128,9930,1,48667,25539,24471
10241317,10241306,TXFE7,128,9930,1,48668,25540,24472
10241354,10241343,TXFE7,128,9931,1,48669,25541,24473
10241367,10241357,TXFE7,128,9930,10,48679,25544,24474
10241367,10241357,TXFE7,128,9931,1,48680,25545,24475
10241367,10241362,TXFE7,128,9930,1,48681,25546,24476
10241379,10241372,TXFE7,128,9931,1,48682,25547,24477
10241392,10241383,TXFE7,128,9931,1,48683,25548,24478
10241392,10241386,TXFE7,128,9931,1,48684,25549,24479
10241454,10241442,TXFE7,128,9931,2,48686,25550,24480
10241454,10241449,TXFE7,128,9931,2,48688,25551,24481
10241454,10241451,TXFE7,128,9930,1,48689,25552,24482
10241467,10241457,TXFE7,128,9931,1,48690,25553,24483
10241492,10241482,TXFE7,128,9930,1,48691,25554,24484
10241542,10241536,TXFE7,128,9931,1,48692,25555,24485
10241554,10241552,TXFE7,128,9931,1,48693,25556,24486
10241567,10241561,TXFE7,128,9931,2,48695,25557,24487
10241592,10241585,TXFE7,128,9930,1,48696,25558,24488
10241592,10241587,TXFE7,128,9930,1,48697,25559,24489
10241604,10241595,TXFE7,128,9931,1,48698,25560,24490
10241704,10241703,TXFE7,128,9931,3,48701,25561,24493
10241779,10241768,TXFE7,128,9930,1,48702,25562,24494
10241804,10241799,TXFE7,128,9930,1,48703,25563,24495
10241817,10241811,TXFE7,128,9930,1,48704,25564,24496
10241829,10241819,TXFE7,128,9931,2,48706,25565,24498
10241854,10241842,TXFE7,128,9931,1,48707,25566,24499
10241867,10241855,TXFE7,128,9930,1,48708,25567,24500
10241917,10241906,TXFE7,128,9930,1,48709,25568,24501
10241929,10241920,TXFE7,128,9931,1,48710,25569,24502
10241992,10241985,TXFE7,128,9930,1,48711,25570,24503
10242004,10241999,TXFE7,128,9931,2,48713,25571,24504
10242004,10242002,TXFE7,128,9930,11,48724,25577,24505
10242042,10242032,TXFE7,128,9931,2,48726,25578,24507
10242067,10242057,TXFE7,128,9930,20,48746,25585,24508
10242167,10242156,TXFE7,128,9930,1,48747,25586,24509
10242217,10242204,TXFE7,128,9931,1,48748,25587,24510
10242267,10242259,TXFE7,128,9930,1,48749,25588,24511
10242292,10242286,TXFE7,128,9930,1,48750,25589,24512
10242342,10242331,TXFE7,128,9930,1,48751,25590,24513
10242404,10242393,TXFE7,128,9930,2,48753,25591,24514
10242492,10242489,TXFE7,128,9930,2,48755,25593,24515
10242504,10242492,TXFE7,128,9930,2,48757,25594,24516
10242504,10242494,TXFE7,128,9930,2,48759,25595,24517
10242542,10242535,TXFE7,128,9930,1,48760,25596,24518
10242567,10242555,TXFE7,128,9930,1,48761,25597,24519
10242829,10242819,TXFE7,128,9931,2,48763,25598,24520
10242879,10242872,TXFE7,128,9931,1,48764,25599,24521
10242892,10242887,TXFE7,128,9930,3,48767,25602,24522
10242917,10242910,TXFE7,128,9931,2,48769,25603,24524
10242992,10242988,TXFE7,128,9930,1,48770,25604,24525
10243017,10243006,TXFE7,128,9931,3,48773,25605,24527
10243129,10243126,TXFE7,128,9931,1,48774,25606,24528
10243192,10243182,TXFE7,128,9930,1,48775,25607,24529
10243204,10243204,TXFE7,128,9930,1,48776,25608,24530
10243342,10243339,TXFE7,128,9931,2,48778,25609,24532
10243429,10243421,TXFE7,128,9930,1,48779,25610,24533
10243929,10243928,TXFE7,128,9930,3,48782,25612,24534
10244154,10244145,TXFE7,128,9931,1,48821,25621,24560
10244204,10244195,TXFE7,128,9931,1,48822,25622,24561
10244342,10244333,TXFE7,128,9932,1,48823,25623,24562
10244354,10244346,TXFE7,128,9932,1,48824,25624,24563
10244379,10244368,TXFE7,128,9932,1,48825,25625,24564
10244404,10244403,TXFE7,128,9932,1,48826,25626,24565
10244404,10244404,TXFE7,128,9932,5,48831,25627,24568
10244404,10244404,TXFE7,128,9932,2,48833,25628,24570
10244417,10244404,TXFE7,128,9932,2,48835,25629,24572
10244417,10244407,TXFE7,128,9932,1,48836,25630,24573
10244467,10244455,TXFE7,128,9933,2,48838,25631,24574
10244492,10244479,TXFE7,128,9933,1,48839,25632,24575
10244492,10244486,TXFE7,128,9932,1,48840,25633,24576
10244504,10244492,TXFE7,128,9933,3,48843,25634,24577
10244579,10244576,TXFE7,128,9933,3,48846,25635,24580
10244592,10244588,TXFE7,128,9933,1,48847,25636,24581
10244629,10244622,TXFE7,128,9933,3,48850,25637,24582
10244679,10244677,TXFE7,128,9933,5,48855,25638,24586
10244717,10244710,TXFE7,128,9932,1,48856,25639,24587
10245054,10245049,TXFE7,128,9932,4,48860,25640,24588
10245267,10245262,TXFE7,128,9933,18,48878,25641,24599
10245279,10245275,TXFE7,128,9933,1,48879,25642,24600
10245392,10245389,TXFE7,128,9934,1,48880,25643,24601
10245404,10245401,TXFE7,128,9934,1,48881,25644,24602
10245442,10245437,TXFE7,128,9933,1,48882,25645,24603
10245504,10245498,TXFE7,128,9934,1,48883,25646,24604
10245529,10245522,TXFE7,128,9933,1,48884,25647,24605
10245529,10245522,TXFE7,128,9933,1,48885,25648,24606
10245529,10245522,TXFE7,128,9933,1,48886,25649,24607
10245529,10245522,TXFE7,128,9933,1,48887,25650,24608
10245529,10245522,TXFE7,128,9933,1,48888,25651,24609
10245529,10245522,TXFE7,128,9933,1,48889,25652,24610
10245529,10245522,TXFE7,128,9933,1,48890,25653,24611
10245542,10245530,TXFE7,128,9933,15,48905,25656,24612
10245567,10245554,TXFE7,128,9933,10,48915,25657,24613
10245579,10245567,TXFE7,128,9933,1,48916,25658,24614
10245579,10245571,TXFE7,128,9934,3,48919,25659,24615
10245592,10245580,TXFE7,128,9933,3,48922,25662,24616
10245704,10245692,TXFE7,128,9933,1,48923,25663,24617
10245717,10245716,TXFE7,128,9932,1,48924,25664,24618
10245754,10245752,TXFE7,128,9933,2,48926,25666,24619
10245767,10245763,TXFE7,128,9934,1,48927,25667,24620
10245767,10245767,TXFE7,128,9933,1,48928,25668,24621
10245779,10245773,TXFE7,128,9934,1,48929,25669,24622
10245792,10245787,TXFE7,128,9933,1,48930,25670,24623
10245842,10245831,TXFE7,128,9933,2,48932,25671,24624
10245867,10245860,TXFE7,128,9933,2,48934,25672,24625
10245892,10245887,TXFE7,128,9934,1,48935,25673,24626
10245942,10245935,TXFE7,128,9934,1,48936,25674,24627
10250079,10250070,TXFE7,128,9933,2,48938,25675,24628
10250092,10250090,TXFE7,128,9933,1,48939,25676,24629
10250117,10250116,TXFE7,128,9933,1,48940,25677,24630
10250142,10250132,TXFE7,128,9933,2,48942,25678,24631
10250254,10250249,TXFE7,128,9934,1,48943,25679,24632
10250467,10250462,TXFE7,128,9934,2,48945,25680,24634
10250629,10250620,TXFE7,128,9934,3,48948,25681,24636
10250629,10250620,TXFE7,128,9934,1,48949,25682,24637
10250642,10250640,TXFE7,128,9934,1,48950,25683,24638
10250667,10250657,TXFE7,128,9934,1,48951,25684,24639
10250692,10250689,TXFE7,128,9934,1,48952,25685,24640
10250729,10250724,TXFE7,128,9934,1,48953,25686,24641
10250892,10250882,TXFE7,128,9934,1,48954,25687,24642
10250992,10250987,TXFE7,128,9934,1,48955,25688,24643
10251229,10251221,TXFE7,128,9934,1,48956,25689,24644
10251279,10251270,TXFE7,128,9934,1,48957,25690,24645
10251292,10251287,TXFE7,128,9934,2,48959,25691,24647
10251329,10251325,TXFE7,128,9934,2,48961,25692,24648
10251354,10251351,TXFE7,128,9934,1,48962,25693,24649
10251479,10251469,TXFE7,128,9933,1,48963,25694,24650
10251517,10251506,TXFE7,128,9934,1,48964,25695,24651
10251592,10251582,TXFE7,128,9934,1,48965,25696,24652
10251617,10251604,TXFE7,128,9934,1,48966,25697,24653
10251692,10251681,TXFE7,128,9934,1,48967,25698,24654
10251704,10251695,TXFE7,128,9933,4,48971,25700,24655
10251779,10251779,TXFE7,128,9934,2,48973,25701,24657
10251879,10251873,TXFE7,128,9933,2,48975,25702,24658
10252242,10252232,TXFE7,128,9934,1,48976,25703,24659
10252242,10252233,TXFE7,128,9933,1,48977,25704,24660
10252279,10252268,TXFE7,128,9933,1,48978,25705,24661
10252317,10252314,TXFE7,128,9933,1,48979,25706,24662
10252367,10252358,TXFE7,128,9933,1,48980,25707,24663
10252404,10252392,TXFE7,128,9934,2,48982,25708,24665
10252417,10252404,TXFE7,128,9933,1,48983,25709,24666
10252492,10252492,TXFE7,128,9934,1,48984,25710,24667
10252567,10252557,TXFE7,128,9934,2,48986,25711,24668
10252579,10252576,TXFE7,128,9934,5,48991,25712,24673
10252792,10252790,TXFE7,128,9934,2,48993,25713,24675
10252817,10252808,TXFE7,128,9933,1,48994,25714,24676
10252829,10252822,TXFE7,128,9934,1,48995,25715,24677
10252904,10252897,TXFE7,128,9933,1,48996,25716,24678
10252942,10252933,TXFE7,128,9933,1,48997,25717,24679
10252979,10252975,TXFE7,128,9933,1,48998,25718,24680
10253017,10253016,TXFE7,128,9933,1,48999,25719,24681
10253067,10253058,TXFE7,128,9933,1,49000,25720,24682
10253154,10253149,TXFE7,128,9933,1,49001,25721,24683
10253179,10253170,TXFE7,128,9933,1,49002,25722,24684
10253467,10253463,TXFE7,128,9933,1,49003,25723,24685
10253467,10253466,TXFE7,128,9933,2,49005,25724,24686
10253567,10253562,TXFE7,128,9933,1,49006,25725,24687
10253579,10253574,TXFE7,128,9933,1,49007,25726,24688
10253667,10253657,TXFE7,128,9933,4,49011,25730,24689
10253717,10253711,TXFE7,128,9934,2,49013,25731,24691
10254717,10254716,TXFE7,128,9934,1,49014,25732,24692
10254904,10254894,TXFE7,128,9933,1,49015,25733,24693
10254917,10254917,TXFE7,128,9933,1,49016,25734,24694
10255017,10255005,TXFE7,128,9933,1,49017,25735,24695
10255192,10255186,TXFE7,128,9934,1,49018,25736,24696
10255292,10255291,TXFE7,128,9934,1,49019,25737,24697
10255342,10255337,TXFE7,128,9933,20,49039,25752,24698
10255679,10255674,TXFE7,128,9933,2,49041,25754,24699
10255967,10255955,TXFE7,128,9934,1,49042,25755,24700
10260067,10260064,TXFE7,128,9933,1,49043,25756,24701
10260079,10260079,TXFE7,128,9934,1,49044,25757,24702
10260142,10260140,TXFE7,128,9934,1,49045,25758,24703
10260267,10260254,TXFE7,128,9934,4,49049,25759,24704
10260267,10260255,TXFE7,128,9934,44,49093,25760,24735
10260279,10260267,TXFE7,128,9935,1,49094,25761,24736
10260304,10260299,TXFE7,128,9935,1,49095,25762,24737
10260542,10260534,TXFE7,128,9935,3,49098,25763,24740
10260554,10260544,TXFE7,128,9935,1,49099,25764,24741
10260692,10260682,TXFE7,128,9935,1,49100,25765,24742
10260742,10260740,TXFE7,128,9935,1,49101,25766,24743
10260829,10260818,TXFE7,128,9934,2,49103,25767,24744
10260829,10260818,TXFE7,128,9935,1,49104,25768,24745
10261042,10261039,TXFE7,128,9935,1,49105,25769,24746
10261067,10261055,TXFE7,128,9935,1,49106,25770,24747
10261117,10261106,TXFE7,128,9935,1,49107,25771,24748
10261242,10261236,TXFE7,128,9935,1,49108,25772,24749
10261267,10261266,TXFE7,128,9935,1,49109,25773,24750
10261392,10261382,TXFE7,128,9935,1,49110,25774,24751
10261417,10261405,TXFE7,128,9935,58,49168,25775,24789
10261442,10261432,TXFE7,128,9935,1,49169,25776,24790
10261529,10261524,TXFE7,128,9935,1,49170,25777,24791
10261567,10261564,TXFE7,128,9936,2,49172,25778,24793
10261617,10261615,TXFE7,128,9936,2,49174,25779,24794
10261629,10261627,TXFE7,128,9936,1,49175,25780,24795
10261717,10261709,TXFE7,128,9936,1,49176,25781,24796
10261804,10261799,TXFE7,128,9936,2,49178,25782,24797
10261817,10261809,TXFE7,128,9936,1,49179,25783,24798
10261854,10261853,TXFE7,128,9935,1,49180,25784,24799
10261942,10261934,TXFE7,128,9936,2,49182,25785,24801
10262154,10262145,TXFE7,128,9936,2,49184,25786,24803
10262304,10262301,TXFE7,128,9936,1,49185,25787,24804
10262529,10262518,TXFE7,128,9936,1,49186,25788,24805
10262554,10262549,TXFE7,128,9936,1,49187,25789,24806
10262592,10262591,TXFE7,128,9936,1,49188,25790,24807
10262717,10262715,TXFE7,128,9936,1,49189,25791,24808
10262842,10262836,TXFE7,128,9936,1,49190,25792,24809
10263167,10263159,TXFE7,128,9936,1,49191,25793,24810
10263242,10263234,TXFE7,128,9936,1,49192,25794,24811
10263504,10263492,TXFE7,128,9936,5,49197,25795,24812
10263567,10263561,TXFE7,128,9936,3,49200,25796,24813
10263717,10263713,TXFE7,128,9936,2,49202,25797,24814
10263817,10263805,TXFE7,128,9935,1,49203,25798,24815
10263854,10263844,TXFE7,128,9936,1,49204,25799,24816
10263992,10263985,TXFE7,128,9936,2,49206,25800,24818
10264042,10264033,TXFE7,128,9936,1,49207,25801,24819
10264054,10264052,TXFE7,128,9936,2,49209,25802,24820
10264117,10264115,TXFE7,128,9935,4,49213,25803,24821
10264192,10264191,TXFE7,128,9935,1,49214,25804,24822
10264204,10264202,TXFE7,128,9936,1,49215,25805,24823
10264367,10264359,TXFE7,128,9935,4,49219,25809,24824
10264504,10264493,TXFE7,128,9935,1,49220,25810,24825
10264554,10264553,TXFE7,128,9936,4,49224,25811,24826
10264617,10264615,TXFE7,128,9936,1,49225,25812,24827
10264667,10264661,TXFE7,128,9935,1,49226,25813,24828
10264792,10264783,TXFE7,128,9935,1,49227,25814,24829
10264867,10264855,TXFE7,128,9935,1,49228,25815,24830
10265179,10265178,TXFE7,128,9935,1,49229,25816,24831
10265592,10265591,TXFE7,128,9935,2,49231,25817,24832
10265604,10265595,TXFE7,128,9935,1,49232,25818,24833
10265617,10265616,TXFE7,128,9936,1,49233,25819,24834
10265717,10265709,TXFE7,128,9935,1,49234,25820,24835
10270017,10270009,TXFE7,128,9936,1,49235,25821,24836
10270054,10270045,TXFE7,128,9935,5,49240,25823,24837
10270067,10270067,TXFE7,128,9936,1,49241,25824,24838
10270129,10270122,TXFE7,128,9935,2,49243,25825,24839
10270192,10270184,TXFE7,128,9935,1,49244,25826,24840
10270204,10270199,TXFE7,128,9935,1,49245,25827,24841
10270279,10270273,TXFE7,128,9936,2,49247,25828,24843
10270304,10270298,TXFE7,128,9936,2,49249,25829,24844
10271779,10271768,TXFE7,128,9936,25,49288,25839,24867
10271792,10271779,TXFE7,128,9936,12,49300,25840,24878
10271792,10271780,TXFE7,128,9936,11,49311,25841,24886
10271804,10271798,TXFE7,128,9936,1,49312,25842,24887
10272254,10272252,TXFE7,128,9936,1,49321,25849,24894
10272267,10272255,TXFE7,128,9935,1,49322,25850,24895
10272279,10272277,TXFE7,128,9936,1,49323,25851,24896
10272292,10272280,TXFE7,128,9936,1,49324,25852,24897
10272692,10272689,TXFE7,128,9936,1,49334,25857,24900
10272767,10272761,TXFE7,128,9936,1,49335,25858,24901
10272767,10272763,TXFE7,128,9936,1,49336,25859,24902
10272842,10272836,TXFE7,128,9936,10,49346,25860,24912
10272967,10272966,TXFE7,128,9935,1,49347,25861,24913
10273579,10273573,TXFE7,128,9936,1,49381,25885,24920
10274042,10274030,TXFE7,128,9935,40,49421,25909,24921
10274054,10274042,TXFE7,128,9935,4,49425,25912,24922
10274067,10274054,TXFE7,128,9935,2,49427,25913,24923
10274067,10274054,TXFE7,128,9935,2,49429,25914,24924
10274067,10274055,TXFE7,128,9935,7,49436,25917,24925
10274079,10274067,TXFE7,128,9935,4,49440,25918,24927
10274104,10274093,TXFE7,128,9935,1,49441,25919,24928
10274104,10274093,TXFE7,128,9935,1,49442,25920,24929
10274604,10274600,TXFE7,128,9935,3,49445,25922,24930
10274617,10274604,TXFE7,128,9936,12,49457,25923,24931
10274842,10274838,TXFE7,128,9935,1,49458,25924,24932
10274867,10274864,TXFE7,128,9936,1,49459,25925,24933
10274967,10274960,TXFE7,128,9935,10,49469,25929,24934
10274979,10274967,TXFE7,128,9935,3,49472,25931,24935
10275104,10275103,TXFE7,128,9935,1,49473,25932,24936
10275129,10275124,TXFE7,128,9935,3,49476,25933,24937
10275292,10275282,TXFE7,128,9935,1,49477,25934,24938
10275629,10275629,TXFE7,128,9935,1,49478,25935,24939
10280154,10280153,TXFE7,128,9935,20,49498,25936,24946
10280167,10280154,TXFE7,128,9935,2,49500,25937,24948
10280267,10280265,TXFE7,128,9934,1,49501,25938,24949
10280279,10280269,TXFE7,128,9935,1,49502,25939,24950
10280529,10280525,TXFE7,128,9935,1,49503,25940,24951
10280579,10280578,TXFE7,128,9935,1,49504,25941,24952
10280592,10280581,TXFE7,128,9935,1,49505,25942,24953
10280604,10280592,TXFE7,128,9935,5,49510,25943,24955
10280629,10280626,TXFE7,128,9936,1,49511,25944,24956
10280679,10280678,TXFE7,128,9935,1,49512,25945,24957
10280804,10280793,TXFE7,128,9935,2,49514,25947,24958
10281042,10281034,TXFE7,128,9935,1,49515,25948,24959
10281117,10281111,TXFE7,128,9936,1,49516,25949,24960
10281492,10281491,TXFE7,128,9935,1,49517,25950,24961
10281754,10281746,TXFE7,128,9935,2,49519,25952,24962
10281867,10281860,TXFE7,128,9935,1,49520,25953,24963
10281892,10281880,TXFE7,128,9936,2,49522,25954,24964
10282217,10282216,TXFE7,128,9935,1,49523,25955,24965
10282242,10282232,TXFE7,128,9935,1,49524,25956,24966
10282429,10282417,TXFE7,128,9935,1,49525,25957,24967
10282679,10282672,TXFE7,128,9935,1,49526,25958,24968
10282879,10282874,TXFE7,128,9935,1,49527,25959,24969
10282892,10282881,TXFE7,128,9935,1,49528,25960,24970
10283092,10283089,TXFE7,128,9935,1,49529,25961,24971
10283117,10283105,TXFE7,128,9935,1,49530,25962,24972
10283404,10283401,TXFE7,128,9935,1,49531,25963,24973
10283417,10283408,TXFE7,128,9935,1,49532,25964,24974
10283642,10283640,TXFE7,128,9935,1,49533,25965,24975
10283917,10283915,TXFE7,128,9935,2,49535,25967,24976
10283967,10283962,TXFE7,128,9935,1,49536,25968,24977
10284004,10284000,TXFE7,128,9935,1,49537,25969,24978
10284129,10284126,TXFE7,128,9935,1,49538,25970,24979
10284179,10284176,TXFE7,128,9935,1,49539,25971,24980
10284529,10284521,TXFE7,128,9935,1,49540,25972,24981
10284629,10284621,TXFE7,128,9936,1,49541,25973,24982
10285517,10285516,TXFE7,128,9935,1,49542,25974,24983
10285554,10285551,TXFE7,128,9936,1,49543,25975,24984
10285592,10285589,TXFE7,128,9936,20,49563,25976,25001
10285592,10285590,TXFE7,128,9936,1,49564,25977,25002
10285592,10285590,TXFE7,128,9936,2,49566,25978,25004
10285592,10285590,TXFE7,128,9936,2,49568,25979,25006
10285592,10285590,TXFE7,128,9936,32,49600,25980,25029
10285867,10285855,TXFE7,128,9936,1,49601,25981,25030
10290067,10290063,TXFE7,128,9936,1,49602,25982,25031
10290092,10290089,TXFE7,128,9937,1,49603,25983,25032
10290104,10290094,TXFE7,128,9937,1,49604,25984,25033
10290104,10290094,TXFE7,128,9936,1,49605,25985,25034
10290104,10290100,TXFE7,128,9937,1,49606,25986,25035
10290129,10290118,TXFE7,128,9937,1,49607,25987,25036
10290204,10290199,TXFE7,128,9937,1,49608,25988,25037
10290204,10290203,TXFE7,128,9937,3,49611,25989,25040
10290254,10290250,TXFE7,128,9936,6,49617,25991,25041
10290279,10290268,TXFE7,128,9936,1,49618,25992,25042
10290467,10290456,TXFE7,128,9937,2,49620,25993,25044
10290492,10290486,TXFE7,128,9936,1,49621,25994,25045
10290504,10290501,TXFE7,128,9936,1,49622,25995,25046
10290717,10290715,TXFE7,128,9937,1,49623,25996,25047
10291904,10291898,TXFE7,128,9937,1,49624,25997,25048
10292229,10292220,TXFE7,128,9937,1,49625,25998,25049
10292304,10292294,TXFE7,128,9937,3,49628,25999,25050
10292529,10292524,TXFE7,128,9936,1,49629,26000,25051
10292567,10292557,TXFE7,128,9937,1,49630,26001,25052
10292654,10292642,TXFE7,128,9937,4,49634,26002,25053
10292667,10292654,TXFE7,128,9937,3,49637,26003,25054
10292667,10292658,TXFE7,128,9937,63,49700,26004,25097
10292704,10292692,TXFE7,128,9938,1,49701,26005,25098
10292717,10292713,TXFE7,128,9938,1,49702,26006,25099
10292742,10292731,TXFE7,128,9938,1,49703,26007,25100
10292742,10292736,TXFE7,128,9938,1,49704,26008,25101
10292754,10292743,TXFE7,128,9938,1,49705,26009,25102
10292754,10292746,TXFE7,128,9938,1,49706,26010,25103
10292767,10292756,TXFE7,128,9938,1,49707,26011,25104
10292767,10292766,TXFE7,128,9938,1,49708,26012,25105
10292767,10292767,TXFE7,128,9937,1,49709,26013,25106
10292842,10292830,TXFE7,128,9937,2,49711,26015,25107
10292892,10292884,TXFE7,128,9937,1,49712,26016,25108
10292929,10292927,TXFE7,128,9938,1,49713,26017,25109
10292942,10292938,TXFE7,128,9937,1,49714,26018,25110
10293029,10293018,TXFE7,128,9937,1,49715,26019,25111
10293154,10293149,TXFE7,128,9938,1,49716,26020,25112
10293179,10293175,TXFE7,128,9938,1,49717,26021,25113
10293179,10293177,TXFE7,128,9938,1,49718,26022,25114
10293429,10293427,TXFE7,128,9937,1,49719,26023,25115
10293554,10293551,TXFE7,128,9938,1,49720,26024,25116
10293754,10293742,TXFE7,128,9937,1,49721,26025,25117
10293779,10293776,TXFE7,128,9937,2,49723,26026,25118
10294067,10294057,TXFE7,128,9938,9,49732,26027,25119
10294104,10294096,TXFE7,128,9938,1,49733,26028,25120
10294142,10294131,TXFE7,128,9937,1,49734,26029,25121
10294379,10294377,TXFE7,128,9937,1,49735,26030,25122
10294404,10294392,TXFE7,128,9938,1,49736,26031,25123
10294517,10294510,TXFE7,128,9938,3,49739,26032,25124
10294667,10294660,TXFE7,128,9938,1,49740,26033,25125
10294929,10294920,TXFE7,128,9937,1,49741,26034,25126
10294979,10294978,TXFE7,128,9937,49,49790,26060,25127
10295004,10294995,TXFE7,128,9937,1,49791,26061,25128
10295042,10295039,TXFE7,128,9936,2,49793,26062,25129
10295079,10295071,TXFE7,128,9937,1,49794,26063,25130
10295292,10295288,TXFE7,128,9936,1,49795,26064,25131
10295504,10295504,TXFE7,128,9937,1,49796,26065,25132
10295542,10295529,TXFE7,128,9937,3,49799,26066,25133
10295629,10295624,TXFE7,128,9937,1,49800,26067,25134
10295642,10295640,TXFE7,128,9937,11,49811,26068,25140
10295754,10295750,TXFE7,128,9937,1,49812,26069,25141
10295767,10295765,TXFE7,128,9938,2,49814,26070,25143
10295792,10295786,TXFE7,128,9937,2,49816,26071,25144
10295992,10295981,TXFE7,128,9937,1,49817,26072,25145
10300167,10300157,TXFE7,128,9937,1,49818,26073,25146
10300204,10300195,TXFE7,128,9937,4,49822,26074,25147
10300217,10300205,TXFE7,129,9937,1,49828,26079,25148
10300217,10300205,TXFE7,129,9936,5,49828,26079,25148
10300229,10300229,TXFE7,128,9937,1,49829,26080,25149
10300242,10300233,TXFE7,128,9936,1,49830,26081,25150
10300304,10300300,TXFE7,128,9937,1,49831,26082,25151
10300442,10300430,TXFE7,128,9936,3,49834,26085,25152
10300442,10300432,TXFE7,128,9936,3,49837,26088,25153
10300554,10300545,TXFE7,128,9937,1,49838,26089,25154
10300704,10300700,TXFE7,128,9936,14,49852,26102,25155
10300717,10300710,TXFE7,128,9935,1,49853,26103,25156
10300717,10300717,TXFE7,128,9936,4,49857,26104,25157
10301317,10301313,TXFE7,128,9936,1,49858,26105,25158
10301992,10301986,TXFE7,128,9936,1,49859,26106,25159
10302117,10302116,TXFE7,128,9935,1,49860,26107,25160
10302579,10302578,TXFE7,128,9935,1,49861,26108,25161
10302629,10302628,TXFE7,128,9936,1,49862,26109,25162
10303429,10303421,TXFE7,128,9936,5,49867,26110,25165
10303517,10303513,TXFE7,128,9935,1,49868,26111,25166
10304154,10304143,TXFE7,128,9935,1,49869,26112,25167
10304242,10304232,TXFE7,128,9936,1,49870,26113,25168
10304242,10304232,TXFE7,128,9936,1,49871,26114,25169
10304242,10304232,TXFE7,128,9936,6,49877,26115,25175
10304242,10304238,TXFE7,128,9936,1,49878,26116,25176
10304242,10304239,TXFE7,128,9937,4,49882,26117,25177
10304242,10304240,TXFE7,128,9936,1,49883,26118,25178
10304254,10304242,TXFE7,128,9936,2,49885,26119,25179
10304254,10304242,TXFE7,128,9936,1,49886,26120,25180
10304304,10304299,TXFE7,128,9936,16,49902,26127,25181
10304704,10304698,TXFE7,128,9935,1,49903,26128,25182
10305042,10305035,TXFE7,128,9935,1,49904,26129,25183
10305092,10305088,TXFE7,128,9935,1,49905,26130,25184
10305154,10305150,TXFE7,128,9935,1,49906,26131,25185
10305629,10305626,TXFE7,128,9935,1,49907,26132,25186
10305742,10305736,TXFE7,128,9936,1,49908,26133,25187
10305892,10305881,TXFE7,128,9936,1,49909,26134,25188
10305892,10305886,TXFE7,128,9936,4,49913,26135,25190
10305904,10305892,TXFE7,128,9936,1,49914,26136,25191
10305904,10305892,TXFE7,128,9936,1,49915,26137,25192
10305904,10305897,TXFE7,128,9935,1,49916,26138,25193
10305904,10305903,TXFE7,128,9936,7,49923,26139,25195
10305917,10305904,TXFE7,128,9936,1,49924,26140,25196
10310942,10310941,TXFE7,128,9936,1,49925,26141,25197
10311067,10311066,TXFE7,128,9935,2,49927,26142,25198
10311329,10311322,TXFE7,128,9935,1,49928,26143,25199
10311504,10311498,TXFE7,128,9935,2,49930,26144,25200
10311579,10311568,TXFE7,128,9936,2,49932,26145,25202
10311617,10311606,TXFE7,128,9935,1,49933,26146,25203
10311892,10311892,TXFE7,128,9935,1,49934,26147,25204
10311904,10311892,TXFE7,128,9935,4,49938,26150,25205
10311904,10311892,TXFE7,128,9935,18,49956,26165,25206
10311929,10311921,TXFE7,128,9935,2,49958,26166,25207
10312092,10312088,TXFE7,128,9936,14,49972,26167,25217
10312267,10312256,TXFE7,128,9936,2,49974,26168,25218
10312667,10312663,TXFE7,128,9936,1,49975,26169,25219
10313254,10313242,TXFE7,128,9936,4,49979,26171,25220
10313254,10313254,TXFE7,128,9936,2,49981,26173,25221
10313592,10313579,TXFE7,128,9936,1,49982,26174,25222
10313929,10313920,TXFE7,128,9936,2,49984,26175,25223
10314067,10314063,TXFE7,128,9936,12,49996,26181,25224
10314079,10314067,TXFE7,128,9936,1,49997,26182,25225
10314429,10314428,TXFE7,128,9936,1,49998,26183,25226
10314442,10314437,TXFE7,128,9936,1,49999,26184,25227
10314842,10314831,TXFE7,128,9936,3,50002,26187,25228
10315054,10315054,TXFE7,128,9936,1,50003,26188,25229
10315217,10315206,TXFE7,128,9936,1,50004,26189,25230
10315242,10315229,TXFE7,128,9936,1,50005,26190,25231
10315267,10315255,TXFE7,128,9936,1,50006,26191,25232
10315517,10315517,TXFE7,128,9935,1,50007,26192,25233
10320142,10320137,TXFE7,128,9935,6,50013,26197,25234
10320179,10320179,TXFE7,128,9935,15,50028,26205,25235
10320304,10320292,TXFE7,128,9935,1,50029,26206,25236
10320504,10320504,TXFE7,128,9935,1,50030,26207,25237
10320579,10320574,TXFE7,128,9936,1,50031,26208,25238
10320617,10320609,TXFE7,128,9935,1,50032,26209,25239
10320642,10320634,TXFE7,128,9936,20,50052,26210,25247
10320654,10320647,TXFE7,128,9936,2,50054,26211,25249
10320654,10320647,TXFE7,128,9936,1,50055,26212,25250
10320942,10320936,TXFE7,128,9935,2,50057,26214,25251
10321292,10321287,TXFE7,128,9935,1,50058,26215,25252
10321342,10321339,TXFE7,128,9936,1,50059,26216,25253
10321729,10321726,TXFE7,128,9936,1,50060,26217,25254
10322767,10322761,TXFE7,128,9936,9,50069,26218,25258
10322792,10322790,TXFE7,128,9937,1,50070,26219,25259
10323929,10323923,TXFE7,128,9936,1,50071,26220,25260
10324392,10324390,TXFE7,128,9937,1,50072,26221,25261
10324454,10324454,TXFE7,128,9936,1,50073,26222,25262
10324592,10324586,TXFE7,128,9936,1,50074,26223,25263
10325504,10325493,TXFE7,128,9936,3,50077,26224,25264
10325817,10325813,TXFE7,128,9936,2,50079,26225,25265
10330867,10330857,TXFE7,128,9936,1,50080,26226,25266
10331029,10331019,TXFE7,128,9936,5,50085,26227,25267
10331042,10331034,TXFE7,128,9937,1,50086,26228,25268
10331379,10331379,TXFE7,128,9937,1,50087,26229,25269
10331567,10331566,TXFE7,128,9936,2,50089,26230,25270
10331604,10331597,TXFE7,128,9937,1,50090,26231,25271
10331667,10331658,TXFE7,128,9937,1,50091,26232,25272
10331967,10331960,TXFE7,128,9936,1,50092,26233,25273
10332179,10332167,TXFE7,128,9936,2,50094,26235,25274
10332467,10332463,TXFE7,128,9936,1,50095,26236,25275
10332754,10332749,TXFE7,128,9936,2,50097,26238,25276
10332954,10332951,TXFE7,128,9936,10,50107,26242,25277
10333242,10333236,TXFE7,128,9936,1,50108,26243,25278
10333292,10333289,TXFE7,128,9936,2,50110,26244,25279
10333529,10333524,TXFE7,128,9936,2,50112,26245,25280
10333654,10333649,TXFE7,128,9936,10,50122,26247,25281
10333829,10333827,TXFE7,128,9936,2,50124,26249,25282
10334317,10334309,TXFE7,128,9936,10,50134,26251,25283
10334379,10334370,TXFE7,128,9936,2,50136,26253,25284
10334504,10334500,TXFE7,128,9936,1,50137,26254,25285
10334704,10334698,TXFE7,128,9936,1,50138,26255,25286
10334729,10334729,TXFE7,128,9936,10,50148,26258,25287
10334879,10334873,TXFE7,128,9936,1,50149,26259,25288
10334942,10334930,TXFE7,128,9936,2,50151,26260,25289
10334942,10334932,TXFE7,128,9936,1,50152,26261,25290
10335004,10335004,TXFE7,128,9936,1,50153,26262,25291
10335154,10335147,TXFE7,128,9936,3,50156,26263,25292
10335342,10335332,TXFE7,128,9936,10,50166,26264,25293
10335379,10335374,TXFE7,128,9936,1,50167,26265,25294
10335479,10335469,TXFE7,128,9936,2,50169,26267,25295
10335629,10335620,TXFE7,128,9936,2,50171,26268,25296
10335667,10335661,TXFE7,128,9937,1,50172,26269,25297
10335754,10335749,TXFE7,128,9936,10,50182,26271,25298
10340029,10340029,TXFE7,128,9936,2,50184,26273,25299
10340579,10340568,TXFE7,128,9936,2,50186,26274,25300
10341004,10340992,TXFE7,128,9937,68,50254,26275,25340
10341054,10341053,TXFE7,128,9938,7,50261,26276,25344
10341079,10341068,TXFE7,128,9937,10,50271,26279,25345
10341117,10341112,TXFE7,128,9937,2,50273,26280,25346
10341242,10341239,TXFE7,128,9937,3,50276,26282,25347
10341354,10341344,TXFE7,128,9938,2,50278,26283,25349
10341529,10341526,TXFE7,128,9938,7,50285,26284,25355
10341554,10341549,TXFE7,128,9938,1,50286,26285,25356
10341567,10341555,TXFE7,128,9938,10,50296,26286,25363
10341579,10341569,TXFE7,128,9938,8,50304,26287,25368
10341679,10341672,TXFE7,128,9937,2,50306,26288,25369
10341742,10341741,TXFE7,128,9938,4,50310,26289,25373
10341742,10341742,TXFE7,128,9938,63,50373,26290,25413
10341767,10341757,TXFE7,128,9939,7,50380,26291,25419
10341779,10341769,TXFE7,128,9939,2,50382,26292,25420
10341792,10341783,TXFE7,128,9939,1,50383,26293,25421
10341792,10341785,TXFE7,128,9939,2,50385,26294,25422
10341804,10341804,TXFE7,128,9939,2,50387,26295,25423
10341817,10341817,TXFE7,128,9939,2,50389,26296,25424
10341879,10341875,TXFE7,128,9939,1,50390,26297,25425
10341929,10341919,TXFE7,128,9939,3,50393,26298,25426
10341954,10341945,TXFE7,128,9939,1,50394,26299,25427
10342029,10342028,TXFE7,128,9939,6,50400,26300,25431
10342092,10342089,TXFE7,128,9938,2,50402,26301,25432
10342117,10342112,TXFE7,128,9938,10,50412,26303,25433
10342229,10342218,TXFE7,128,9938,2,50414,26304,25434
10342292,10342285,TXFE7,128,9939,1,50415,26305,25435
10342329,10342324,TXFE7,128,9938,1,50416,26306,25436
10342654,10342648,TXFE7,128,9938,4,50420,26310,25437
10342667,10342654,TXFE7,128,9938,1,50421,26311,25438
10342667,10342654,TXFE7,128,9938,1,50422,26312,25439
10342679,10342667,TXFE7,128,9938,2,50424,26313,25440
10342692,10342679,TXFE7,128,9938,3,50427,26314,25441
10342729,10342723,TXFE7,128,9938,5,50432,26316,25442
10342779,10342769,TXFE7,128,9937,2,50434,26317,25443
10342792,10342782,TXFE7,128,9938,10,50444,26318,25445
10342829,10342817,TXFE7,128,9938,1,50445,26319,25446
10342854,10342844,TXFE7,128,9938,1,50446,26320,25447
10342854,10342850,TXFE7,128,9937,10,50456,26321,25448
10342867,10342856,TXFE7,128,9938,2,50458,26322,25450
10342992,10342984,TXFE7,128,9938,1,50459,26323,25451
10343317,10343311,TXFE7,128,9937,10,50469,26330,25452
10343342,10343329,TXFE7,128,9937,2,50471,26332,25453
10343867,10343864,TXFE7,128,9938,5,50476,26333,25456
10343879,10343871,TXFE7,128,9937,2,50478,26334,25457
10343967,10343965,TXFE7,128,9938,1,50479,26335,25458
10343992,10343988,TXFE7,128,9938,4,50483,26336,25462
10344004,10343992,TXFE7,128,9938,2,50485,26337,25463
10344092,10344091,TXFE7,129,9938,1,50495,26341,25464
10344092,10344091,TXFE7,129,9937,9,50495,26341,25464
10344417,10344410,TXFE7,128,9937,2,50497,26342,25465
10344442,10344429,TXFE7,128,9938,1,50498,26343,25466
10344629,10344627,TXFE7,128,9938,3,50501,26344,25469
10344642,10344629,TXFE7,128,9938,4,50505,26345,25472
10344904,10344901,TXFE7,128,9939,1,50506,26346,25473
10344954,10344945,TXFE7,128,9939,1,50507,26347,25474
10344979,10344971,TXFE7,128,9938,2,50509,26348,25475
10344992,10344987,TXFE7,128,9938,2,50511,26350,25476
10345029,10345023,TXFE7,128,9938,1,50512,26351,25477
10345067,10345061,TXFE7,128,9938,9,50521,26352,25478
10345179,10345167,TXFE7,128,9938,1,50522,26353,25479
10345242,10345231,TXFE7,128,9939,2,50524,26354,25481
10345254,10345248,TXFE7,128,9938,10,50534,26358,25482
10345254,10345252,TXFE7,129,9938,6,50544,26363,25483
10345254,10345252,TXFE7,129,9937,4,50544,26363,25483
10345517,10345513,TXFE7,128,9937,2,50546,26365,25484
10345767,10345754,TXFE7,128,9938,1,50547,26366,25485
10345792,10345780,TXFE7,128,9938,1,50548,26367,25486
10345804,10345795,TXFE7,128,9938,1,50549,26368,25487
10350054,10350051,TXFE7,128,9937,2,50551,26370,25488
10350217,10350212,TXFE7,128,9938,1,50552,26371,25489
10350267,10350255,TXFE7,128,9937,1,50553,26372,25490
10350379,10350368,TXFE7,128,9938,1,50554,26373,25491
10350417,10350408,TXFE7,128,9938,1,50555,26374,25492
10350492,10350491,TXFE7,128,9938,1,50556,26375,25493
10350517,10350515,TXFE7,128,9938,1,50557,26376,25494
10350542,10350540,TXFE7,128,9938,1,50558,26377,25495
10350567,10350556,TXFE7,128,9938,1,50559,26378,25496
10350592,10350580,TXFE7,128,9939,1,50560,26379,25497
10350604,10350601,TXFE7,128,9939,1,50561,26380,25498
10350629,10350618,TXFE7,128,9938,2,50563,26381,25499
10350742,10350733,TXFE7,128,9938,1,50564,26382,25500
10350742,10350736,TXFE7,128,9939,1,50565,26383,25501
10350767,10350765,TXFE7,128,9938,1,50566,26384,25502
10350779,10350776,TXFE7,128,9938,1,50567,26385,25503
10350804,10350795,TXFE7,128,9938,1,50568,26386,25504
10350829,10350821,TXFE7,128,9937,1,50569,26387,25505
10350892,10350880,TXFE7,128,9938,2,50571,26388,25506
10350979,10350970,TXFE7,128,9938,1,50572,26389,25507
10351029,10351022,TXFE7,128,9938,1,50573,26390,25508
10351129,10351128,TXFE7,128,9938,1,50574,26391,25509
10351192,10351180,TXFE7,128,9937,2,50576,26392,25510
10351717,10351714,TXFE7,128,9937,2,50578,26393,25511
10351767,10351765,TXFE7,128,9937,2,50580,26394,25512
10351779,10351775,TXFE7,128,9937,2,50582,26395,25513
10351779,10351776,TXFE7,128,9937,4,50586,26396,25514
10352279,10352274,TXFE7,128,9937,2,50588,26397,25515
10352604,10352604,TXFE7,128,9938,1,50589,26398,25516
10352679,10352678,TXFE7,128,9937,1,50590,26399,25517
10352817,10352814,TXFE7,128,9937,2,50592,26400,25518
10353379,10353376,TXFE7,128,9937,2,50594,26401,25519
10353579,10353575,TXFE7,128,9937,5,50599,26402,25520
10353942,10353938,TXFE7,128,9937,2,50601,26403,25521
10354367,10354359,TXFE7,128,9938,1,50602,26404,25522
10354479,10354477,TXFE7,128,9937,2,50604,26406,25523
10355017,10355014,TXFE7,128,9937,2,50606,26407,25524
10355567,10355555,TXFE7,128,9937,2,50608,26408,25525
10360067,10360057,TXFE7,128,9938,1,50609,26409,25526
10360154,10360143,TXFE7,128,9938,1,50610,26410,25527
10360154,10360144,TXFE7,128,9937,2,50612,26412,25528
10360679,10360676,TXFE7,128,9937,2,50614,26414,25529
10360892,10360882,TXFE7,128,9937,1,50615,26415,25530
10360992,10360982,TXFE7,128,9938,1,50616,26416,25531
10361004,10361003,TXFE7,128,9938,1,50617,26417,25532
10361029,10361027,TXFE7,128,9938,1,50618,26418,25533
10361054,10361045,TXFE7,128,9938,1,50619,26419,25534
10361067,10361064,TXFE7,128,9938,1,50620,26420,25535
10361092,10361091,TXFE7,128,9938,1,50621,26421,25536
10361117,10361114,TXFE7,128,9938,1,50622,26422,25537
10361192,10361189,TXFE7,128,9938,1,50623,26423,25538
10361229,10361223,TXFE7,128,9938,1,50624,26424,25539
10361242,10361240,TXFE7,128,9937,2,50626,26426,25540
10361329,10361317,TXFE7,128,9938,4,50630,26427,25543
10361342,10361329,TXFE7,128,9938,14,50644,26428,25550
10361342,10361333,TXFE7,128,9938,11,50655,26429,25559
10361392,10361383,TXFE7,128,9939,1,50656,26430,25560
10361417,10361416,TXFE7,128,9938,1,50657,26431,25561
10361779,10361776,TXFE7,128,9938,2,50659,26433,25562
10362017,10362007,TXFE7,128,9938,1,50660,26434,25563
10362192,10362180,TXFE7,128,9938,5,50665,26438,25564
10362192,10362189,TXFE7,128,9938,1,50666,26439,25565
10362279,10362267,TXFE7,128,9938,4,50670,26440,25566
10362292,10362286,TXFE7,129,9938,1,50672,26442,25567
10362292,10362286,TXFE7,129,9937,1,50672,26442,25567
10362329,10362317,TXFE7,128,9937,2,50674,26444,25568
10362467,10362460,TXFE7,128,9938,6,50680,26445,25571
10362479,10362474,TXFE7,128,9939,1,50681,26446,25572
10362667,10362665,TXFE7,128,9938,3,50684,26447,25573
10362679,10362669,TXFE7,128,9939,1,50685,26448,25574
10362879,10362877,TXFE7,128,9938,2,50687,26450,25575
10362967,10362955,TXFE7,128,9938,1,50688,26451,25576
10362992,10362983,TXFE7,128,9938,20,50708,26455,25577
10363017,10363011,TXFE7,128,9939,10,50718,26456,25586
10363042,10363031,TXFE7,128,9939,10,50728,26457,25594
10363067,10363057,TXFE7,128,9939,10,50738,26458,25601
10363279,10363273,TXFE7,128,9939,1,50739,26459,25602
10363429,10363420,TXFE7,128,9938,2,50741,26460,25603
10363467,10363456,TXFE7,128,9938,1,50742,26461,25604
10363579,10363575,TXFE7,128,9938,1,50743,26462,25605
10363704,10363695,TXFE7,128,9939,1,50744,26463,25606
10363754,10363748,TXFE7,128,9939,1,50745,26464,25607
10363767,10363763,TXFE7,128,9939,2,50747,26465,25608
10363779,10363779,TXFE7,128,9939,1,50748,26466,25609
10363867,10363863,TXFE7,128,9939,1,50749,26467,25610
10363967,10363957,TXFE7,128,9939,1,50750,26468,25611
10363967,10363958,TXFE7,128,9938,3,50753,26470,25612
10363992,10363980,TXFE7,128,9938,2,50755,26471,25613
10364004,10364004,TXFE7,128,9939,1,50756,26472,25614
10364054,10364046,TXFE7,128,9939,1,50757,26473,25615
10364104,10364104,TXFE7,128,9939,1,50758,26474,25616
10364179,10364175,TXFE7,128,9939,1,50759,26475,25617
10364179,10364175,TXFE7,128,9939,1,50760,26476,25618
10364192,10364189,TXFE7,128,9938,5,50765,26479,25619
10364267,10364261,TXFE7,128,9939,1,50766,26480,25620
10364354,10364346,TXFE7,128,9939,1,50767,26481,25621
10364442,10364432,TXFE7,128,9939,1,50768,26482,25622
10364454,10364454,TXFE7,128,9938,5,50773,26486,25623
10364529,10364517,TXFE7,128,9939,1,50774,26487,25624
10364542,10364538,TXFE7,128,9938,2,50776,26488,25625
10364604,10364599,TXFE7,128,9939,1,50777,26489,25626
10364604,10364599,TXFE7,128,9939,1,50778,26490,25627
10364704,10364695,TXFE7,128,9939,1,50779,26491,25628
10364804,10364797,TXFE7,128,9939,1,50780,26492,25629
10364929,10364928,TXFE7,128,9939,1,50781,26493,25630
10364979,10364975,TXFE7,128,9938,5,50786,26494,25631
10365017,10365009,TXFE7,128,9939,1,50787,26495,25632
10365092,10365080,TXFE7,128,9938,2,50789,26496,25633
10365142,10365137,TXFE7,128,9939,1,50790,26497,25634
10365217,10365215,TXFE7,128,9938,1,50791,26498,25635
10365267,10365255,TXFE7,128,9939,1,50792,26499,25636
10365354,10365342,TXFE7,128,9939,1,50793,26500,25637
10365479,10365468,TXFE7,128,9939,1,50794,26501,25638
10365592,10365583,TXFE7,128,9938,2,50796,26502,25639
10365592,10365591,TXFE7,128,9939,1,50797,26503,25640
10365629,10365621,TXFE7,128,9938,2,50799,26504,25641
10365704,10365699,TXFE7,128,9939,1,50800,26505,25642
10365779,10365775,TXFE7,128,9939,1,50801,26506,25643
10365904,10365902,TXFE7,128,9939,1,50802,26507,25644
10370092,10370087,TXFE7,128,9939,1,50803,26508,25645
10370092,10370088,TXFE7,128,9938,1,50804,26509,25646
10370192,10370181,TXFE7,128,9938,2,50806,26510,25647
10370267,10370257,TXFE7,128,9939,1,50807,26511,25648
10370292,10370280,TXFE7,128,9938,1,50808,26512,25649
10370392,10370380,TXFE7,128,9939,20,50828,26513,25660
10370529,10370520,TXFE7,128,9938,3,50831,26515,25661
10370567,10370563,TXFE7,128,9939,12,50843,26516,25673
10370579,10370567,TXFE7,128,9939,35,50878,26517,25692
10370654,10370652,TXFE7,129,9939,23,50918,26537,25693
10370654,10370652,TXFE7,129,9938,17,50918,26537,25693
10370667,10370655,TXFE7,128,9939,1,50919,26538,25694
10370667,10370656,TXFE7,128,9939,1,50920,26539,25695
10370667,10370658,TXFE7,128,9939,1,50921,26540,25696
10370667,10370666,TXFE7,128,9939,10,50931,26541,25699
10370717,10370715,TXFE7,128,9940,1,50932,26542,25700
10370729,10370721,TXFE7,128,9939,2,50934,26543,25701
10370729,10370724,TXFE7,128,9940,3,50937,26544,25702
10370742,10370735,TXFE7,128,9940,1,50938,26545,25703
10370754,10370746,TXFE7,128,9940,1,50939,26546,25704
10370767,10370766,TXFE7,128,9940,1,50940,26547,25705
10371017,10371014,TXFE7,128,9940,1,50941,26548,25706
10371054,10371049,TXFE7,128,9939,2,50943,26549,25707
10371067,10371066,TXFE7,128,9939,1,50944,26550,25708
10371267,10371263,TXFE7,128,9939,2,50946,26551,25709
10371392,10371390,TXFE7,128,9939,1,50947,26552,25710
10371479,10371470,TXFE7,128,9940,1,50948,26553,25711
10371542,10371530,TXFE7,128,9939,1,50949,26554,25712
10371567,10371565,TXFE7,128,9940,3,50952,26555,25713
10371829,10371819,TXFE7,128,9939,1,50953,26556,25714
10371829,10371820,TXFE7,128,9939,2,50955,26557,25715
10371842,10371836,TXFE7,128,9940,2,50957,26558,25716
10371854,10371845,TXFE7,128,9940,1,50958,26559,25717
10371892,10371881,TXFE7,128,9940,2,50960,26560,25719
10372179,10372173,TXFE7,128,9940,2,50962,26561,25720
10372292,10372290,TXFE7,128,9940,8,50970,26562,25725
10372367,10372362,TXFE7,128,9940,1,50971,26563,25726
10372367,10372365,TXFE7,128,9939,2,50973,26564,25727
10372392,10372391,TXFE7,128,9940,1,50974,26565,25728
10372429,10372427,TXFE7,128,9940,1,50975,26566,25729
10372492,10372488,TXFE7,128,9940,1,50976,26567,25730
10372504,10372503,TXFE7,128,9940,1,50977,26568,25731
10372517,10372514,TXFE7,128,9940,8,50985,26569,25736
10372629,10372621,TXFE7,128,9940,1,50986,26570,25737
10372854,10372853,TXFE7,128,9940,1,50987,26571,25738
10372904,10372900,TXFE7,128,9939,2,50989,26573,25739
10373167,10373155,TXFE7,128,9939,5,50994,26577,25740
10373292,10373290,TXFE7,128,9939,1,50995,26578,25741
10373442,10373433,TXFE7,128,9940,3,50998,26579,25742
10373454,10373442,TXFE7,128,9939,2,51000,26581,25743
10373467,10373457,TXFE7,128,9940,1,51001,26582,25744
10373492,10373491,TXFE7,128,9939,1,51002,26583,25745
10373579,10373571,TXFE7,128,9940,1,51003,26584,25746
10373804,10373803,TXFE7,128,9939,1,51006,26586,25748
10374004,10374002,TXFE7,128,9939,2,51008,26587,25749
10374554,10374544,TXFE7,128,9939,2,51010,26589,25750
10374567,10374565,TXFE7,128,9940,1,51011,26590,25751
10374592,10374591,TXFE7,128,9939,1,51012,26591,25752
10374642,10374637,TXFE7,128,9939,1,51013,26592,25753
10374667,10374657,TXFE7,128,9939,1,51014,26593,25754
10374667,10374665,TXFE7,128,9939,1,51015,26594,25755
10374717,10374709,TXFE7,128,9939,1,51016,26595,25756
10374954,10374952,TXFE7,128,9939,10,51026,26596,25757
10375104,10375101,TXFE7,128,9939,1,51027,26597,25758
10375104,10375101,TXFE7,128,9939,2,51029,26598,25759
10375242,10375238,TXFE7,128,9939,1,51030,26599,25760
10375304,10375304,TXFE7,128,9939,1,51031,26600,25761
10375429,10375425,TXFE7,128,9939,1,51032,26601,25762
10375442,10375430,TXFE7,128,9939,1,51033,26602,25763
10375654,10375644,TXFE7,128,9939,2,51035,26604,25764
10375704,10375702,TXFE7,128,9939,1,51036,26605,25765
10375717,10375716,TXFE7,128,9939,22,51058,26623,25766
10375729,10375721,TXFE7,128,9938,1,51059,26624,25767
10375767,10375761,TXFE7,128,9938,1,51060,26625,25768
10375804,10375802,TXFE7,128,9939,1,51061,26626,25769
10375954,10375947,TXFE7,128,9939,1,51062,26627,25770
10375967,10375965,TXFE7,128,9939,1,51063,26628,25771
10380192,10380182,TXFE7,128,9938,2,51065,26629,25772
10380467,10380458,TXFE7,128,9939,1,51066,26630,25773
10380729,10380724,TXFE7,128,9938,2,51068,26631,25774
10380742,10380736,TXFE7,128,9939,1,51069,26632,25775
10380742,10380737,TXFE7,128,9939,20,51089,26633,25780
10380754,10380742,TXFE7,128,9939,4,51093,26634,25784
10380754,10380742,TXFE7,128,9939,5,51098,26635,25787
10380767,10380765,TXFE7,128,9939,5,51103,26636,25788
10381254,10381242,TXFE7,128,9939,1,51104,26637,25789
10381279,10381279,TXFE7,128,9939,1,51105,26638,25790
10381292,10381284,TXFE7,128,9938,2,51107,26639,25791
10381304,10381304,TXFE7,128,9938,1,51108,26640,25792
10381579,10381579,TXFE7,128,9939,1,51109,26641,25793
10381729,10381721,TXFE7,128,9939,1,51110,26642,25794
10381829,10381823,TXFE7,128,9938,2,51112,26644,25795
10382379,10382372,TXFE7,128,9938,2,51114,26646,25796
10382929,10382925,TXFE7,128,9938,2,51116,26647,25797
10383179,10383177,TXFE7,128,9938,1,51117,26648,25798
10383204,10383197,TXFE7,128,9938,1,51118,26649,25799
10383467,10383464,TXFE7,128,9938,2,51120,26650,25800
10384042,10384036,TXFE7,128,9938,2,51122,26651,25801
10384054,10384045,TXFE7,128,9938,3,51125,26652,25802
10384379,10384377,TXFE7,128,9939,1,51126,26653,25803
10384579,10384567,TXFE7,128,9938,2,51128,26654,25804
10384904,10384903,TXFE7,128,9938,1,51129,26655,25805
10385054,10385052,TXFE7,128,9938,1,51130,26656,25806
10385104,10385103,TXFE7,128,9939,1,51131,26657,25807
10385117,10385106,TXFE7,128,9938,2,51133,26658,25808
10385142,10385138,TXFE7,128,9938,2,51135,26659,25809
10385204,10385193,TXFE7,128,9938,1,51136,26660,25810
10385679,10385671,TXFE7,128,9938,2,51138,26662,25811
10385704,10385695,TXFE7,128,9939,1,51139,26663,25812
10385792,10385783,TXFE7,128,9939,2,51141,26664,25814
10390054,10390051,TXFE7,128,9938,2,51143,26666,25815
10390192,10390187,TXFE7,128,9939,20,51163,26667,25825
10390204,10390192,TXFE7,128,9939,2,51165,26668,25826
10390204,10390192,TXFE7,128,9939,27,51192,26669,25837
10390204,10390192,TXFE7,128,9939,2,51194,26670,25839
10390217,10390207,TXFE7,128,9939,2,51196,26671,25840
10390229,10390228,TXFE7,128,9940,2,51198,26672,25841
10390242,10390229,TXFE7,128,9940,1,51199,26673,25842
10390242,10390229,TXFE7,128,9940,93,51292,26674,25904
10390242,10390230,TXFE7,128,9940,1,51293,26675,25905
10390242,10390237,TXFE7,129,9940,3,51305,26680,25906
10390242,10390237,TXFE7,129,9939,9,51305,26680,25906
10390242,10390238,TXFE7,128,9939,1,51306,26681,25907
10390254,10390253,TXFE7,128,9941,1,51307,26682,25908
10390267,10390258,TXFE7,128,9941,2,51309,26683,25909
10390267,10390259,TXFE7,128,9941,6,51315,26684,25912
10390267,10390259,TXFE7,128,9941,6,51321,26685,25914
10390279,10390273,TXFE7,128,9941,2,51323,26686,25916
10390329,10390322,TXFE7,128,9941,2,51325,26687,25917
10390342,10390330,TXFE7,128,9940,30,51355,26696,25918
10390354,10390342,TXFE7,128,9940,1,51356,26697,25919
10390379,10390371,TXFE7,128,9940,2,51358,26698,25920
10390442,10390429,TXFE7,128,9940,1,51359,26699,25921
10390479,10390470,TXFE7,128,9940,1,51360,26700,25922
10390642,10390634,TXFE7,128,9939,1,51361,26701,25923
10390754,10390748,TXFE7,128,9939,2,51363,26702,25924
10390879,10390875,TXFE7,128,9940,2,51365,26703,25925
10391067,10391054,TXFE7,128,9940,1,51366,26704,25926
10391204,10391201,TXFE7,128,9940,20,51386,26705,25937
10391317,10391307,TXFE7,128,9939,2,51388,26706,25938
10391354,10391354,TXFE7,128,9940,1,51389,26707,25939
10391467,10391460,TXFE7,128,9939,2,51391,26708,25940
10391717,10391706,TXFE7,128,9939,1,51392,26709,25941
10391754,10391750,TXFE7,128,9940,1,51393,26710,25942
10391854,10391848,TXFE7,128,9939,2,51395,26711,25943
10391979,10391967,TXFE7,128,9939,4,51399,26715,25944
10392067,10392060,TXFE7,128,9939,25,51424,26725,25945
10392079,10392067,TXFE7,128,9939,1,51425,26726,25946
10392092,10392079,TXFE7,128,9939,4,51429,26727,25948
10392104,10392092,TXFE7,128,9939,2,51431,26728,25949
10392392,10392387,TXFE7,128,9938,2,51433,26729,25950
10392492,10392487,TXFE7,128,9939,1,51434,26730,25951
10392929,10392927,TXFE7,128,9938,2,51436,26731,25952
10393317,10393304,TXFE7,128,9938,1,51437,26732,25953
10393492,10393490,TXFE7,128,9938,2,51439,26734,25954
10394029,10394029,TXFE7,128,9938,2,51441,26735,25955
10394367,10394360,TXFE7,128,9938,13,51454,26738,25956
10394492,10394482,TXFE7,128,9938,26,51480,26754,25957
10394579,10394573,TXFE7,128,9937,2,51482,26755,25958
10394617,10394608,TXFE7,128,9937,5,51487,26756,25959
10395142,10395132,TXFE7,128,9937,2,51489,26757,25960
10395442,10395437,TXFE7,128,9937,1,51490,26758,25961
10395442,10395441,TXFE7,128,9938,1,51491,26759,25962
10395692,10395690,TXFE7,128,9937,2,51493,26761,25963
10395767,10395766,TXFE7,128,9938,1,51494,26762,25964
10395792,10395787,TXFE7,128,9937,1,51495,26763,25965
10400042,10400029,TXFE7,128,9938,3,51498,26764,25968
10400054,10400047,TXFE7,128,9937,2,51500,26766,25969
10400092,10400084,TXFE7,128,9938,1,51501,26767,25970
10400104,10400095,TXFE7,128,9938,1,51502,26768,25971
10400242,10400231,TXFE7,128,9937,2,51504,26770,25972
10400329,10400324,TXFE7,128,9937,1,51505,26771,25973
10400342,10400333,TXFE7,128,9937,1,51506,26772,25974
10400429,10400417,TXFE7,128,9938,1,51507,26773,25975
10400529,10400517,TXFE7,128,9938,2,51509,26774,25977
10400629,10400619,TXFE7,128,9938,1,51510,26775,25978
10400717,10400708,TXFE7,128,9938,1,51511,26776,25979
10400779,10400773,TXFE7,128,9937,2,51513,26777,25980
10400942,10400936,TXFE7,128,9937,1,51514,26778,25981
10401217,10401215,TXFE7,128,9938,1,51515,26779,25982
10401292,10401281,TXFE7,128,9937,1,51516,26780,25983
10401317,10401316,TXFE7,128,9938,3,51519,26781,25985
10401342,10401330,TXFE7,128,9937,2,51521,26782,25986
10401379,10401375,TXFE7,128,9938,1,51522,26783,25987
10401767,10401756,TXFE7,128,9938,3,51525,26784,25988
10401817,10401811,TXFE7,128,9938,2,51527,26785,25989
10401879,10401871,TXFE7,128,9937,2,51529,26786,25990
10401954,10401944,TXFE7,128,9938,1,51530,26787,25991
10402154,10402145,TXFE7,128,9937,2,51532,26788,25992
10402204,10402200,TXFE7,128,9938,1,51533,26789,25993
10402442,10402435,TXFE7,128,9937,2,51535,26790,25994
10402504,10402499,TXFE7,128,9937,1,51536,26791,25995
10403017,10403011,TXFE7,128,9937,2,51538,26792,25996
10403204,10403204,TXFE7,128,9937,1,51539,26793,25997
10403279,10403270,TXFE7,128,9938,1,51540,26794,25998
10403392,10403384,TXFE7,128,9938,6,51546,26795,26003
10403504,10403493,TXFE7,128,9937,1,51547,26796,26004
10403554,10403553,TXFE7,128,9937,2,51549,26797,26005
10404092,10404081,TXFE7,128,9938,1,51550,26798,26006
10404104,10404094,TXFE7,128,9937,2,51552,26799,26007
10404192,10404180,TXFE7,128,9938,2,51554,26800,26008
10404642,10404632,TXFE7,128,9937,2,51556,26801,26009
10405004,10404996,TXFE7,128,9937,1,51557,26802,26010
10405204,10405192,TXFE7,128,9937,2,51559,26803,26011
10405742,10405732,TXFE7,128,9937,2,51561,26804,26012
10405754,10405751,TXFE7,128,9937,2,51563,26806,26013
10410079,10410070,TXFE7,128,9937,1,51564,26807,26014
10410279,10410275,TXFE7,128,9937,2,51566,26808,26015
10410592,10410589,TXFE7,128,9937,1,51567,26809,26016
10410604,10410600,TXFE7,128,9937,1,51568,26810,26017
10410667,10410661,TXFE7,128,9938,1,51569,26811,26018
10410704,10410693,TXFE7,128,9937,1,51570,26812,26019
10410742,10410733,TXFE7,128,9937,1,51571,26813,26020
10410842,10410836,TXFE7,128,9937,2,51573,26814,26021
10411079,10411071,TXFE7,128,9937,1,51574,26815,26022
10411104,10411101,TXFE7,128,9937,1,51575,26816,26023
10411117,10411112,TXFE7,128,9937,1,51576,26817,26024
10411179,10411172,TXFE7,128,9937,1,51577,26818,26025
10411379,10411377,TXFE7,128,9937,2,51579,26820,26026
10411917,10411915,TXFE7,128,9937,2,51581,26822,26027
10411992,10411989,TXFE7,128,9937,1,51582,26823,26028
10412479,10412479,TXFE7,128,9937,2,51584,26824,26029
10412867,10412860,TXFE7,128,9937,2,51586,26826,26030
10413017,10413016,TXFE7,128,9937,2,51588,26828,26031
10413192,10413189,TXFE7,128,9937,1,51589,26829,26032
10413579,10413578,TXFE7,128,9937,2,51591,26831,26033
10413904,10413902,TXFE7,128,9937,1,51592,26832,26034
10414117,10414115,TXFE7,128,9937,2,51594,26833,26035
10414667,10414660,TXFE7,128,9937,2,51596,26835,26036
10415229,10415217,TXFE7,128,9937,2,51598,26837,26037
10415567,10415563,TXFE7,128,9938,1,51599,26838,26038
10415767,10415756,TXFE7,128,9937,2,51601,26840,26039
10420304,10420300,TXFE7,128,9937,2,51603,26842,26040
10420654,10420645,TXFE7,128,9938,3,51606,26843,26041
10420679,10420674,TXFE7,128,9938,4,51610,26844,26044
10420679,10420675,TXFE7,128,9938,1,51611,26845,26045
10420692,10420686,TXFE7,128,9938,2,51613,26846,26047
10420692,10420686,TXFE7,128,9938,1,51614,26847,26048
10420692,10420690,TXFE7,128,9938,1,51615,26848,26049
10420692,10420691,TXFE7,128,9938,1,51616,26849,26050
10420704,10420701,TXFE7,128,9938,3,51619,26850,26051
10420704,10420702,TXFE7,128,9938,1,51620,26851,26052
10420704,10420703,TXFE7,128,9938,3,51623,26852,26055
10420717,10420706,TXFE7,128,9938,1,51624,26853,26056
10420842,10420838,TXFE7,128,9937,2,51626,26855,26057
10420854,10420852,TXFE7,128,9938,20,51646,26856,26071
10420904,10420897,TXFE7,128,9938,2,51648,26857,26073
10421017,10421009,TXFE7,128,9938,1,51649,26858,26074
10421367,10421360,TXFE7,128,9937,1,51650,26859,26075
10421404,10421399,TXFE7,128,9937,2,51652,26861,26076
10421579,10421579,TXFE7,128,9938,1,51653,26862,26077
10421629,10421623,TXFE7,128,9938,1,51654,26863,26078
10421842,10421834,TXFE7,128,9938,1,51655,26864,26079
10421942,10421937,TXFE7,128,9938,2,51657,26865,26080
10421979,10421971,TXFE7,128,9938,1,51658,26866,26081
10421979,10421979,TXFE7,128,9938,14,51672,26867,26082
10422004,10422001,TXFE7,128,9938,8,51680,26868,26084
10422317,10422312,TXFE7,128,9938,1,51681,26869,26085
10422504,10422499,TXFE7,128,9938,2,51683,26870,26086
10422517,10422507,TXFE7,128,9939,1,51684,26871,26087
10422642,10422634,TXFE7,128,9938,1,51685,26872,26088
10422767,10422754,TXFE7,128,9938,4,51689,26873,26089
10422829,10422818,TXFE7,128,9938,2,51691,26874,26090
10423054,10423042,TXFE7,128,9938,2,51693,26876,26091
10423379,10423369,TXFE7,128,9938,1,51694,26877,26092
10423454,10423443,TXFE7,128,9938,2,51696,26878,26093
10423479,10423470,TXFE7,128,9938,20,51716,26883,26094
10423604,10423598,TXFE7,128,9937,2,51718,26885,26095
10424254,10424244,TXFE7,128,9937,2,51720,26886,26096
10424254,10424250,TXFE7,128,9938,1,51721,26887,26097
10424629,10424628,TXFE7,128,9938,1,51722,26888,26098
10424704,10424699,TXFE7,128,9937,2,51724,26890,26099
10424717,10424709,TXFE7,128,9938,2,51726,26891,26100
10424879,10424878,TXFE7,128,9938,4,51730,26892,26103
10425104,10425100,TXFE7,128,9938,2,51732,26893,26104
10425242,10425240,TXFE7,128,9938,2,51734,26894,26105
10425804,10425801,TXFE7,128,9938,2,51736,26896,26106
10425917,10425906,TXFE7,128,9938,1,51737,26897,26107
10425967,10425957,TXFE7,128,9938,1,51738,26898,26108
10430079,10430072,TXFE7,128,9939,1,51739,26899,26109
10430104,10430094,TXFE7,128,9938,1,51740,26900,26110
10430342,10430340,TXFE7,128,9938,2,51742,26901,26111
10430604,10430602,TXFE7,128,9938,2,51744,26903,26112
10430879,10430878,TXFE7,128,9939,1,51745,26904,26113
10430904,10430903,TXFE7,128,9938,2,51747,26906,26114
10430992,10430981,TXFE7,128,9939,20,51767,26907,26124
10431154,10431147,TXFE7,129,9939,17,51787,26908,26137
10431154,10431147,TXFE7,129,9940,3,51787,26908,26137
10431167,10431161,TXFE7,128,9940,2,51789,26909,26138
10431217,10431213,TXFE7,128,9939,1,51790,26910,26139
10431442,10431441,TXFE7,128,9938,2,51792,26911,26140
10432004,10432001,TXFE7,128,9938,1,51793,26912,26141
10432017,10432013,TXFE7,128,9938,2,51795,26913,26142
10432379,10432372,TXFE7,128,9938,5,51800,26914,26143
10432467,10432466,TXFE7,128,9939,1,51801,26915,26144
10432542,10432541,TXFE7,128,9938,2,51803,26917,26145
10433017,10433005,TXFE7,128,9939,20,51823,26918,26153
10433092,10433082,TXFE7,128,9938,2,51825,26919,26154
10433142,10433133,TXFE7,128,9939,3,51828,26920,26155
10433167,10433156,TXFE7,128,9940,3,51831,26921,26156
10433167,10433159,TXFE7,128,9940,2,51833,26922,26158
10433167,10433162,TXFE7,128,9940,2,51835,26923,26160
10433204,10433197,TXFE7,128,9940,4,51839,26924,26163
10433204,10433197,TXFE7,128,9940,2,51841,26925,26165
10433204,10433197,TXFE7,128,9940,4,51845,26926,26167
10433204,10433197,TXFE7,128,9940,4,51849,26927,26171
10433204,10433197,TXFE7,128,9940,6,51855,26928,26173
10433204,10433197,TXFE7,128,9940,3,51858,26929,26176
10433204,10433197,TXFE7,128,9940,2,51860,26930,26178
10433204,10433197,TXFE7,128,9940,6,51866,26931,26181
10433204,10433197,TXFE7,128,9940,8,51874,26932,26188
10433204,10433198,TXFE7,128,9940,6,51880,26933,26194
10433217,10433204,TXFE7,128,9940,2,51882,26934,26196
10433217,10433204,TXFE7,128,9940,2,51884,26935,26197
10433217,10433207,TXFE7,128,9940,2,51886,26936,26199
10433242,10433229,TXFE7,128,9940,1,51887,26937,26200
10433292,10433284,TXFE7,128,9940,1,51888,26938,26201
10433629,10433624,TXFE7,128,9939,2,51890,26939,26202
10434192,10434185,TXFE7,128,9939,2,51892,26940,26203
10434304,10434304,TXFE7,128,9940,2,51894,26941,26204
10434517,10434506,TXFE7,128,9940,1,51895,26942,26205
10434729,10434723,TXFE7,128,9939,2,51897,26943,26206
10434742,10434736,TXFE7,128,9940,1,51898,26944,26207
10434854,10434844,TXFE7,128,9940,1,51899,26945,26208
10435179,10435171,TXFE7,128,9940,5,51904,26946,26210
10435204,10435201,TXFE7,128,9940,1,51905,26947,26211
10435292,10435284,TXFE7,128,9939,2,51907,26948,26212
10435854,10435842,TXFE7,128,9939,2,51909,26949,26213
10435954,10435951,TXFE7,128,9939,1,51910,26950,26214
10440079,10440074,TXFE7,128,9939,1,51911,26951,26215
10440229,10440227,TXFE7,128,9939,5,51916,26952,26216
10440404,10440403,TXFE7,128,9939,2,51918,26954,26217
10440554,10440545,TXFE7,128,9939,1,51919,26955,26218
10440917,10440905,TXFE7,128,9940,5,51924,26956,26219
10440917,10440905,TXFE7,128,9940,15,51939,26957,26233
10440929,10440917,TXFE7,128,9940,13,51952,26958,26243
10440929,10440922,TXFE7,128,9941,5,51957,26959,26244
10440942,10440939,TXFE7,128,9941,1,51958,26960,26245
10440954,10440943,TXFE7,128,9940,2,51960,26961,26246
10440979,10440967,TXFE7,128,9940,1,51961,26962,26247
10440979,10440972,TXFE7,128,9940,1,51962,26963,26248
10441004,10441002,TXFE7,128,9941,2,51964,26964,26249
10441042,10441035,TXFE7,128,9940,1,51965,26965,26250
10441042,10441040,TXFE7,128,9940,1,51966,26966,26251
10441179,10441172,TXFE7,128,9940,1,51967,26967,26252
10441179,10441177,TXFE7,128,9940,1,51968,26968,26253
10441192,10441190,TXFE7,128,9941,1,51969,26969,26254
10441479,10441477,TXFE7,128,9941,1,51970,26970,26255
10441492,10441485,TXFE7,128,9940,2,51972,26971,26256
10441817,10441814,TXFE7,128,9940,1,51973,26972,26257
10441829,10441822,TXFE7,128,9940,1,51974,26973,26258
10441854,10441844,TXFE7,128,9940,3,51977,26974,26259
10441867,10441867,TXFE7,128,9940,1,51978,26975,26260
10441929,10441919,TXFE7,128,9940,1,51979,26976,26261
10442042,10442035,TXFE7,128,9940,2,51981,26977,26262
10442054,10442044,TXFE7,128,9940,1,51982,26978,26263
10442054,10442045,TXFE7,128,9940,1,51983,26979,26264
10442067,10442058,TXFE7,128,9940,1,51984,26980,26265
10442104,10442099,TXFE7,128,9940,20,52004,26986,26266
10442117,10442104,TXFE7,128,9940,2,52006,26987,26267
10442117,10442104,TXFE7,128,9940,1,52007,26988,26268
10442117,10442109,TXFE7,128,9940,1,52008,26989,26269
10442117,10442109,TXFE7,128,9940,1,52009,26990,26270
10442117,10442112,TXFE7,128,9940,5,52014,26991,26271
10442129,10442117,TXFE7,128,9940,7,52021,26994,26272
10442129,10442129,TXFE7,128,9940,1,52022,26995,26273
10442142,10442141,TXFE7,128,9940,2,52024,26996,26275
10442167,10442157,TXFE7,128,9940,1,52025,26997,26276
10442179,10442167,TXFE7,128,9940,5,52030,26998,26277
10442254,10442250,TXFE7,128,9940,1,52031,26999,26278
10442592,10442586,TXFE7,128,9939,2,52033,27000,26279
10442804,10442795,TXFE7,128,9939,1,52034,27001,26280
10442842,10442834,TXFE7,128,9940,2,52036,27002,26281
10442892,10442883,TXFE7,128,9940,1,52037,27003,26282
10443129,10443129,TXFE7,128,9939,2,52039,27004,26283
10443342,10443334,TXFE7,128,9939,5,52044,27006,26284
10443454,10443448,TXFE7,128,9939,20,52064,27014,26285
10443542,10443530,TXFE7,128,9940,2,52066,27015,26287
10443542,10443534,TXFE7,128,9940,2,52068,27016,26288
10443542,10443537,TXFE7,128,9940,2,52070,27017,26289
10443542,10443539,TXFE7,128,9940,2,52072,27018,26291
10443542,10443540,TXFE7,128,9940,4,52076,27019,26292
10443542,10443540,TXFE7,128,9940,2,52078,27020,26293
10443554,10443542,TXFE7,128,9940,1,52079,27021,26294
10443554,10443542,TXFE7,128,9940,2,52081,27022,26296
10443554,10443544,TXFE7,128,9940,3,52084,27023,26297
10443567,10443561,TXFE7,128,9940,3,52087,27024,26298
10443567,10443562,TXFE7,128,9940,2,52089,27025,26299
10443567,10443563,TXFE7,128,9940,2,52091,27026,26300
10443567,10443563,TXFE7,128,9940,2,52093,27027,26301
10443579,10443567,TXFE7,128,9940,2,52095,27028,26302
10443579,10443569,TXFE7,128,9940,4,52099,27029,26303
10443579,10443571,TXFE7,128,9940,3,52102,27030,26304
10443592,10443589,TXFE7,128,9940,1,52103,27031,26305
10443592,10443591,TXFE7,128,9940,2,52105,27032,26306
10443604,10443592,TXFE7,128,9940,7,52112,27033,26307
10443604,10443593,TXFE7,128,9940,4,52116,27034,26308
10443604,10443594,TXFE7,128,9940,4,52120,27035,26309
10443604,10443599,TXFE7,128,9940,6,52126,27036,26315
10443617,10443604,TXFE7,128,9940,2,52128,27037,26316
10443617,10443604,TXFE7,128,9940,10,52138,27038,26322
10443654,10443644,TXFE7,128,9940,1,52139,27039,26323
10443692,10443687,TXFE7,129,9940,1,52141,27041,26324
10443692,10443687,TXFE7,129,9939,1,52141,27041,26324
10443817,10443817,TXFE7,128,9940,7,52148,27042,26325
10443829,10443821,TXFE7,128,9940,2,52150,27044,26326
10443954,10443942,TXFE7,128,9940,1,52151,27045,26327
10443954,10443942,TXFE7,128,9940,2,52153,27046,26328
10444029,10444023,TXFE7,128,9940,2,52155,27047,26329
10444179,10444178,TXFE7,128,9940,1,52156,27048,26330
10444179,10444179,TXFE7,128,9940,1,52157,27049,26331
10444204,10444194,TXFE7,128,9940,7,52164,27050,26334
10444242,10444235,TXFE7,128,9939,2,52166,27051,26335
10444267,10444260,TXFE7,128,9940,1,52167,27052,26336
10444442,10444436,TXFE7,128,9940,1,52168,27053,26337
10444604,10444601,TXFE7,128,9939,5,52173,27058,26338
10444804,10444796,TXFE7,128,9939,2,52175,27060,26339
10445254,10445253,TXFE7,128,9940,3,52178,27061,26340
10445342,10445329,TXFE7,128,9939,2,52180,27062,26341
10445617,10445610,TXFE7,128,9940,1,52181,27063,26342
10445704,10445693,TXFE7,128,9940,1,52182,27064,26343
10445879,10445867,TXFE7,128,9939,2,52184,27065,26344
10450429,10450428,TXFE7,128,9939,2,52186,27066,26345
10450492,10450489,TXFE7,128,9940,1,52187,27067,26346
10450904,10450904,TXFE7,128,9940,30,52217,27068,26355
10450917,10450916,TXFE7,128,9940,1,52218,27069,26356
10450967,10450956,TXFE7,128,9940,1,52219,27070,26357
10450967,10450958,TXFE7,128,9940,1,52220,27071,26358
10450979,10450967,TXFE7,128,9939,2,52222,27072,26359
10450992,10450983,TXFE7,128,9940,1,52223,27073,26360
10450992,10450985,TXFE7,128,9940,1,52224,27074,26361
10450992,10450987,TXFE7,128,9940,1,52225,27075,26362
10450992,10450989,TXFE7,128,9940,1,52226,27076,26363
10450992,10450991,TXFE7,128,9940,1,52227,27077,26364
10451192,10451186,TXFE7,128,9939,2,52229,27078,26365
10451229,10451218,TXFE7,128,9940,4,52233,27079,26368
10451442,10451436,TXFE7,128,9940,1,52234,27080,26369
10451517,10451507,TXFE7,128,9940,2,52236,27081,26370
10451592,10451591,TXFE7,128,9940,1,52237,27082,26371
10451704,10451696,TXFE7,128,9940,2,52239,27083,26372
10451892,10451889,TXFE7,128,9940,1,52240,27084,26373
10452067,10452055,TXFE7,128,9940,1,52241,27085,26374
10452079,10452070,TXFE7,128,9940,2,52243,27086,26375
10452179,10452176,TXFE7,128,9940,2,52245,27087,26376
10452279,10452269,TXFE7,128,9940,1,52246,27088,26377
10452317,10452315,TXFE7,128,9940,1,52247,27089,26378
10452479,10452476,TXFE7,128,9940,2,52249,27090,26379
10452617,10452608,TXFE7,128,9940,2,52251,27091,26380
10452629,10452617,TXFE7,128,9940,42,52293,27099,26381
10452742,10452730,TXFE7,128,9940,1,52294,27100,26382
10452904,10452893,TXFE7,128,9939,2,52296,27101,26383
10453029,10453018,TXFE7,128,9939,1,52297,27102,26384
10453079,10453075,TXFE7,128,9940,5,52302,27103,26387
10453179,10453169,TXFE7,128,9939,2,52304,27104,26388
10453717,10453711,TXFE7,128,9939,2,52306,27105,26389
10454067,10454061,TXFE7,128,9939,2,52308,27106,26390
10454067,10454066,TXFE7,128,9939,1,52309,27107,26391
10454279,10454270,TXFE7,128,9939,2,52311,27109,26392
10454354,10454354,TXFE7,128,9939,14,52325,27120,26393
10454442,10454440,TXFE7,128,9939,14,52339,27123,26394
10454817,10454810,TXFE7,128,9939,2,52341,27124,26395
10455354,10455347,TXFE7,128,9940,1,52342,27125,26396
10455354,10455351,TXFE7,128,9939,2,52344,27126,26397
10455704,10455702,TXFE7,128,9939,1,52345,27127,26398
10455917,10455912,TXFE7,128,9939,2,52347,27128,26399
10460429,10460427,TXFE7,128,9939,1,52348,27129,26400
10460454,10460450,TXFE7,128,9939,2,52350,27130,26401
10460467,10460463,TXFE7,128,9939,1,52351,27131,26402
10460504,10460497,TXFE7,128,9940,30,52381,27132,26422
10460529,10460517,TXFE7,128,9940,1,52382,27133,26423
10460529,10460520,TXFE7,128,9940,1,52383,27134,26424
10460529,10460522,TXFE7,128,9940,1,52384,27135,26425
10460529,10460525,TXFE7,128,9941,1,52385,27136,26426
10460529,10460527,TXFE7,128,9941,1,52386,27137,26427
10460542,10460530,TXFE7,128,9941,1,52387,27138,26428
10460542,10460539,TXFE7,128,9941,1,52388,27139,26429
10460554,10460544,TXFE7,128,9941,2,52390,27140,26430
10460579,10460569,TXFE7,128,9940,1,52391,27141,26431
10461017,10461012,TXFE7,128,9939,2,52393,27142,26432
10461042,10461029,TXFE7,128,9940,1,52394,27143,26433
10461054,10461054,TXFE7,128,9940,1,52395,27144,26434
10461192,10461190,TXFE7,128,9941,1,52396,27145,26435
10461242,10461230,TXFE7,128,9940,1,52397,27146,26436
10461404,10461400,TXFE7,128,9940,2,52399,27147,26437
10461554,10461551,TXFE7,128,9940,2,52401,27148,26438
10461554,10461553,TXFE7,128,9941,1,52402,27149,26439
10461779,10461768,TXFE7,128,9940,1,52403,27150,26440
10461792,10461788,TXFE7,128,9941,5,52408,27151,26441
10461804,10461793,TXFE7,128,9941,2,52410,27152,26442
10461804,10461800,TXFE7,128,9941,5,52415,27153,26443
10461817,10461811,TXFE7,128,9941,1,52416,27154,26444
10461842,10461840,TXFE7,128,9941,1,52417,27155,26445
10462067,10462060,TXFE7,128,9941,1,52418,27156,26446
10462104,10462099,TXFE7,128,9941,1,52419,27157,26447
10462117,10462114,TXFE7,128,9940,2,52421,27158,26448
10462142,10462138,TXFE7,128,9940,1,52422,27159,26449
10462392,10462388,TXFE7,128,9940,1,52423,27160,26450
10462592,10462583,TXFE7,128,9940,1,52424,27161,26451
10462654,10462654,TXFE7,128,9940,2,52426,27162,26452
10463017,10463015,TXFE7,128,9940,1,52427,27163,26453
10463217,10463215,TXFE7,128,9940,2,52429,27164,26454
10463304,10463292,TXFE7,128,9940,10,52439,27170,26455
10463592,10463586,TXFE7,128,9941,1,52440,27171,26456
10463592,10463586,TXFE7,128,9941,8,52448,27172,26457
10463592,10463586,TXFE7,128,9941,1,52449,27173,26458
10463592,10463586,TXFE7,128,9941,1,52450,27174,26459
10463592,10463586,TXFE7,128,9941,1,52451,27175,26460
10463592,10463586,TXFE7,128,9941,1,52452,27176,26461
10463592,10463586,TXFE7,128,9941,1,52453,27177,26462
10463592,10463586,TXFE7,128,9941,1,52454,27178,26463
10463592,10463586,TXFE7,128,9941,2,52456,27179,26464
10463592,10463586,TXFE7,128,9941,1,52457,27180,26465
10463592,10463586,TXFE7,128,9941,1,52458,27181,26466
10463592,10463586,TXFE7,128,9941,62,52520,27182,26481
10463592,10463586,TXFE7,128,9941,2,52522,27183,26482
10463592,10463589,TXFE7,128,9941,1,52523,27184,26483
10463592,10463589,TXFE7,128,9941,1,52524,27185,26484
10463592,10463589,TXFE7,128,9941,4,52528,27186,26485
10463592,10463590,TXFE7,128,9941,5,52533,27187,26486
10463604,10463592,TXFE7,128,9941,2,52535,27188,26487
10463604,10463592,TXFE7,128,9941,10,52545,27189,26491
10463604,10463592,TXFE7,128,9941,8,52553,27190,26492
10463604,10463592,TXFE7,128,9941,16,52569,27191,26497
10463604,10463592,TXFE7,128,9941,2,52571,27192,26498
10463604,10463592,TXFE7,128,9941,1,52572,27193,26499
10463604,10463592,TXFE7,128,9941,2,52574,27194,26500
10463604,10463592,TXFE7,128,9941,2,52576,27195,26501
10463604,10463592,TXFE7,128,9941,1,52577,27196,26502
10463604,10463592,TXFE7,128,9941,1,52578,27197,26503
10463604,10463592,TXFE7,128,9941,1,52579,27198,26504
10463604,10463592,TXFE7,128,9941,6,52585,27199,26507
10463604,10463592,TXFE7,128,9941,12,52597,27200,26510
10463604,10463592,TXFE7,128,9941,4,52601,27201,26513
10463604,10463592,TXFE7,128,9941,10,52611,27202,26518
10463604,10463592,TXFE7,128,9941,28,52639,27203,26537
10463604,10463594,TXFE7,128,9942,2,52641,27204,26539
10463604,10463597,TXFE7,128,9942,2,52643,27205,26541
10463604,10463598,TXFE7,128,9942,4,52647,27206,26544
10463604,10463600,TXFE7,128,9942,1,52648,27207,26545
10463617,10463604,TXFE7,128,9942,1,52649,27208,26546
10463617,10463604,TXFE7,128,9942,8,52657,27209,26553
10463617,10463604,TXFE7,128,9942,3,52660,27210,26556
10463617,10463605,TXFE7,128,9942,4,52664,27211,26559
10463617,10463605,TXFE7,128,9942,10,52674,27212,26560
10463617,10463605,TXFE7,128,9942,1,52675,27213,26561
10463617,10463605,TXFE7,128,9942,8,52683,27214,26563
10463617,10463608,TXFE7,128,9942,1,52684,27215,26564
10463617,10463613,TXFE7,128,9942,3,52687,27216,26565
10463617,10463613,TXFE7,128,9942,2,52689,27217,26566
10463617,10463614,TXFE7,128,9942,2,52691,27218,26567
10463617,10463615,TXFE7,128,9942,2,52693,27219,26568
10463629,10463617,TXFE7,128,9942,1,52694,27220,26569
10463629,10463617,TXFE7,128,9942,2,52696,27221,26571
10463629,10463617,TXFE7,128,9942,2,52698,27222,26573
10463629,10463617,TXFE7,128,9942,7,52705,27223,26578
10463629,10463617,TXFE7,128,9942,7,52712,27224,26582
10463629,10463618,TXFE7,128,9942,1,52713,27225,26583
10463629,10463619,TXFE7,128,9942,1,52714,27226,26584
10463629,10463620,TXFE7,128,9942,1,52715,27227,26585
10463629,10463621,TXFE7,128,9942,2,52717,27228,26586
10463629,10463626,TXFE7,128,9942,1,52718,27229,26587
10463629,10463629,TXFE7,128,9942,1,52719,27230,26588
10463642,10463630,TXFE7,128,9942,7,52726,27231,26591
10463642,10463630,TXFE7,128,9942,100,52826,27232,26619
10463642,10463630,TXFE7,128,9942,2,52828,27233,26620
10463642,10463630,TXFE7,128,9943,7,52835,27234,26627
10463642,10463637,TXFE7,128,9943,9,52844,27235,26628
10463642,10463638,TXFE7,128,9943,1,52845,27236,26629
10463654,10463642,TXFE7,128,9943,7,52852,27237,26630
10463654,10463645,TXFE7,128,9943,2,52854,27238,26631
10463654,10463646,TXFE7,128,9943,10,52864,27239,26640
10463654,10463647,TXFE7,128,9943,2,52866,27240,26642
10463654,10463648,TXFE7,128,9943,1,52867,27241,26643
10463654,10463651,TXFE7,128,9943,8,52875,27242,26644
10463654,10463653,TXFE7,128,9943,2,52877,27243,26645
10463667,10463655,TXFE7,128,9943,7,52884,27244,26647
10463667,10463660,TXFE7,128,9943,1,52885,27245,26648
10463667,10463661,TXFE7,128,9943,2,52887,27246,26649
10463667,10463667,TXFE7,128,9943,1,52888,27247,26650
10463679,10463671,TXFE7,128,9943,1,52889,27248,26651
10463679,10463672,TXFE7,128,9943,3,52892,27249,26652
10463679,10463672,TXFE7,128,9943,4,52896,27250,26653
10463679,10463677,TXFE7,128,9943,8,52904,27251,26660
10463704,10463695,TXFE7,128,9943,1,52905,27252,26661
10463704,10463701,TXFE7,128,9943,1,52906,27253,26662
10463704,10463703,TXFE7,128,9943,1,52907,27254,26663
10463717,10463709,TXFE7,128,9942,6,52913,27257,26664
10463717,10463709,TXFE7,128,9942,4,52917,27260,26665
10463717,10463709,TXFE7,128,9942,7,52924,27261,26666
10463717,10463709,TXFE7,128,9942,3,52927,27262,26667
10463717,10463709,TXFE7,128,9942,2,52929,27263,26668
10463717,10463709,TXFE7,128,9942,1,52930,27264,26669
10463717,10463711,TXFE7,128,9943,1,52931,27265,26670
10463717,10463712,TXFE7,128,9943,9,52940,27266,26679
10463729,10463717,TXFE7,128,9942,10,52950,27269,26680
10463729,10463717,TXFE7,128,9942,2,52952,27271,26681
10463729,10463720,TXFE7,128,9942,8,52960,27272,26683
10463729,10463727,TXFE7,128,9942,3,52963,27273,26685
10463742,10463732,TXFE7,128,9942,1,52964,27274,26686
10463754,10463747,TXFE7,128,9942,4,52968,27275,26688
10463754,10463750,TXFE7,128,9942,1,52969,27276,26689
10463754,10463754,TXFE7,128,9941,2,52971,27277,26690
10463767,10463766,TXFE7,128,9942,1,52972,27278,26691
10463792,10463782,TXFE7,128,9941,1,52973,27279,26692
10463792,10463783,TXFE7,128,9942,1,52974,27280,26693
10463792,10463786,TXFE7,128,9942,2,52976,27281,26694
10463804,10463797,TXFE7,128,9942,1,52977,27282,26695
10463804,10463798,TXFE7,128,9941,1,52978,27283,26696
10463817,10463809,TXFE7,128,9942,1,52979,27284,26697
10463817,10463816,TXFE7,128,9942,3,52982,27285,26699
10463842,10463841,TXFE7,128,9942,1,52983,27286,26700
10463854,10463846,TXFE7,128,9942,1,52984,27287,26701
10463867,10463856,TXFE7,128,9942,1,52985,27288,26702
10463892,10463881,TXFE7,128,9942,2,52987,27289,26703
10463892,10463891,TXFE7,128,9942,1,52988,27290,26704
10463904,10463901,TXFE7,128,9942,1,52989,27291,26705
10464042,10464037,TXFE7,128,9943,1,52990,27292,26706
10464042,10464038,TXFE7,128,9943,2,52992,27293,26708
10464042,10464040,TXFE7,128,9943,1,52993,27294,26709
10464042,10464041,TXFE7,128,9943,2,52995,27295,26711
10464054,10464044,TXFE7,128,9943,1,52996,27296,26712
10464054,10464044,TXFE7,128,9943,2,52998,27297,26714
10464054,10464045,TXFE7,128,9943,1,52999,27298,26715
10464054,10464046,TXFE7,128,9943,1,53000,27299,26716
10464054,10464050,TXFE7,128,9943,1,53001,27300,26717
10464054,10464052,TXFE7,128,9943,1,53002,27301,26718
10464067,10464060,TXFE7,128,9943,1,53003,27302,26719
10464067,10464065,TXFE7,128,9943,10,53013,27303,26725
10464079,10464079,TXFE7,128,9942,2,53015,27305,26726
10464154,10464142,TXFE7,128,9942,7,53022,27306,26727
10464154,10464142,TXFE7,128,9942,2,53024,27308,26728
10464154,10464147,TXFE7,128,9942,4,53028,27312,26729
10464154,10464147,TXFE7,128,9942,6,53034,27317,26730
10464179,10464174,TXFE7,128,9942,1,53035,27318,26731
10464217,10464205,TXFE7,128,9942,1,53036,27319,26732
10464267,10464265,TXFE7,128,9942,1,53037,27320,26733
10464304,10464293,TXFE7,128,9941,2,53039,27321,26734
10464429,10464419,TXFE7,128,9942,4,53043,27322,26737
10464492,10464490,TXFE7,128,9941,4,53047,27324,26738
10464542,10464531,TXFE7,128,9942,1,53048,27325,26739
10464579,10464570,TXFE7,128,9942,1,53049,27326,26740
10464692,10464687,TXFE7,128,9942,2,53051,27327,26741
10464829,10464824,TXFE7,128,9941,1,53052,27328,26742
10464854,10464853,TXFE7,128,9941,2,53054,27330,26743
10465117,10465108,TXFE7,128,9942,10,53064,27331,26748
10465254,10465242,TXFE7,128,9941,1,53065,27332,26749
10465267,10465259,TXFE7,128,9941,1,53066,27333,26750
10465267,10465259,TXFE7,128,9941,1,53067,27334,26751
10465267,10465259,TXFE7,128,9941,7,53074,27336,26752
10465267,10465259,TXFE7,128,9941,1,53075,27337,26753
10465267,10465259,TXFE7,128,9941,1,53076,27338,26754
10465267,10465259,TXFE7,128,9941,1,53077,27339,26755
10465267,10465260,TXFE7,128,9941,21,53098,27352,26756
10465279,10465268,TXFE7,128,9941,7,53105,27353,26760
10465292,10465284,TXFE7,128,9941,5,53110,27354,26762
10465404,10465393,TXFE7,128,9940,2,53112,27356,26763
10465429,10465425,TXFE7,128,9941,2,53114,27357,26765
10465429,10465427,TXFE7,128,9941,2,53116,27358,26766
10465617,10465609,TXFE7,128,9942,2,53118,27359,26767
10465817,10465810,TXFE7,128,9942,1,53119,27360,26768
10465929,10465924,TXFE7,128,9942,1,53120,27361,26769
10465954,10465954,TXFE7,128,9941,2,53122,27362,26770
10470067,10470056,TXFE7,128,9942,16,53138,27363,26778
10470079,10470074,TXFE7,128,9942,10,53148,27364,26784
10470092,10470084,TXFE7,128,9942,5,53153,27365,26789
10470104,10470092,TXFE7,128,9942,1,53154,27366,26790
10470104,10470097,TXFE7,128,9942,5,53159,27367,26795
10470204,10470192,TXFE7,128,9942,4,53163,27368,26796
10470204,10470200,TXFE7,128,9941,1,53164,27369,26797
10470204,10470203,TXFE7,128,9942,1,53165,27370,26798
10470292,10470281,TXFE7,129,9942,16,53195,27371,26816
10470292,10470281,TXFE7,129,9943,14,53195,27371,26816
10470292,10470282,TXFE7,128,9942,1,53196,27372,26817
10470292,10470288,TXFE7,128,9943,1,53197,27373,26818
10470292,10470290,TXFE7,128,9943,1,53198,27374,26819
10470304,10470292,TXFE7,128,9943,1,53199,27375,26820
10470304,10470296,TXFE7,128,9943,1,53200,27376,26821
10470317,10470310,TXFE7,128,9943,1,53201,27377,26822
10470317,10470313,TXFE7,128,9943,1,53202,27378,26823
10470329,10470317,TXFE7,128,9943,1,53203,27379,26824
10470354,10470345,TXFE7,128,9943,2,53205,27380,26825
10470404,10470395,TXFE7,128,9942,1,53206,27381,26826
10470442,10470433,TXFE7,128,9942,4,53210,27383,26827
10470504,10470495,TXFE7,128,9941,2,53212,27384,26828
10470567,10470563,TXFE7,128,9941,6,53218,27387,26829
10470654,10470647,TXFE7,128,9942,1,53219,27388,26830
10470654,10470651,TXFE7,128,9942,1,53220,27389,26831
10470892,10470891,TXFE7,128,9942,1,53221,27390,26832
10470929,10470920,TXFE7,128,9942,1,53222,27391,26833
10471017,10471006,TXFE7,128,9942,2,53224,27392,26835
10471067,10471056,TXFE7,128,9941,2,53226,27394,26836
10471154,10471153,TXFE7,128,9942,2,53228,27395,26837
10471192,10471186,TXFE7,128,9941,1,53229,27396,26838
10471367,10471360,TXFE7,128,9942,1,53230,27397,26839
10471367,10471360,TXFE7,128,9942,1,53231,27398,26840
10471367,10471360,TXFE7,128,9942,4,53235,27399,26843
10471379,10471367,TXFE7,128,9942,1,53236,27400,26844
10471379,10471367,TXFE7,128,9942,1,53237,27401,26845
10471379,10471367,TXFE7,128,9942,1,53238,27402,26846
10471379,10471379,TXFE7,128,9943,1,53239,27403,26847
10471417,10471414,TXFE7,128,9943,5,53244,27404,26848
10471442,10471439,TXFE7,128,9943,5,53249,27405,26849
10471454,10471452,TXFE7,128,9943,5,53254,27406,26850
10471454,10471454,TXFE7,128,9942,1,53255,27407,26851
10471629,10471617,TXFE7,128,9942,2,53257,27409,26852
10471654,10471652,TXFE7,128,9943,2,53259,27410,26853
10472067,10472058,TXFE7,128,9943,5,53264,27411,26854
10472079,10472072,TXFE7,128,9943,5,53269,27412,26855
10472179,10472176,TXFE7,128,9942,2,53271,27414,26856
10472192,10472180,TXFE7,128,9943,2,53273,27415,26857
10472229,10472223,TXFE7,128,9943,1,53274,27416,26858
10472254,10472248,TXFE7,128,9943,1,53275,27417,26859
10472279,10472277,TXFE7,128,9943,3,53278,27418,26860
10472404,10472402,TXFE7,128,9942,1,53279,27419,26861
10472629,10472620,TXFE7,128,9943,3,53282,27420,26862
10472729,10472718,TXFE7,128,9942,2,53284,27422,26863
10472992,10472984,TXFE7,128,9942,28,53312,27423,26864
10473004,10472992,TXFE7,128,9942,13,53325,27424,26865
10473004,10472992,TXFE7,128,9942,13,53338,27425,26866
10473004,10472992,TXFE7,128,9942,2,53340,27426,26867
10473004,10472992,TXFE7,128,9942,2,53342,27427,26868
10473004,10472992,TXFE7,128,9942,2,53344,27428,26869
10473004,10472992,TXFE7,128,9942,1,53345,27429,26870
10473004,10472992,TXFE7,128,9942,2,53347,27430,26871
10473004,10472992,TXFE7,128,9942,8,53355,27435,26872
10473004,10472992,TXFE7,128,9942,1,53356,27436,26873
10473004,10472992,TXFE7,128,9942,2,53358,27437,26874
10473004,10472992,TXFE7,128,9942,2,53360,27438,26875
10473004,10472992,TXFE7,128,9942,4,53364,27441,26876
10473004,10472997,TXFE7,128,9943,3,53367,27442,26877
10473017,10473004,TXFE7,128,9942,2,53369,27444,26878
10473017,10473004,TXFE7,128,9942,1,53370,27445,26879
10473017,10473004,TXFE7,128,9942,3,53373,27447,26880
10473029,10473022,TXFE7,128,9941,1,53374,27448,26881
10473029,10473027,TXFE7,128,9942,1,53375,27449,26882
10473054,10473047,TXFE7,128,9942,1,53376,27450,26883
10473217,10473215,TXFE7,128,9942,1,53377,27451,26884
10473242,10473237,TXFE7,128,9942,1,53378,27452,26885
10473254,10473242,TXFE7,128,9942,2,53380,27453,26887
10473254,10473242,TXFE7,128,9942,1,53381,27454,26888
10473254,10473242,TXFE7,128,9942,1,53382,27455,26889
10473254,10473242,TXFE7,128,9942,1,53383,27456,26890
10473267,10473255,TXFE7,128,9942,26,53409,27457,26902
10473267,10473257,TXFE7,128,9941,2,53411,27458,26903
10473279,10473269,TXFE7,128,9942,7,53418,27459,26904
10473304,10473304,TXFE7,128,9942,1,53419,27460,26905
10473442,10473429,TXFE7,128,9942,1,53420,27461,26906
10473667,10473657,TXFE7,128,9942,8,53428,27462,26908
10473679,10473672,TXFE7,128,9942,1,53429,27463,26909
10473729,10473720,TXFE7,128,9942,1,53430,27464,26910
10473829,10473818,TXFE7,128,9941,2,53432,27466,26911
10473829,10473823,TXFE7,128,9942,1,53433,27467,26912
10473867,10473859,TXFE7,128,9942,1,53434,27468,26913
10473867,10473862,TXFE7,128,9942,3,53437,27469,26914
10473904,10473902,TXFE7,128,9942,3,53440,27470,26917
10473954,10473946,TXFE7,128,9942,5,53445,27471,26922
10473967,10473954,TXFE7,128,9942,1,53446,27472,26923
10473979,10473972,TXFE7,128,9943,4,53450,27473,26924
10474004,10474001,TXFE7,128,9942,1,53451,27474,26925
10474017,10474010,TXFE7,128,9942,1,53452,27475,26926
10474017,10474011,TXFE7,128,9942,2,53454,27476,26927
10474029,10474017,TXFE7,128,9942,5,53459,27477,26928
10474142,10474131,TXFE7,128,9943,1,53460,27478,26929
10474179,10474170,TXFE7,128,9942,1,53461,27479,26930
10474367,10474356,TXFE7,128,9942,2,53463,27480,26931
10474404,10474401,TXFE7,128,9942,1,53464,27481,26932
10474417,10474415,TXFE7,128,9942,2,53466,27482,26933
10474417,10474415,TXFE7,128,9942,1,53467,27483,26934
10474429,10474417,TXFE7,128,9942,3,53470,27485,26935
10474454,10474454,TXFE7,128,9942,1,53471,27486,26936
10474604,10474603,TXFE7,128,9941,1,53472,27487,26937
10474654,10474654,TXFE7,128,9942,1,53473,27488,26938
10474729,10474725,TXFE7,128,9943,1,53474,27489,26939
10474917,10474916,TXFE7,128,9942,2,53476,27491,26940
10474942,10474941,TXFE7,128,9942,1,53477,27492,26941
10474979,10474978,TXFE7,128,9943,1,53478,27493,26942
10475029,10475017,TXFE7,128,9942,1,53479,27494,26943
10475129,10475128,TXFE7,128,9943,50,53529,27495,26944
10475142,10475129,TXFE7,128,9943,10,53539,27496,26950
10475154,10475142,TXFE7,128,9943,3,53542,27497,26953
10475154,10475142,TXFE7,128,9943,1,53543,27498,26954
10475154,10475142,TXFE7,128,9943,1,53544,27499,26955
10475154,10475142,TXFE7,128,9943,27,53571,27500,26978
10475242,10475235,TXFE7,128,9943,1,53572,27501,26979
10475279,10475275,TXFE7,128,9944,1,53573,27502,26980
10475292,10475281,TXFE7,128,9944,2,53575,27503,26982
10475292,10475281,TXFE7,128,9944,4,53579,27504,26985
10475304,10475296,TXFE7,128,9944,6,53585,27505,26990
10475342,10475330,TXFE7,128,9943,1,53586,27506,26991
10475342,10475332,TXFE7,128,9944,16,53602,27507,26992
10475342,10475336,TXFE7,128,9944,1,53603,27508,26993
10475354,10475344,TXFE7,128,9944,12,53615,27509,27000
10475354,10475344,TXFE7,128,9944,2,53617,27510,27002
10475354,10475352,TXFE7,128,9944,8,53625,27511,27003
10475379,10475377,TXFE7,128,9943,1,53626,27512,27004
10475392,10475387,TXFE7,128,9944,2,53628,27513,27005
10475467,10475457,TXFE7,128,9943,2,53630,27514,27006
10475479,10475475,TXFE7,128,9943,1,53631,27515,27007
10475504,10475498,TXFE7,128,9943,1,53632,27516,27008
10475542,10475535,TXFE7,128,9944,1,53633,27517,27009
10475592,10475580,TXFE7,128,9944,1,53634,27518,27010
10475692,10475688,TXFE7,128,9943,2,53636,27520,27011
10475704,10475700,TXFE7,128,9944,1,53637,27521,27012
10475742,10475732,TXFE7,128,9943,1,53638,27522,27013
10475742,10475733,TXFE7,128,9944,1,53639,27523,27014
10475742,10475735,TXFE7,128,9944,10,53649,27524,27015
10475867,10475866,TXFE7,128,9944,1,53650,27525,27016
10475917,10475909,TXFE7,128,9944,1,53651,27526,27017
10475954,10475942,TXFE7,128,9943,1,53652,27527,27018
10475992,10475990,TXFE7,128,9944,1,53653,27528,27019
10480004,10475999,TXFE7,128,9943,2,53655,27530,27020
10480042,10480038,TXFE7,128,9944,2,53657,27531,27021
10480042,10480041,TXFE7,128,9944,2,53659,27532,27023
10480054,10480043,TXFE7,128,9944,1,53660,27533,27024
10480054,10480044,TXFE7,128,9944,1,53661,27534,27025
10480054,10480045,TXFE7,128,9944,1,53662,27535,27026
10480054,10480048,TXFE7,128,9944,1,53663,27536,27027
10480067,10480055,TXFE7,128,9944,1,53664,27537,27028
10480079,10480070,TXFE7,128,9944,4,53668,27538,27032
10480079,10480072,TXFE7,128,9944,2,53670,27539,27034
10480092,10480079,TXFE7,128,9944,4,53674,27540,27035
10480117,10480104,TXFE7,128,9943,1,53675,27541,27036
10480179,10480171,TXFE7,128,9944,30,53705,27542,27046
10480217,10480211,TXFE7,128,9944,1,53706,27543,27047
10480217,10480213,TXFE7,128,9944,1,53707,27544,27048
10480217,10480215,TXFE7,128,9944,1,53708,27545,27049
10480229,10480217,TXFE7,128,9944,1,53709,27546,27050
10480229,10480219,TXFE7,128,9944,1,53710,27547,27051
10480242,10480230,TXFE7,128,9944,1,53711,27548,27052
10480242,10480234,TXFE7,128,9944,1,53712,27549,27053
10480292,10480281,TXFE7,128,9944,1,53713,27550,27054
10480342,10480339,TXFE7,128,9944,1,53714,27551,27055
10480367,10480364,TXFE7,128,9944,1,53715,27552,27056
10480392,10480384,TXFE7,128,9944,1,53716,27553,27057
10480392,10480386,TXFE7,128,9944,1,53717,27554,27058
10480442,10480437,TXFE7,128,9944,2,53719,27555,27059
10480442,10480440,TXFE7,128,9944,1,53720,27556,27060
10480492,10480487,TXFE7,128,9944,1,53721,27557,27061
10480504,10480492,TXFE7,128,9944,1,53722,27558,27062
10480517,10480516,TXFE7,128,9943,1,53723,27559,27063
10480542,10480537,TXFE7,128,9943,2,53725,27560,27064
10480579,10480579,TXFE7,128,9943,1,53726,27561,27065
10480629,10480621,TXFE7,128,9944,1,53727,27562,27066
10480642,10480632,TXFE7,128,9944,2,53729,27563,27067
10480642,10480640,TXFE7,128,9944,1,53730,27564,27068
10480717,10480716,TXFE7,128,9944,1,53731,27565,27069
10480792,10480789,TXFE7,128,9943,1,53732,27566,27070
10480804,10480803,TXFE7,128,9944,1,53733,27567,27071
10480867,10480859,TXFE7,128,9944,1,53734,27568,27072
10480917,10480915,TXFE7,128,9944,2,53736,27569,27073
10480967,10480956,TXFE7,128,9944,1,53737,27570,27074
10480967,10480956,TXFE7,128,9944,1,53738,27571,27075
10480967,10480957,TXFE7,128,9944,1,53739,27572,27076
10480967,10480958,TXFE7,128,9944,1,53740,27573,27077
10480967,10480958,TXFE7,128,9944,1,53741,27574,27078
10480967,10480965,TXFE7,128,9944,2,53743,27575,27079
10480967,10480965,TXFE7,128,9944,2,53745,27576,27081
10481004,10480997,TXFE7,128,9944,8,53753,27577,27088
10481054,10481045,TXFE7,128,9944,1,53754,27578,27089
10481067,10481055,TXFE7,128,9944,1,53755,27579,27090
10481092,10481080,TXFE7,128,9944,1,53756,27580,27091
10481092,10481084,TXFE7,128,9944,5,53761,27581,27095
10481104,10481099,TXFE7,128,9943,2,53763,27583,27096
10481142,10481130,TXFE7,128,9944,7,53770,27584,27102
10481142,10481139,TXFE7,128,9944,1,53771,27585,27103
10481167,10481159,TXFE7,128,9944,5,53776,27586,27105
10481179,10481168,TXFE7,128,9944,1,53777,27587,27106
10481192,10481191,TXFE7,128,9944,30,53807,27588,27127
10481204,10481192,TXFE7,128,9944,2,53809,27589,27129
10481217,10481208,TXFE7,128,9945,1,53810,27590,27130
10481229,10481221,TXFE7,128,9945,4,53814,27591,27131
10481229,10481223,TXFE7,128,9945,1,53815,27592,27132
10481242,10481231,TXFE7,128,9945,4,53819,27593,27136
10481242,10481232,TXFE7,128,9945,1,53820,27594,27137
10481242,10481236,TXFE7,128,9945,2,53822,27595,27139
10481242,10481237,TXFE7,128,9945,4,53826,27596,27140
10481254,10481253,TXFE7,128,9945,1,53827,27597,27141
10481267,10481265,TXFE7,128,9945,4,53831,27598,27144
10481267,10481266,TXFE7,128,9945,1,53832,27599,27145
10481292,10481280,TXFE7,128,9945,1,53833,27600,27146
10481354,10481343,TXFE7,128,9945,1,53834,27601,27147
10481367,10481364,TXFE7,128,9945,1,53835,27602,27148
10481392,10481382,TXFE7,128,9944,1,53836,27603,27149
10481404,10481396,TXFE7,128,9944,1,53837,27604,27150
10481429,10481423,TXFE7,128,9945,1,53838,27605,27151
10481454,10481447,TXFE7,128,9944,7,53845,27608,27152
10481467,10481455,TXFE7,128,9945,1,53846,27609,27153
10481467,10481456,TXFE7,128,9945,1,53847,27610,27154
10481492,10481491,TXFE7,128,9944,1,53848,27611,27155
10481542,10481539,TXFE7,128,9945,2,53850,27612,27157
10481542,10481539,TXFE7,128,9945,2,53852,27613,27159
10481542,10481539,TXFE7,128,9945,2,53854,27614,27161
10481542,10481541,TXFE7,128,9945,2,53856,27615,27162
10481554,10481543,TXFE7,128,9945,1,53857,27616,27163
10481554,10481544,TXFE7,128,9945,1,53858,27617,27164
10481554,10481545,TXFE7,128,9945,2,53860,27618,27166
10481554,10481545,TXFE7,128,9945,2,53862,27619,27168
10481554,10481549,TXFE7,128,9945,2,53864,27620,27170
10481554,10481550,TXFE7,128,9945,2,53866,27621,27171
10481629,10481619,TXFE7,128,9945,4,53870,27622,27175
10481629,10481628,TXFE7,128,9945,1,53871,27623,27176
10481642,10481631,TXFE7,128,9944,1,53872,27624,27177
10481642,10481637,TXFE7,128,9944,2,53874,27625,27178
10481642,10481638,TXFE7,128,9944,1,53875,27626,27179
10481667,10481666,TXFE7,128,9945,1,53876,27627,27180
10481692,10481681,TXFE7,128,9945,2,53878,27628,27182
10481704,10481697,TXFE7,128,9945,1,53879,27629,27183
10481717,10481710,TXFE7,128,9945,1,53880,27630,27184
10481742,10481733,TXFE7,128,9945,1,53881,27631,27185
10481754,10481745,TXFE7,128,9945,1,53882,27632,27186
10481779,10481771,TXFE7,128,9945,1,53883,27633,27187
10481804,10481794,TXFE7,128,9945,1,53884,27634,27188
10481804,10481797,TXFE7,128,9944,1,53885,27635,27189
10481804,10481800,TXFE7,128,9945,1,53886,27636,27190
10481817,10481814,TXFE7,128,9945,1,53887,27637,27191
10481854,10481850,TXFE7,128,9945,2,53889,27638,27192
10481854,10481852,TXFE7,128,9945,2,53891,27639,27193
10481854,10481853,TXFE7,128,9945,2,53893,27640,27194
10481854,10481853,TXFE7,128,9945,1,53894,27641,27195
10481854,10481854,TXFE7,128,9945,2,53896,27642,27196
10481867,10481855,TXFE7,128,9945,2,53898,27643,27197
10481867,10481857,TXFE7,128,9945,1,53899,27644,27198
10481879,10481873,TXFE7,128,9945,1,53900,27645,27199
10481917,10481911,TXFE7,128,9945,1,53901,27646,27200
10481917,10481916,TXFE7,128,9945,1,53902,27647,27201
10481929,10481922,TXFE7,128,9945,1,53903,27648,27202
10481929,10481927,TXFE7,128,9944,1,53904,27649,27203
10481942,10481931,TXFE7,128,9944,1,53905,27650,27204
10481954,10481949,TXFE7,128,9945,3,53908,27651,27206
10481992,10481981,TXFE7,128,9945,1,53909,27652,27207
10481992,10481988,TXFE7,128,9944,1,53910,27653,27208
10482017,10482012,TXFE7,128,9945,1,53911,27654,27209
10482042,10482030,TXFE7,128,9945,1,53912,27655,27210
10482054,10482054,TXFE7,128,9945,1,53913,27656,27211
10482067,10482067,TXFE7,128,9945,2,53915,27657,27212
10482067,10482067,TXFE7,128,9945,2,53917,27658,27213
10482079,10482072,TXFE7,128,9945,2,53919,27659,27215
10482079,10482072,TXFE7,128,9945,2,53921,27660,27217
10482079,10482073,TXFE7,128,9945,2,53923,27661,27219
10482104,10482095,TXFE7,128,9944,1,53924,27662,27220
10482192,10482181,TXFE7,128,9944,2,53926,27663,27221
10482317,10482308,TXFE7,128,9945,2,53928,27664,27222
10482354,10482349,TXFE7,128,9945,1,53929,27665,27223
10482379,10482369,TXFE7,128,9944,1,53930,27666,27224
10482379,10482373,TXFE7,128,9945,1,53931,27667,27225
10482417,10482406,TXFE7,128,9945,1,53932,27668,27226
10482442,10482438,TXFE7,128,9945,2,53934,27669,27228
10482442,10482438,TXFE7,128,9945,1,53935,27670,27229
10482467,10482462,TXFE7,128,9944,1,53936,27671,27230
10482467,10482462,TXFE7,128,9945,1,53937,27672,27231
10482479,10482474,TXFE7,128,9945,1,53938,27673,27232
10482517,10482515,TXFE7,128,9945,1,53939,27674,27233
10482542,10482533,TXFE7,128,9944,1,53940,27675,27234
10482592,10482581,TXFE7,128,9945,1,53941,27676,27235
10482617,10482610,TXFE7,128,9945,1,53942,27677,27236
10482629,10482628,TXFE7,128,9945,1,53943,27678,27237
10482654,10482653,TXFE7,128,9945,1,53944,27679,27238
10482654,10482653,TXFE7,128,9945,22,53966,27680,27255
10482729,10482720,TXFE7,128,9945,1,53967,27681,27256
10482742,10482738,TXFE7,128,9944,2,53969,27683,27257
10482804,10482799,TXFE7,128,9945,1,53970,27684,27258
10482829,10482817,TXFE7,128,9945,1,53971,27685,27259
10482842,10482836,TXFE7,128,9945,1,53972,27686,27260
10482879,10482870,TXFE7,128,9945,22,53994,27687,27269
10482967,10482959,TXFE7,128,9944,1,53995,27688,27270
10482979,10482971,TXFE7,128,9945,2,53997,27689,27272
10482992,10482983,TXFE7,128,9945,1,53998,27690,27273
10482992,10482984,TXFE7,128,9945,1,53999,27691,27274
10482992,10482984,TXFE7,128,9945,1,54000,27692,27275
10482992,10482986,TXFE7,128,9945,1,54001,27693,27276
10482992,10482989,TXFE7,128,9945,1,54002,27694,27277
10482992,10482990,TXFE7,128,9945,1,54003,27695,27278
10482992,10482990,TXFE7,128,9945,1,54004,27696,27279
10482992,10482992,TXFE7,128,9945,1,54005,27697,27280
10483004,10482992,TXFE7,128,9945,1,54006,27698,27281
10483092,10483080,TXFE7,128,9945,5,54011,27699,27284
10483104,10483099,TXFE7,128,9944,1,54012,27700,27285
10483154,10483145,TXFE7,128,9944,1,54013,27701,27286
10483167,10483155,TXFE7,128,9945,7,54020,27702,27293
10483242,10483236,TXFE7,128,9945,1,54021,27703,27294
10483292,10483281,TXFE7,128,9944,2,54023,27704,27295
10483304,10483292,TXFE7,128,9945,1,54024,27705,27296
10483429,10483423,TXFE7,128,9945,1,54025,27706,27297
10483442,10483433,TXFE7,128,9945,7,54032,27707,27298
10483492,10483485,TXFE7,128,9945,1,54033,27708,27299
10483492,10483488,TXFE7,128,9945,1,54034,27709,27300
10483492,10483491,TXFE7,128,9945,1,54035,27710,27301
10483579,10483574,TXFE7,128,9944,1,54036,27711,27302
10483579,10483577,TXFE7,128,9945,1,54037,27712,27303
10483654,10483646,TXFE7,128,9945,1,54038,27713,27304
10483717,10483710,TXFE7,128,9945,3,54041,27714,27305
10483829,10483824,TXFE7,128,9944,2,54043,27715,27306
10483879,10483874,TXFE7,128,9945,2,54045,27716,27308
10483892,10483881,TXFE7,128,9944,1,54046,27717,27309
10483942,10483941,TXFE7,128,9944,1,54047,27718,27310
10483942,10483941,TXFE7,128,9944,1,54048,27719,27311
10483954,10483942,TXFE7,128,9944,19,54067,27731,27312
10483954,10483942,TXFE7,128,9944,1,54068,27732,27313
10483954,10483942,TXFE7,128,9944,1,54069,27733,27314
10483967,10483954,TXFE7,128,9944,6,54075,27737,27315
10483967,10483954,TXFE7,128,9944,2,54077,27738,27316
10483967,10483954,TXFE7,128,9944,4,54081,27739,27317
10483967,10483954,TXFE7,128,9944,1,54082,27740,27318
10483967,10483954,TXFE7,128,9944,2,54084,27741,27319
10483967,10483954,TXFE7,128,9944,3,54087,27742,27320
10483967,10483954,TXFE7,128,9944,2,54089,27743,27321
10483967,10483954,TXFE7,128,9944,2,54091,27745,27322
10483967,10483954,TXFE7,128,9944,1,54092,27746,27323
10483967,10483954,TXFE7,128,9944,1,54093,27747,27324
10483967,10483954,TXFE7,128,9944,10,54103,27752,27325
10483967,10483954,TXFE7,128,9944,1,54104,27753,27326
10483967,10483954,TXFE7,128,9944,1,54105,27754,27327
10483967,10483954,TXFE7,128,9944,1,54106,27755,27328
10483967,10483954,TXFE7,128,9944,4,54110,27759,27329
10483967,10483954,TXFE7,128,9944,4,54114,27761,27330
10483992,10483984,TXFE7,128,9944,1,54115,27762,27331
10483992,10483992,TXFE7,128,9944,30,54145,27763,27342
10484104,10484092,TXFE7,128,9943,100,54245,27786,27343
10484117,10484104,TXFE7,128,9943,2,54247,27788,27344
10484117,10484104,TXFE7,128,9943,1,54248,27789,27345
10484117,10484104,TXFE7,128,9943,1,54249,27790,27346
10484117,10484104,TXFE7,128,9943,1,54250,27791,27347
10484117,10484104,TXFE7,128,9943,2,54252,27793,27348
10484117,10484104,TXFE7,128,9943,1,54253,27794,27349
10484117,10484106,TXFE7,128,9942,1,54254,27795,27350
10484129,10484128,TXFE7,128,9943,5,54259,27796,27353
10484154,10484147,TXFE7,128,9943,5,54264,27797,27355
10484167,10484159,TXFE7,128,9943,1,54265,27798,27356
10484167,10484159,TXFE7,128,9943,5,54270,27799,27359
10484167,10484165,TXFE7,128,9942,2,54272,27800,27360
10484204,10484194,TXFE7,128,9943,1,54273,27801,27361
10484217,10484214,TXFE7,128,9942,5,54278,27804,27362
10484279,10484270,TXFE7,128,9942,1,54279,27805,27363
10484342,10484338,TXFE7,128,9942,1,54280,27806,27364
10484354,10484342,TXFE7,128,9943,1,54281,27807,27365
10484367,10484359,TXFE7,128,9942,2,54283,27808,27366
10484379,10484372,TXFE7,128,9943,1,54284,27809,27367
10484479,10484471,TXFE7,128,9943,2,54286,27810,27368
10484504,10484501,TXFE7,128,9943,1,54287,27811,27369
10484867,10484856,TXFE7,128,9942,30,54317,27825,27370
10484879,10484878,TXFE7,128,9942,29,54346,27830,27371
10484904,10484896,TXFE7,128,9942,5,54351,27831,27373
10484904,10484901,TXFE7,129,9942,18,54411,27832,27397
10484904,10484901,TXFE7,129,9943,42,54411,27832,27397
10484917,10484906,TXFE7,128,9943,1,54412,27833,27398
10484917,10484910,TXFE7,128,9942,1,54413,27834,27399
10484929,10484917,TXFE7,128,9943,3,54416,27835,27401
10484929,10484917,TXFE7,128,9943,2,54418,27836,27402
10484929,10484923,TXFE7,128,9942,10,54428,27841,27403
10484942,10484939,TXFE7,128,9942,2,54430,27843,27404
10484954,10484950,TXFE7,128,9942,4,54434,27844,27405
10484967,10484960,TXFE7,128,9943,5,54439,27845,27406
10485004,10485004,TXFE7,128,9942,3,54442,27848,27407
10485104,10485100,TXFE7,128,9942,2,54444,27850,27408
10485192,10485185,TXFE7,128,9942,1,54445,27851,27409
10485229,10485218,TXFE7,128,9943,1,54446,27852,27410
10485242,10485241,TXFE7,128,9942,3,54449,27854,27411
10485254,10485242,TXFE7,128,9942,4,54453,27857,27412
10485279,10485267,TXFE7,128,9942,1,54454,27858,27413
10485279,10485271,TXFE7,128,9941,1,54455,27859,27414
10485292,10485289,TXFE7,128,9942,1,54456,27860,27415
10485354,10485346,TXFE7,128,9942,2,54458,27861,27417
10485367,10485363,TXFE7,128,9942,1,54459,27862,27418
10485504,10485500,TXFE7,128,9941,2,54461,27864,27419
10485529,10485523,TXFE7,128,9941,1,54462,27865,27420
10485567,10485561,TXFE7,128,9942,1,54463,27866,27421
10485579,10485572,TXFE7,128,9942,1,54464,27867,27422
10485742,10485735,TXFE7,128,9942,1,54465,27868,27423
10485767,10485757,TXFE7,128,9941,10,54475,27871,27424
10485904,10485897,TXFE7,128,9942,3,54478,27872,27427
10490042,10490040,TXFE7,128,9941,2,54480,27873,27428
10490054,10490043,TXFE7,128,9942,11,54491,27874,27430
10490067,10490054,TXFE7,128,9943,15,54506,27875,27438
10490079,10490070,TXFE7,128,9942,4,54510,27876,27439
10490104,10490103,TXFE7,128,9943,8,54518,27877,27442
10490154,10490150,TXFE7,128,9943,3,54521,27878,27443
10490167,10490156,TXFE7,128,9943,1,54522,27879,27444
10490179,10490174,TXFE7,128,9943,30,54552,27880,27456
10490217,10490204,TXFE7,128,9943,2,54554,27881,27457
10490217,10490205,TXFE7,128,9943,1,54555,27882,27458
10490217,10490207,TXFE7,128,9943,1,54556,27883,27459
10490217,10490209,TXFE7,128,9943,1,54557,27884,27460
10490217,10490211,TXFE7,128,9943,1,54558,27885,27461
10490217,10490213,TXFE7,128,9943,1,54559,27886,27462
10490229,10490217,TXFE7,128,9943,2,54561,27887,27463
10490229,10490228,TXFE7,128,9943,1,54562,27888,27464
10490242,10490230,TXFE7,128,9943,1,54563,27889,27465
10490254,10490246,TXFE7,128,9943,2,54565,27890,27467
10490267,10490254,TXFE7,128,9943,2,54567,27891,27469
10490267,10490254,TXFE7,128,9943,2,54569,27892,27471
10490279,10490267,TXFE7,128,9943,1,54570,27893,27472
10490292,10490285,TXFE7,128,9943,6,54576,27896,27473
10490304,10490292,TXFE7,128,9943,1,54577,27897,27474
10490304,10490294,TXFE7,128,9943,1,54578,27898,27475
10490367,10490354,TXFE7,128,9943,2,54580,27899,27476
10490392,10490387,TXFE7,128,9943,2,54582,27900,27477
10490429,10490417,TXFE7,128,9943,1,54583,27901,27478
10490529,10490521,TXFE7,128,9943,1,54584,27902,27479
10490579,10490570,TXFE7,128,9943,1,54585,27903,27480
10490579,10490572,TXFE7,128,9944,40,54625,27904,27493
10490579,10490577,TXFE7,128,9943,1,54626,27905,27494
10490592,10490581,TXFE7,128,9943,2,54628,27906,27495
10490729,10490727,TXFE7,128,9943,2,54630,27907,27496
10490854,10490854,TXFE7,128,9943,1,54631,27908,27497
10490892,10490881,TXFE7,128,9943,1,54632,27909,27498
10490904,10490894,TXFE7,128,9943,3,54635,27911,27499
10490904,10490904,TXFE7,128,9944,1,54636,27912,27500
10491154,10491144,TXFE7,128,9943,2,54638,27914,27501
10491154,10491151,TXFE7,128,9943,2,54640,27916,27502
10491229,10491217,TXFE7,128,9943,1,54641,27917,27503
10491329,10491322,TXFE7,128,9944,1,54642,27918,27504
10491479,10491477,TXFE7,128,9944,1,54643,27919,27505
10491692,10491685,TXFE7,128,9943,2,54645,27920,27506
10491729,10491721,TXFE7,128,9944,1,54646,27921,27507
10491842,10491837,TXFE7,128,9944,3,54649,27922,27508
10491892,10491885,TXFE7,128,9943,1,54650,27923,27509
10491942,10491931,TXFE7,128,9943,1,54651,27924,27510
10491979,10491967,TXFE7,128,9943,1,54652,27925,27511
10491992,10491979,TXFE7,128,9943,1,54653,27926,27512
10491992,10491982,TXFE7,128,9943,21,54674,27939,27513
10492004,10491998,TXFE7,128,9943,1,54675,27940,27514
10492054,10492049,TXFE7,128,9942,1,54676,27941,27515
10492079,10492078,TXFE7,128,9943,2,54678,27942,27516
10492079,10492079,TXFE7,128,9943,2,54680,27943,27518
10492229,10492223,TXFE7,128,9942,2,54682,27944,27519
10492454,10492448,TXFE7,128,9943,19,54701,27945,27524
10492467,10492460,TXFE7,128,9943,2,54703,27946,27525
10492492,10492486,TXFE7,128,9943,1,54704,27947,27526
10492504,10492500,TXFE7,128,9944,2,54706,27948,27527
10492517,10492515,TXFE7,128,9943,1,54707,27949,27528
10492792,10492786,TXFE7,128,9943,2,54709,27950,27529
10492854,10492842,TXFE7,128,9943,1,54710,27951,27530
10493004,10492995,TXFE7,128,9943,1,54711,27952,27531
10493054,10493044,TXFE7,128,9943,1,54712,27953,27532
10493092,10493087,TXFE7,128,9943,1,54713,27954,27533
10493142,10493137,TXFE7,128,9943,3,54716,27957,27534
10493254,10493242,TXFE7,128,9943,2,54718,27959,27535
10493279,10493279,TXFE7,128,9943,2,54720,27960,27536
10493329,10493324,TXFE7,128,9942,2,54722,27961,27537
10493354,10493354,TXFE7,128,9943,1,54723,27962,27538
10493492,10493482,TXFE7,128,9943,1,54724,27963,27539
10493504,10493497,TXFE7,128,9943,2,54726,27964,27541
10493529,10493517,TXFE7,128,9943,1,54727,27965,27542
10493579,10493568,TXFE7,128,9944,3,54730,27966,27543
10493604,10493602,TXFE7,128,9943,1,54731,27967,27544
10493667,10493656,TXFE7,128,9943,1,54732,27968,27545
10493867,10493863,TXFE7,128,9943,2,54734,27969,27546
10493904,10493893,TXFE7,128,9944,1,54735,27970,27547
10494192,10494187,TXFE7,128,9943,2,54737,27971,27548
10494292,10494284,TXFE7,128,9943,3,54740,27972,27549
10494329,10494317,TXFE7,128,9943,7,54747,27976,27550
10494367,10494367,TXFE7,128,9942,1,54748,27977,27551
10494392,10494390,TXFE7,128,9943,1,54749,27978,27552
10494417,10494405,TXFE7,128,9942,2,54751,27979,27553
10494429,10494422,TXFE7,128,9942,3,54754,27981,27554
10494492,10494483,TXFE7,128,9943,5,54759,27982,27555
10494692,10494692,TXFE7,128,9943,1,54760,27983,27556
10494704,10494699,TXFE7,128,9943,2,54762,27984,27558
10494804,10494793,TXFE7,128,9943,1,54763,27985,27559
10494854,10494854,TXFE7,128,9943,1,54764,27986,27560
10495129,10495118,TXFE7,128,9943,1,54793,27991,27568
10495142,10495134,TXFE7,128,9943,1,54794,27992,27569
10495154,10495142,TXFE7,128,9943,2,54796,27993,27570
10495504,10495504,TXFE7,128,9943,1,54797,27994,27571
10495529,10495528,TXFE7,128,9942,2,54799,27996,27572
10495817,10495805,TXFE7,128,9943,1,54800,27997,27573
10495854,10495849,TXFE7,128,9943,2,54802,27998,27575
10495867,10495863,TXFE7,128,9943,2,54804,27999,27577
10500054,10500048,TXFE7,128,9943,1,54805,28000,27578
10500079,10500067,TXFE7,128,9943,1,54806,28001,27579
10500079,10500071,TXFE7,128,9943,1,54807,28002,27580
10500079,10500073,TXFE7,128,9942,2,54809,28004,27581
10500617,10500605,TXFE7,128,9942,2,54811,28006,27582
10500704,10500704,TXFE7,128,9943,2,54813,28007,27583
10500717,10500706,TXFE7,128,9943,2,54815,28008,27584
10500954,10500953,TXFE7,128,9943,1,54816,28009,27585
10501017,10501006,TXFE7,128,9942,10,54826,28014,27586
10501079,10501076,TXFE7,128,9942,1,54827,28015,27587
10501154,10501147,TXFE7,128,9942,2,54829,28016,27588
10501217,10501215,TXFE7,128,9943,1,54830,28017,27589
10501279,10501270,TXFE7,128,9943,1,54831,28018,27590
10501317,10501311,TXFE7,128,9943,1,54832,28019,27591
10501367,10501357,TXFE7,128,9943,1,54833,28020,27592
10501404,10501402,TXFE7,128,9943,1,54834,28021,27593
10501454,10501451,TXFE7,128,9943,1,54835,28022,27594
10501504,10501497,TXFE7,128,9943,1,54836,28023,27595
10501517,10501516,TXFE7,128,9943,1,54837,28024,27596
10501592,10501585,TXFE7,128,9942,2,54839,28026,27597
10501667,10501661,TXFE7,128,9942,1,54840,28027,27598
10501667,10501666,TXFE7,128,9943,1,54841,28028,27599
10501692,10501688,TXFE7,128,9942,2,54843,28029,27600
10501692,10501688,TXFE7,128,9943,1,54844,28030,27601
10501717,10501707,TXFE7,128,9943,1,54845,28031,27602
10501729,10501725,TXFE7,128,9943,1,54846,28032,27603
10501754,10501747,TXFE7,128,9943,1,54847,28033,27604
10501767,10501764,TXFE7,128,9943,1,54848,28034,27605
10501929,10501918,TXFE7,128,9943,1,54849,28035,27606
10501929,10501924,TXFE7,128,9943,1,54850,28036,27607
10501954,10501952,TXFE7,128,9943,10,54860,28037,27617
10501967,10501962,TXFE7,128,9944,6,54866,28038,27618
10502004,10502004,TXFE7,128,9944,1,54867,28039,27619
10502017,10502006,TXFE7,128,9944,1,54868,28040,27620
10502017,10502010,TXFE7,128,9944,1,54869,28041,27621
10502017,10502014,TXFE7,128,9944,1,54870,28042,27622
10502029,10502024,TXFE7,128,9944,1,54871,28043,27623
10502029,10502026,TXFE7,128,9944,1,54872,28044,27624
10502029,10502028,TXFE7,128,9944,1,54873,28045,27625
10502254,10502247,TXFE7,128,9943,2,54875,28046,27626
10502317,10502311,TXFE7,128,9943,2,54877,28047,27627
10502479,10502473,TXFE7,128,9943,1,54878,28048,27628
10502479,10502475,TXFE7,128,9943,1,54879,28049,27629
10502479,10502477,TXFE7,128,9943,1,54880,28050,27630
10502492,10502479,TXFE7,128,9943,1,54881,28051,27631
10502492,10502479,TXFE7,128,9943,11,54892,28052,27632
10502492,10502480,TXFE7,128,9943,19,54911,28060,27633
10502817,10502808,TXFE7,128,9942,2,54913,28061,27634
10502817,10502815,TXFE7,128,9943,1,54914,28062,27635
10502829,10502818,TXFE7,128,9943,1,54915,28063,27636
10502992,10502982,TXFE7,128,9943,1,54916,28064,27637
10502992,10502986,TXFE7,128,9942,1,54917,28065,27638
10503117,10503114,TXFE7,128,9943,3,54920,28066,27641
10503354,10503350,TXFE7,128,9943,2,54922,28068,27642
10503404,10503402,TXFE7,128,9943,1,54923,28069,27643
10503829,10503829,TXFE7,128,9944,1,54924,28070,27644
10503854,10503853,TXFE7,128,9943,2,54926,28071,27645
10503892,10503889,TXFE7,128,9943,2,54928,28072,27646
10504017,10504007,TXFE7,128,9943,1,54929,28073,27647
10504017,10504013,TXFE7,128,9944,1,54930,28074,27648
10504042,10504035,TXFE7,128,9943,1,54931,28075,27649
10504442,10504430,TXFE7,128,9943,2,54933,28076,27650
10504479,10504467,TXFE7,128,9943,4,54937,28080,27651
10504929,10504925,TXFE7,128,9944,1,54938,28081,27652
10504967,10504962,TXFE7,128,9944,1,54939,28082,27653
10504992,10504989,TXFE7,128,9943,2,54941,28083,27654
10505129,10505119,TXFE7,128,9943,1,54942,28084,27655
10505279,10505267,TXFE7,128,9943,14,54956,28094,27656
10505304,10505302,TXFE7,128,9943,1,54957,28095,27657
10505342,10505334,TXFE7,128,9942,1,54958,28096,27658
10505517,10505510,TXFE7,128,9943,13,54971,28097,27665
10505517,10505511,TXFE7,128,9943,2,54973,28098,27666
10505517,10505514,TXFE7,128,9943,4,54977,28099,27667
10505529,10505527,TXFE7,128,9943,1,54978,28100,27668
10505529,10505528,TXFE7,128,9942,2,54980,28101,27669
10505554,10505543,TXFE7,128,9942,2,54982,28102,27670
10505579,10505570,TXFE7,128,9942,1,54983,28103,27671
10505617,10505606,TXFE7,128,9942,1,54984,28104,27672
10505629,10505617,TXFE7,128,9943,1,54985,28105,27673
10505642,10505638,TXFE7,128,9942,1,54986,28106,27674
10505667,10505659,TXFE7,128,9943,1,54987,28107,27675
10505829,10505818,TXFE7,128,9943,1,54988,28108,27676
10510067,10510059,TXFE7,128,9943,1,54989,28109,27677
10510079,10510069,TXFE7,128,9942,2,54991,28110,27678
10510079,10510078,TXFE7,129,9943,2,54998,28111,27684
10510079,10510078,TXFE7,129,9944,5,54998,28111,27684
10510092,10510092,TXFE7,128,9944,7,55005,28112,27689
10510129,10510126,TXFE7,128,9944,6,55011,28113,27690
10510142,10510132,TXFE7,128,9944,1,55012,28114,27691
10510179,10510175,TXFE7,128,9943,1,55013,28115,27692
10510192,10510189,TXFE7,128,9944,2,55015,28116,27693
10510192,10510191,TXFE7,128,9944,2,55017,28117,27694
10510229,10510223,TXFE7,128,9944,1,55018,28118,27695
10510254,10510247,TXFE7,128,9944,1,55019,28119,27696
10510254,10510251,TXFE7,128,9944,1,55020,28120,27697
10510254,10510253,TXFE7,128,9944,1,55021,28121,27698
10510267,10510255,TXFE7,128,9944,1,55022,28122,27699
10510292,10510279,TXFE7,128,9944,1,55023,28123,27700
10510292,10510279,TXFE7,128,9944,1,55024,28124,27701
10510292,10510281,TXFE7,128,9944,4,55028,28125,27703
10510304,10510295,TXFE7,128,9944,3,55031,28126,27706
10510304,10510295,TXFE7,128,9944,3,55034,28127,27709
10510354,10510343,TXFE7,128,9944,1,55035,28128,27710
10510404,10510401,TXFE7,128,9944,1,55036,28129,27711
10510417,10510411,TXFE7,128,9943,1,55037,28130,27712
10510429,10510422,TXFE7,128,9944,1,55038,28131,27713
10510442,10510432,TXFE7,128,9944,1,55039,28132,27714
10510517,10510513,TXFE7,128,9944,1,55040,28133,27715
10510642,10510632,TXFE7,128,9943,2,55042,28135,27716
10510817,10510808,TXFE7,128,9944,5,55047,28136,27720
10510892,10510891,TXFE7,128,9943,1,55048,28137,27721
10511117,10511108,TXFE7,128,9944,5,55053,28138,27726
10511142,10511130,TXFE7,128,9943,16,55069,28147,27727
10511179,10511170,TXFE7,128,9942,2,55071,28148,27728
10511404,10511397,TXFE7,128,9943,5,55076,28149,27731
10511704,10511695,TXFE7,128,9943,5,55081,28150,27732
10511717,10511708,TXFE7,128,9942,2,55083,28151,27733
10511829,10511823,TXFE7,128,9943,1,55084,28152,27734
10511929,10511925,TXFE7,128,9943,4,55088,28153,27735
10511942,10511935,TXFE7,128,9943,5,55093,28154,27739
10511979,10511968,TXFE7,128,9943,1,55094,28155,27740
10512017,10512008,TXFE7,128,9942,1,55095,28156,27741
10512017,10512013,TXFE7,128,9943,1,55096,28157,27742
10512192,10512182,TXFE7,128,9943,1,55097,28158,27743
10512279,10512278,TXFE7,128,9942,2,55099,28159,27744
10512304,10512296,TXFE7,128,9943,8,55107,28160,27747
10512317,10512308,TXFE7,128,9944,10,55117,28161,27754
10512354,10512350,TXFE7,128,9943,1,55118,28162,27755
10512379,10512371,TXFE7,128,9943,1,55119,28163,27756
10512592,10512588,TXFE7,128,9943,1,55120,28164,27757
10512642,10512635,TXFE7,128,9944,1,55121,28165,27758
10512767,10512756,TXFE7,128,9943,2,55123,28166,27759
10512779,10512767,TXFE7,128,9943,3,55126,28167,27760
10512792,10512780,TXFE7,128,9943,1,55127,28168,27761
10512792,10512783,TXFE7,128,9943,1,55128,28169,27762
10512817,10512813,TXFE7,128,9943,2,55130,28170,27763
10512954,10512946,TXFE7,128,9943,1,55131,28171,27764
10512954,10512950,TXFE7,128,9943,9,55140,28172,27765
10512992,10512987,TXFE7,128,9943,1,55141,28173,27766
10513129,10513122,TXFE7,128,9943,12,55153,28177,27767
10513379,10513370,TXFE7,128,9942,2,55155,28178,27768
10513392,10513388,TXFE7,128,9943,9,55164,28179,27770
10513417,10513410,TXFE7,128,9943,1,55165,28180,27771
10513517,10513513,TXFE7,128,9944,2,55167,28181,27772
10513567,10513566,TXFE7,128,9943,1,55168,28182,27773
10513617,10513615,TXFE7,128,9944,1,55169,28183,27774
10513629,10513625,TXFE7,128,9943,1,55170,28184,27775
10513629,10513629,TXFE7,128,9943,2,55172,28185,27776
10513742,10513735,TXFE7,128,9943,1,55173,28186,27777
10513917,10513912,TXFE7,128,9943,2,55175,28187,27778
10514304,10514301,TXFE7,128,9943,9,55184,28188,27779
10514317,10514304,TXFE7,128,9943,4,55188,28189,27780
10514329,10514326,TXFE7,128,9943,3,55191,28190,27781
10514454,10514452,TXFE7,128,9943,2,55193,28191,27782
10514554,10514545,TXFE7,128,9943,1,55194,28192,27783
10514817,10514811,TXFE7,128,9943,2,55196,28193,27784
10514854,10514846,TXFE7,128,9943,5,55201,28194,27785
10514992,10514981,TXFE7,128,9943,1,55202,28195,27786
10515029,10515018,TXFE7,128,9943,1,55203,28196,27787
10515029,10515029,TXFE7,128,9943,2,55205,28197,27788
10515067,10515063,TXFE7,128,9943,1,55206,28198,27789
10515404,10515393,TXFE7,128,9943,1,55207,28199,27790
10515554,10515551,TXFE7,128,9942,2,55209,28200,27791
10520092,10520082,TXFE7,128,9943,1,55210,28201,27792
10520104,10520094,TXFE7,128,9942,2,55212,28202,27793
10520104,10520101,TXFE7,128,9943,3,55215,28203,27795
10520142,10520132,TXFE7,128,9943,1,55216,28204,27796
10520192,10520191,TXFE7,128,9943,2,55218,28205,27798
10520204,10520196,TXFE7,128,9944,2,55220,28206,27800
10520267,10520263,TXFE7,128,9943,1,55221,28207,27801
10520404,10520403,TXFE7,128,9943,1,55222,28208,27802
10520679,10520673,TXFE7,128,9943,2,55224,28210,27803
10520929,10520917,TXFE7,128,9943,1,55225,28211,27804
10521142,10521136,TXFE7,128,9942,1,55226,28212,27805
10521217,10521212,TXFE7,128,9942,2,55228,28213,27806
10521454,10521448,TXFE7,128,9943,1,55229,28214,27807
10521467,10521463,TXFE7,128,9942,20,55249,28219,27808
10521492,10521492,TXFE7,128,9943,1,55250,28220,27809
10521754,10521754,TXFE7,128,9942,2,55252,28221,27810
10522067,10522065,TXFE7,128,9942,2,55254,28222,27811
10522304,10522293,TXFE7,128,9942,2,55256,28223,27812
10522804,10522792,TXFE7,128,9942,2,55258,28224,27813
10522854,10522853,TXFE7,128,9942,2,55260,28225,27814
10522892,10522882,TXFE7,128,9942,1,55261,28226,27815
10522942,10522941,TXFE7,128,9942,5,55266,28227,27816
10523404,10523393,TXFE7,128,9942,2,55268,28228,27817
10523704,10523699,TXFE7,128,9943,1,55269,28229,27818
10523754,10523749,TXFE7,128,9943,1,55270,28230,27819
10523942,10523936,TXFE7,128,9942,2,55272,28231,27820
10523967,10523957,TXFE7,128,9943,1,55273,28232,27821
10524267,10524255,TXFE7,128,9942,1,55274,28233,27822
10524367,10524366,TXFE7,128,9943,1,55275,28234,27823
10524429,10524418,TXFE7,128,9943,1,55276,28235,27824
10524492,10524480,TXFE7,128,9942,2,55278,28236,27825
10524554,10524545,TXFE7,128,9942,3,55281,28237,27826
10525004,10524994,TXFE7,128,9943,2,55283,28238,27827
10525042,10525035,TXFE7,128,9942,2,55285,28240,27828
10525079,10525071,TXFE7,128,9943,1,55286,28241,27829
10525079,10525075,TXFE7,128,9942,1,55287,28242,27830
10525104,10525099,TXFE7,128,9942,1,55288,28243,27831
10525579,10525577,TXFE7,128,9942,2,55290,28244,27832
10525779,10525768,TXFE7,128,9943,1,55291,28245,27833
10525967,10525963,TXFE7,128,9943,1,55292,28246,27834
10530092,10530088,TXFE7,128,9943,1,55293,28247,27835
10530092,10530089,TXFE7,128,9943,1,55294,28248,27836
10530117,10530107,TXFE7,128,9943,3,55297,28249,27839
10530117,10530114,TXFE7,128,9943,1,55298,28250,27840
10530129,10530117,TXFE7,128,9942,2,55300,28251,27841
10530154,10530143,TXFE7,128,9943,1,55301,28252,27842
10530679,10530676,TXFE7,128,9942,2,55303,28253,27843
10530729,10530726,TXFE7,128,9943,1,55304,28254,27844
10530804,10530793,TXFE7,128,9943,5,55309,28255,27848
10530954,10530945,TXFE7,128,9942,9,55318,28263,27849
10531229,10531220,TXFE7,128,9942,2,55320,28264,27850
10531329,10531322,TXFE7,128,9943,1,55321,28265,27851
10531454,10531453,TXFE7,128,9942,2,55323,28266,27852
10531792,10531779,TXFE7,128,9942,2,55325,28267,27853
10531967,10531961,TXFE7,128,9942,1,55326,28268,27854
10532242,10532241,TXFE7,128,9943,5,55331,28269,27857
10532354,10532342,TXFE7,128,9942,2,55333,28270,27858
10532904,10532900,TXFE7,128,9942,2,55335,28272,27859
10532942,10532936,TXFE7,128,9943,5,55340,28273,27862
10532954,10532950,TXFE7,128,9942,1,55341,28274,27863
10533004,10533004,TXFE7,128,9943,1,55342,28275,27864
10533442,10533437,TXFE7,128,9942,2,55344,28277,27865
10533979,10533978,TXFE7,128,9942,2,55346,28279,27866
10534142,10534132,TXFE7,128,9943,1,55347,28280,27867
10534167,10534165,TXFE7,128,9942,1,55348,28281,27868
10534392,10534386,TXFE7,128,9942,1,55349,28282,27869
10534542,10534540,TXFE7,128,9942,2,55351,28283,27870
10534642,10534639,TXFE7,128,9942,1,55352,28284,27871
10534642,10534639,TXFE7,128,9942,1,55353,28285,27872
10534642,10534639,TXFE7,128,9942,15,55368,28294,27873
10534654,10534642,TXFE7,128,9942,1,55369,28295,27874
10534967,10534962,TXFE7,128,9942,1,55370,28296,27875
10534967,10534962,TXFE7,128,9942,15,55385,28297,27876
10534979,10534967,TXFE7,128,9942,2,55387,28298,27877
10534979,10534967,TXFE7,128,9942,7,55394,28299,27878
10534979,10534967,TXFE7,128,9942,1,55395,28300,27879
10534979,10534967,TXFE7,128,9942,1,55396,28301,27880
10534979,10534967,TXFE7,128,9942,1,55397,28302,27881
10535017,10535009,TXFE7,128,9942,5,55402,28303,27882
10535067,10535058,TXFE7,128,9942,2,55404,28304,27883
10535067,10535064,TXFE7,128,9943,5,55409,28305,27888
10535079,10535079,TXFE7,128,9942,2,55411,28306,27889
10535354,10535346,TXFE7,128,9943,5,55416,28307,27890
10535404,10535399,TXFE7,128,9942,1,55417,28308,27891
10535604,10535596,TXFE7,128,9942,1,55418,28309,27892
10535629,10535618,TXFE7,128,9942,2,55420,28310,27893
10535942,10535938,TXFE7,128,9942,1,55421,28311,27894
10540142,10540138,TXFE7,128,9942,1,55422,28312,27895
10540192,10540180,TXFE7,128,9942,2,55424,28313,27896
10540192,10540183,TXFE7,128,9942,1,55425,28314,27897
10540329,10540324,TXFE7,128,9942,1,55426,28315,27898
10540517,10540512,TXFE7,128,9943,1,55427,28316,27899
10540529,10540518,TXFE7,128,9942,1,55428,28317,27900
10540692,10540679,TXFE7,128,9942,1,55429,28318,27901
10540704,10540696,TXFE7,128,9942,45,55474,28338,27902
10540729,10540721,TXFE7,128,9941,2,55476,28339,27903
10540754,10540745,TXFE7,128,9942,2,55478,28340,27905
10540767,10540759,TXFE7,128,9941,1,55479,28341,27906
10541167,10541155,TXFE7,128,9942,5,55484,28342,27907
10541267,10541260,TXFE7,128,9941,2,55486,28343,27908
10541442,10541430,TXFE7,128,9942,1,55487,28344,27909
10541454,10541453,TXFE7,128,9941,1,55488,28345,27910
10541704,10541699,TXFE7,128,9941,1,55489,28346,27911
10541829,10541828,TXFE7,128,9941,2,55491,28347,27912
10541892,10541881,TXFE7,128,9941,30,55521,28363,27913
10542117,10542107,TXFE7,128,9941,1,55522,28364,27914
10542229,10542229,TXFE7,128,9941,1,55523,28365,27915
10542367,10542360,TXFE7,128,9941,2,55525,28366,27916
10542479,10542467,TXFE7,128,9941,1,55526,28367,27917
10542517,10542517,TXFE7,128,9941,1,55527,28368,27918
10542604,10542602,TXFE7,128,9941,1,55528,28369,27919
10542879,10542871,TXFE7,128,9941,1,55529,28370,27920
10542904,10542901,TXFE7,128,9941,2,55531,28371,27921
10543017,10543009,TXFE7,128,9941,2,55533,28372,27922
10543079,10543076,TXFE7,128,9941,1,55534,28373,27923
10543092,10543083,TXFE7,128,9941,2,55536,28375,27924
10543279,10543270,TXFE7,128,9942,5,55541,28376,27926
10543317,10543315,TXFE7,128,9941,1,55542,28377,27927
10543354,10543348,TXFE7,128,9941,1,55543,28378,27928
10543454,10543443,TXFE7,128,9941,2,55545,28380,27929
10543592,10543581,TXFE7,128,9942,2,55547,28381,27931
10543592,10543587,TXFE7,128,9942,5,55552,28382,27935
10543679,10543668,TXFE7,128,9942,1,55553,28383,27936
10543717,10543711,TXFE7,128,9941,1,55554,28384,27937
10543842,10543840,TXFE7,128,9941,2,55556,28385,27938
10543967,10543956,TXFE7,128,9941,1,55557,28386,27939
10543967,10543956,TXFE7,128,9941,1,55558,28387,27940
10543967,10543956,TXFE7,128,9941,2,55560,28389,27941
10543967,10543956,TXFE7,128,9941,39,55599,28415,27942
10543967,10543964,TXFE7,128,9941,1,55600,28416,27943
10544004,10544002,TXFE7,128,9940,2,55602,28418,27944
10544017,10544007,TXFE7,128,9940,2,55604,28420,27945
10544154,10544151,TXFE7,128,9940,40,55644,28436,27946
10544167,10544165,TXFE7,128,9940,1,55645,28437,27947
10544267,10544259,TXFE7,128,9940,1,55646,28438,27948
10544554,10544543,TXFE7,128,9940,2,55648,28440,27949
10544642,10544630,TXFE7,128,9940,2,55650,28441,27950
10544967,10544962,TXFE7,128,9940,1,55651,28442,27951
10545017,10545007,TXFE7,128,9940,1,55652,28443,27952
10545092,10545088,TXFE7,128,9940,2,55654,28444,27953
10545492,10545488,TXFE7,128,9940,1,55655,28445,27954
10545492,10545489,TXFE7,128,9940,5,55660,28447,27955
10545504,10545494,TXFE7,128,9940,1,55661,28448,27956
10545654,10545645,TXFE7,128,9940,2,55663,28450,27957
10545754,10545743,TXFE7,128,9940,1,55664,28451,27958
10545842,10545837,TXFE7,128,9940,1,55665,28452,27959
10550029,10550026,TXFE7,128,9940,2,55667,28453,27960
10550042,10550030,TXFE7,128,9940,1,55668,28454,27961
10550042,10550037,TXFE7,128,9940,1,55669,28455,27962
10550129,10550121,TXFE7,128,9940,1,55670,28456,27963
10550192,10550185,TXFE7,128,9940,1,55671,28457,27964
10550192,10550189,TXFE7,128,9940,2,55673,28458,27965
10550417,10550415,TXFE7,128,9940,1,55674,28459,27966
10550642,10550640,TXFE7,128,9940,1,55675,28460,27967
10550754,10550744,TXFE7,128,9940,2,55677,28462,27968
10550817,10550808,TXFE7,128,9940,1,55678,28463,27969
10550979,10550971,TXFE7,128,9940,1,55679,28464,27970
10550992,10550987,TXFE7,128,9940,1,55680,28465,27971
10551154,10551148,TXFE7,128,9940,2,55682,28467,27972
10551167,10551163,TXFE7,128,9940,1,55683,28468,27973
10551217,10551212,TXFE7,128,9940,1,55684,28469,27974
10551342,10551337,TXFE7,128,9940,2,55686,28471,27975
10551654,10551653,TXFE7,128,9940,2,55688,28472,27976
10551929,10551919,TXFE7,128,9940,4,55692,28474,27977
10552054,10552054,TXFE7,128,9941,1,55693,28475,27978
10552204,10552201,TXFE7,128,9940,1,55694,28476,27979
10552992,10552981,TXFE7,128,9941,1,55695,28477,27980
10553117,10553105,TXFE7,128,9940,2,55697,28479,27981
10553179,10553167,TXFE7,128,9940,1,55698,28480,27982
10553242,10553239,TXFE7,128,9940,1,55699,28481,27983
10553454,10553445,TXFE7,128,9941,1,55700,28482,27984
10553467,10553467,TXFE7,128,9941,2,55702,28483,27985
10553554,10553553,TXFE7,128,9940,1,55703,28484,27986
10553579,10553567,TXFE7,128,9940,1,55704,28485,27987
10553867,10553862,TXFE7,128,9940,1,55705,28486,27988
10554404,10554400,TXFE7,128,9940,2,55707,28488,27989
10554467,10554461,TXFE7,128,9940,1,55708,28489,27990
10554479,10554469,TXFE7,128,9941,1,55709,28490,27991
10555754,10555750,TXFE7,128,9941,1,55710,28491,27992
10555917,10555906,TXFE7,128,9941,1,55711,28492,27993
10560067,10560059,TXFE7,128,9941,1,55712,28493,27994
10560592,10560583,TXFE7,128,9940,9,55721,28494,27995
10561367,10561358,TXFE7,128,9941,1,55722,28495,27996
10561992,10561986,TXFE7,128,9940,5,55727,28496,27997
10562204,10562193,TXFE7,128,9941,1,55728,28497,27998
10562554,10562545,TXFE7,128,9941,5,55733,28498,28002
10562667,10562661,TXFE7,128,9940,1,55734,28499,28003
10562704,10562701,TXFE7,128,9940,1,55735,28500,28004
10562829,10562820,TXFE7,128,9941,2,55737,28501,28005
10562842,10562829,TXFE7,128,9941,3,55740,28502,28008
10562842,10562829,TXFE7,128,9941,3,55743,28503,28011
10562842,10562837,TXFE7,128,9941,1,55744,28504,28012
10562854,10562842,TXFE7,128,9941,2,55746,28505,28013
10562854,10562842,TXFE7,128,9941,3,55749,28506,28015
10562854,10562842,TXFE7,128,9941,1,55750,28507,28016
10562854,10562842,TXFE7,128,9941,21,55771,28508,28031
10563329,10563317,TXFE7,128,9941,1,55772,28509,28032
10563429,10563419,TXFE7,128,9942,4,55776,28510,28034
10563429,10563419,TXFE7,128,9942,4,55780,28511,28037
10563429,10563419,TXFE7,128,9942,2,55782,28512,28039
10563429,10563419,TXFE7,128,9942,2,55784,28513,28041
10563429,10563419,TXFE7,128,9942,6,55790,28514,28044
10563429,10563419,TXFE7,128,9942,3,55793,28515,28047
10563429,10563419,TXFE7,128,9942,2,55795,28516,28049
10563429,10563419,TXFE7,128,9942,2,55797,28517,28051
10563429,10563419,TXFE7,128,9942,2,55799,28518,28053
10563429,10563419,TXFE7,128,9942,2,55801,28519,28055
10563467,10563462,TXFE7,128,9943,4,55805,28520,28056
10563554,10563548,TXFE7,128,9943,1,55806,28521,28057
10563754,10563752,TXFE7,128,9943,1,55807,28522,28058
10564042,10564037,TXFE7,128,9943,10,55817,28523,28067
10564129,10564126,TXFE7,128,9942,1,55818,28524,28068
10564267,10564258,TXFE7,128,9942,3,55821,28525,28069
10564292,10564283,TXFE7,128,9943,2,55823,28526,28070
10564667,10564661,TXFE7,128,9943,10,55833,28527,28079
10564742,10564737,TXFE7,128,9943,5,55838,28528,28084
10564817,10564805,TXFE7,128,9943,5,55843,28529,28089
10564829,10564823,TXFE7,128,9943,1,55844,28530,28090
10564854,10564845,TXFE7,128,9943,1,55845,28531,28091
10564867,10564862,TXFE7,128,9942,1,55846,28532,28092
10564929,10564924,TXFE7,128,9943,1,55847,28533,28093
10565154,10565143,TXFE7,128,9943,1,55848,28534,28094
10565504,10565500,TXFE7,128,9942,10,55858,28541,28095
10565629,10565622,TXFE7,128,9943,1,55859,28542,28096
10565779,10565769,TXFE7,128,9943,1,55860,28543,28097
10565917,10565908,TXFE7,128,9943,10,55870,28544,28106
10565929,10565921,TXFE7,128,9943,1,55871,28545,28107
10565929,10565922,TXFE7,128,9943,1,55872,28546,28108
10565967,10565955,TXFE7,128,9943,3,55875,28547,28110
10565979,10565967,TXFE7,128,9943,6,55881,28548,28115
10565979,10565973,TXFE7,128,9943,1,55882,28549,28116
10570029,10570017,TXFE7,128,9943,1,55883,28550,28117
10570042,10570036,TXFE7,128,9943,1,55884,28551,28118
10570054,10570052,TXFE7,128,9942,1,55885,28552,28119
10570054,10570052,TXFE7,128,9943,1,55886,28553,28120
10570067,10570055,TXFE7,128,9943,6,55892,28554,28121
10570079,10570075,TXFE7,128,9943,1,55893,28555,28122
10570204,10570199,TXFE7,128,9944,1,55894,28556,28123
10570217,10570210,TXFE7,128,9944,2,55896,28557,28124
10570217,10570211,TXFE7,128,9944,2,55898,28558,28126
10570217,10570213,TXFE7,128,9944,2,55900,28559,28128
10570229,10570220,TXFE7,128,9943,1,55901,28560,28129
10570242,10570233,TXFE7,128,9944,8,55909,28561,28137
10570254,10570247,TXFE7,128,9944,2,55911,28562,28138
10570254,10570247,TXFE7,128,9944,2,55913,28563,28139
10570267,10570257,TXFE7,128,9943,1,55914,28564,28140
10570317,10570312,TXFE7,128,9943,5,55919,28565,28141
10570342,10570338,TXFE7,128,9944,1,55920,28566,28142
10570467,10570461,TXFE7,128,9943,3,55923,28568,28143
10571392,10571381,TXFE7,128,9944,1,55924,28569,28144
10571504,10571497,TXFE7,128,9943,1,55925,28570,28145
10572117,10572105,TXFE7,128,9943,2,55927,28572,28146
10572267,10572264,TXFE7,128,9943,1,55928,28573,28147
10572617,10572610,TXFE7,128,9943,1,55929,28574,28148
10572642,10572631,TXFE7,128,9943,1,55930,28575,28149
10572929,10572924,TXFE7,128,9943,25,55955,28580,28150
10573042,10573036,TXFE7,128,9943,5,55960,28581,28151
10573067,10573064,TXFE7,128,9943,2,55962,28582,28152
10573179,10573167,TXFE7,128,9943,1,55963,28583,28153
10573392,10573389,TXFE7,128,9943,1,55964,28584,28154
10573567,10573558,TXFE7,128,9943,2,55966,28586,28155
10573567,10573558,TXFE7,128,9943,4,55970,28587,28156
10573567,10573558,TXFE7,128,9943,4,55974,28588,28157
10573579,10573567,TXFE7,128,9943,2,55976,28589,28158
10573579,10573567,TXFE7,128,9943,2,55978,28590,28159
10573579,10573567,TXFE7,128,9943,2,55980,28591,28160
10573579,10573567,TXFE7,128,9943,2,55982,28592,28161
10573579,10573567,TXFE7,128,9943,6,55988,28593,28162
10573579,10573567,TXFE7,128,9943,8,55996,28594,28163
10573579,10573567,TXFE7,128,9943,2,55998,28595,28164
10573579,10573567,TXFE7,128,9943,1,55999,28596,28165
10573579,10573567,TXFE7,128,9943,13,56012,28602,28166
10573629,10573617,TXFE7,128,9942,9,56021,28603,28167
10573629,10573623,TXFE7,128,9943,1,56022,28604,28168
10573754,10573750,TXFE7,128,9942,1,56023,28605,28169
10573817,10573805,TXFE7,128,9943,1,56024,28606,28170
10573817,10573816,TXFE7,128,9942,1,56025,28607,28171
10573829,10573828,TXFE7,128,9943,1,56026,28608,28172
10573829,10573829,TXFE7,128,9943,1,56027,28609,28173
10575129,10575119,TXFE7,128,9943,5,56032,28610,28174
10575579,10575574,TXFE7,128,9942,10,56042,28620,28175
10575592,10575582,TXFE7,128,9941,1,56043,28621,28176
10575604,10575598,TXFE7,128,9942,1,56044,28622,28177
10575804,10575792,TXFE7,128,9941,28,56072,28638,28178
10575917,10575916,TXFE7,128,9940,1,56073,28639,28179
10580167,10580163,TXFE7,128,9941,2,56075,28640,28181
10580179,10580173,TXFE7,128,9941,1,56076,28641,28182
10580217,10580211,TXFE7,128,9941,2,56078,28642,28183
10580217,10580212,TXFE7,129,9941,1,56080,28643,28185
10580217,10580212,TXFE7,129,9942,1,56080,28643,28185
10580467,10580456,TXFE7,128,9941,1,56081,28644,28186
10580617,10580610,TXFE7,128,9941,1,56082,28645,28187
10580842,10580830,TXFE7,128,9942,1,56083,28646,28188
10581042,10581034,TXFE7,128,9941,1,56084,28647,28189
10581129,10581124,TXFE7,128,9941,1,56085,28648,28190
10581217,10581211,TXFE7,128,9941,3,56088,28651,28191
10581517,10581513,TXFE7,128,9940,1,56089,28652,28192
10581754,10581750,TXFE7,128,9941,1,56090,28653,28193
10582417,10582406,TXFE7,128,9941,1,56091,28654,28194
10582454,10582451,TXFE7,128,9941,9,56100,28655,28200
10583242,10583231,TXFE7,128,9941,1,56101,28656,28201
10583604,10583598,TXFE7,128,9941,2,56103,28658,28202
10583629,10583617,TXFE7,128,9941,1,56104,28659,28203
10584379,10584373,TXFE7,128,9941,1,56105,28660,28204
10584792,10584788,TXFE7,128,9941,4,56109,28661,28207
10584804,10584792,TXFE7,128,9941,1,56110,28662,28208
10585954,10585947,TXFE7,128,9941,1,56111,28663,28209
10585979,10585976,TXFE7,129,9941,4,56116,28664,28213
10585979,10585976,TXFE7,129,9942,1,56116,28664,28213
10585992,10585983,TXFE7,128,9940,6,56122,28669,28214
10590154,10590149,TXFE7,128,9941,1,56123,28670,28215
10590254,10590243,TXFE7,128,9942,2,56125,28671,28216
10590742,10590732,TXFE7,128,9941,1,56126,28672,28217
10590879,10590869,TXFE7,129,9941,1,56128,28674,28218
10590879,10590869,TXFE7,129,9940,1,56128,28674,28218
10591954,10591950,TXFE7,128,9941,1,56129,28675,28219
10592317,10592312,TXFE7,128,9941,1,56130,28676,28220
10592592,10592585,TXFE7,128,9941,5,56135,28677,28223
10595792,10595787,TXFE7,128,9941,3,56138,28678,28224
10595904,10595901,TXFE7,128,9941,5,56143,28679,28226
11001717,11001714,TXFE7,128,9941,1,56144,28680,28227
11001767,11001755,TXFE7,128,9941,4,56148,28681,28231
11001767,11001757,TXFE7,128,9941,2,56150,28682,28233
11001767,11001767,TXFE7,128,9941,4,56154,28683,28235
11001979,11001971,TXFE7,128,9941,1,56155,28684,28236
11002054,11002049,TXFE7,128,9941,2,56157,28685,28238
11002342,11002339,TXFE7,128,9941,5,56162,28686,28240
11002854,11002851,TXFE7,128,9941,5,56167,28687,28245
11003092,11003082,TXFE7,128,9941,22,56189,28688,28248
11003104,11003092,TXFE7,128,9941,1,56190,28689,28249
11003104,11003092,TXFE7,128,9941,1,56191,28690,28250
11003104,11003092,TXFE7,128,9941,1,56192,28691,28251
11003104,11003092,TXFE7,128,9941,1,56193,28692,28252
11003217,11003206,TXFE7,128,9941,1,56194,28693,28253
11003692,11003686,TXFE7,128,9941,1,56195,28694,28254
11003942,11003934,TXFE7,128,9941,1,56196,28695,28255
11003992,11003987,TXFE7,128,9941,2,56198,28696,28257
11004704,11004702,TXFE7,128,9941,1,56199,28697,28258
11004742,11004731,TXFE7,128,9941,4,56203,28699,28259
11004754,11004744,TXFE7,128,9941,1,56204,28700,28260
11004754,11004752,TXFE7,128,9941,4,56208,28704,28261
11004767,11004757,TXFE7,128,9941,1,56209,28705,28262
11004767,11004763,TXFE7,128,9941,1,56210,28706,28263
11004792,11004780,TXFE7,128,9941,4,56214,28710,28264
11004992,11004987,TXFE7,128,9941,1,56215,28711,28265
11005304,11005299,TXFE7,128,9941,1,56216,28712,28266
11005354,11005350,TXFE7,128,9941,6,56222,28713,28268
11005554,11005553,TXFE7,128,9941,1,56223,28714,28269
11005829,11005829,TXFE7,128,9941,2,56225,28715,28270
11010104,11010097,TXFE7,128,9941,2,56227,28716,28272
11010317,11010314,TXFE7,128,9941,2,56229,28717,28274
11011204,11011197,TXFE7,128,9941,9,56238,28718,28276
11011204,11011197,TXFE7,128,9941,9,56247,28719,28277
11011204,11011197,TXFE7,128,9941,2,56249,28720,28278
11013404,11013392,TXFE7,128,9941,1,56250,28721,28279
11013692,11013681,TXFE7,128,9941,8,56258,28722,28282
11014054,11014048,TXFE7,128,9941,2,56260,28723,28283
11014454,11014448,TXFE7,128,9941,1,56261,28724,28284
11015054,11015048,TXFE7,128,9941,5,56266,28726,28285
11015054,11015051,TXFE7,128,9941,1,56267,28727,28286
11015192,11015186,TXFE7,128,9942,2,56269,28728,28288
11015304,11015299,TXFE7,128,9941,1,56270,28729,28289
11020817,11020815,TXFE7,128,9941,6,56276,28733,28290
11021854,11021851,TXFE7,128,9940,1,56277,28734,28291
11021867,11021854,TXFE7,128,9940,4,56281,28736,28292
11021867,11021854,TXFE7,128,9940,1,56282,28737,28293
11021867,11021854,TXFE7,128,9940,1,56283,28738,28294
11021867,11021855,TXFE7,128,9940,2,56285,28739,28295
11021904,11021903,TXFE7,128,9940,2,56287,28741,28296
11022217,11022215,TXFE7,128,9941,1,56288,28742,28297
11022679,11022674,TXFE7,128,9940,2,56290,28744,28298
11022829,11022825,TXFE7,128,9941,1,56291,28745,28299
11023154,11023144,TXFE7,128,9941,1,56292,28746,28300
11023267,11023259,TXFE7,128,9940,1,56293,28747,28301
11023517,11023512,TXFE7,128,9941,1,56294,28748,28302
11023592,11023588,TXFE7,128,9941,2,56296,28749,28303
11023804,11023797,TXFE7,128,9940,1,56297,28750,28304
11024042,11024034,TXFE7,128,9940,25,56322,28769,28305
11024104,11024095,TXFE7,128,9940,1,56323,28770,28306
11024117,11024106,TXFE7,128,9940,1,56324,28771,28307
11024167,11024155,TXFE7,128,9940,1,56325,28772,28308
11024192,11024185,TXFE7,128,9940,4,56329,28775,28309
11024204,11024195,TXFE7,128,9940,2,56331,28776,28310
11024579,11024573,TXFE7,128,9940,15,56346,28784,28311
11024904,11024902,TXFE7,128,9940,1,56347,28785,28312
11025229,11025219,TXFE7,128,9940,1,56348,28786,28313
11025567,11025559,TXFE7,128,9939,1,56349,28787,28314
11025579,11025577,TXFE7,128,9939,1,56350,28788,28315
11025592,11025581,TXFE7,128,9939,1,56351,28789,28316
11025592,11025590,TXFE7,128,9939,2,56353,28791,28317
11025617,11025613,TXFE7,128,9939,1,56354,28792,28318
11025654,11025647,TXFE7,128,9939,1,56355,28793,28319
11025654,11025651,TXFE7,128,9940,1,56356,28794,28320
11025667,11025665,TXFE7,128,9939,1,56357,28795,28321
11025692,11025685,TXFE7,128,9939,1,56358,28796,28322
11025729,11025719,TXFE7,128,9939,1,56359,28797,28323
11025879,11025869,TXFE7,128,9939,1,56360,28798,28324
11025967,11025965,TXFE7,128,9939,10,56370,28802,28325
11030117,11030112,TXFE7,128,9939,2,56372,28803,28326
11030429,11030429,TXFE7,128,9939,10,56382,28812,28327
11030642,11030638,TXFE7,128,9939,1,56383,28813,28328
11031179,11031179,TXFE7,128,9939,4,56387,28815,28329
11031404,11031402,TXFE7,128,9940,2,56389,28816,28331
11031492,11031481,TXFE7,128,9939,1,56390,28817,28332
11032254,11032248,TXFE7,128,9940,1,56391,28818,28333
11032792,11032791,TXFE7,128,9939,7,56398,28824,28334
11033804,11033802,TXFE7,128,9939,1,56399,28825,28335
11033842,11033838,TXFE7,128,9940,1,56400,28826,28336
11034042,11034030,TXFE7,128,9939,2,56402,28827,28337
11034204,11034204,TXFE7,128,9939,1,56403,28828,28338
11034629,11034617,TXFE7,128,9940,1,56404,28829,28339
11034629,11034618,TXFE7,128,9940,1,56405,28830,28340
11034979,11034977,TXFE7,128,9940,1,56406,28831,28341
11035292,11035288,TXFE7,128,9939,4,56410,28834,28342
11040067,11040063,TXFE7,128,9940,1,56411,28835,28343
11040267,11040259,TXFE7,128,9940,1,56412,28836,28344
11040804,11040799,TXFE7,128,9939,2,56414,28838,28345
11042692,11042683,TXFE7,128,9939,4,56418,28842,28346
11043267,11043254,TXFE7,128,9939,1,56419,28843,28347
11043492,11043484,TXFE7,128,9939,1,56420,28844,28348
11044179,11044174,TXFE7,128,9940,2,56422,28845,28350
11044367,11044365,TXFE7,128,9940,82,56504,28846,28394
11044392,11044379,TXFE7,128,9941,13,56517,28847,28400
11044392,11044379,TXFE7,128,9941,1,56518,28848,28401
11044392,11044379,TXFE7,128,9941,5,56523,28849,28405
11044392,11044380,TXFE7,128,9941,4,56527,28850,28408
11044404,11044392,TXFE7,128,9941,2,56529,28851,28410
11044404,11044392,TXFE7,128,9941,2,56531,28852,28412
11044404,11044392,TXFE7,128,9941,1,56532,28853,28413
11044404,11044392,TXFE7,128,9941,1,56533,28854,28414
11044404,11044392,TXFE7,128,9942,1,56534,28855,28415
11044404,11044394,TXFE7,128,9941,1,56535,28856,28416
11044404,11044394,TXFE7,128,9941,1,56536,28857,28417
11044404,11044394,TXFE7,128,9941,1,56537,28858,28418
11044417,11044410,TXFE7,128,9942,1,56538,28859,28419
11044417,11044412,TXFE7,128,9941,1,56539,28860,28420
11044804,11044799,TXFE7,128,9942,2,56541,28861,28421
11045167,11045160,TXFE7,128,9942,4,56545,28862,28425
11045679,11045675,TXFE7,128,9941,1,56546,28863,28426
11045729,11045728,TXFE7,128,9942,10,56556,28864,28435
11050054,11050048,TXFE7,128,9942,4,56560,28865,28439
11050117,11050116,TXFE7,128,9942,1,56561,28866,28440
11050142,11050139,TXFE7,128,9941,8,56569,28869,28441
11050142,11050141,TXFE7,128,9942,1,56570,28870,28442
11050354,11050345,TXFE7,128,9941,2,56572,28871,28443
11050417,11050413,TXFE7,128,9942,1,56573,28872,28444
11050667,11050666,TXFE7,128,9942,8,56581,28873,28447
11051029,11051024,TXFE7,128,9942,2,56583,28874,28448
11051092,11051086,TXFE7,128,9942,2,56585,28875,28449
11051154,11051144,TXFE7,128,9942,1,56586,28876,28450
11051192,11051184,TXFE7,128,9942,15,56601,28877,28462
11051942,11051938,TXFE7,128,9942,1,56602,28878,28463
11052079,11052075,TXFE7,128,9943,1,56603,28879,28464
11052092,11052083,TXFE7,128,9943,4,56607,28880,28467
11052104,11052092,TXFE7,128,9943,66,56673,28881,28499
11052104,11052092,TXFE7,128,9943,2,56675,28882,28501
11052104,11052093,TXFE7,128,9943,12,56687,28883,28508
11052104,11052095,TXFE7,128,9944,2,56689,28884,28509
11052117,11052114,TXFE7,128,9944,1,56690,28885,28510
11052117,11052115,TXFE7,128,9944,1,56691,28886,28511
11052129,11052121,TXFE7,128,9943,1,56692,28887,28512
11052129,11052125,TXFE7,128,9944,8,56700,28888,28520
11052142,11052138,TXFE7,128,9943,5,56705,28890,28521
11052192,11052179,TXFE7,128,9944,2,56707,28891,28522
11052204,11052204,TXFE7,128,9944,1,56708,28892,28523
11052279,11052270,TXFE7,128,9944,1,56709,28893,28524
11052279,11052276,TXFE7,128,9944,2,56711,28894,28525
11052354,11052346,TXFE7,128,9944,10,56721,28895,28533
11052517,11052514,TXFE7,128,9944,1,56722,28896,28534
11052529,11052526,TXFE7,128,9944,6,56728,28897,28540
11052567,11052556,TXFE7,128,9943,2,56730,28898,28541
11052567,11052558,TXFE7,128,9944,1,56731,28899,28542
11052592,11052588,TXFE7,128,9944,1,56732,28900,28543
11052692,11052688,TXFE7,128,9944,1,56733,28901,28544
11052904,11052900,TXFE7,128,9944,1,56734,28902,28545
11053154,11053146,TXFE7,128,9943,2,56736,28903,28546
11053229,11053224,TXFE7,128,9943,1,56737,28904,28547
11053317,11053310,TXFE7,128,9944,1,56738,28905,28548
11053517,11053506,TXFE7,128,9944,1,56739,28906,28549
11053754,11053746,TXFE7,128,9943,1,56740,28907,28550
11053792,11053789,TXFE7,128,9944,1,56741,28908,28551
11053854,11053846,TXFE7,128,9944,3,56744,28909,28554
11053879,11053872,TXFE7,128,9944,3,56747,28910,28557
11054192,11054185,TXFE7,128,9943,1,56751,28913,28560
11054454,11054447,TXFE7,128,9944,2,56753,28914,28561
11054517,11054509,TXFE7,128,9944,1,56754,28915,28562
11055104,11055099,TXFE7,128,9944,8,56762,28916,28567
11055504,11055504,TXFE7,128,9944,1,56763,28917,28568
11055604,11055603,TXFE7,128,9943,2,56765,28918,28569
11055917,11055904,TXFE7,128,9944,4,56769,28919,28573
11060029,11060020,TXFE7,128,9943,29,56798,28929,28574
11060042,11060029,TXFE7,128,9943,12,56810,28933,28575
11060054,11060042,TXFE7,128,9943,6,56816,28934,28576
11060054,11060042,TXFE7,128,9943,1,56817,28935,28577
11060054,11060042,TXFE7,128,9943,1,56818,28936,28578
11060054,11060042,TXFE7,128,9943,1,56819,28937,28579
11060054,11060042,TXFE7,128,9943,7,56826,28938,28580
11060054,11060042,TXFE7,128,9943,4,56830,28939,28581
11060054,11060049,TXFE7,128,9943,6,56836,28944,28582
11060079,11060069,TXFE7,128,9943,2,56838,28945,28583
11060079,11060074,TXFE7,128,9943,11,56849,28946,28587
11060092,11060082,TXFE7,128,9943,6,56855,28947,28591
11060179,11060179,TXFE7,128,9943,20,56875,28952,28592
11060192,11060183,TXFE7,128,9944,10,56885,28953,28601
11060192,11060186,TXFE7,128,9943,1,56886,28954,28602
11060292,11060290,TXFE7,128,9943,1,56887,28955,28603
11060417,11060414,TXFE7,128,9943,1,56888,28956,28604
11060467,11060467,TXFE7,128,9943,1,56889,28957,28605
11060554,11060550,TXFE7,128,9944,1,56890,28958,28606
11060579,11060574,TXFE7,128,9943,1,56891,28959,28607
11060642,11060633,TXFE7,128,9943,1,56892,28960,28608
11060679,11060676,TXFE7,128,9943,1,56893,28961,28609
11060742,11060731,TXFE7,128,9943,1,56894,28962,28610
11060754,11060748,TXFE7,128,9943,2,56896,28963,28611
11060829,11060825,TXFE7,128,9943,2,56898,28964,28612
11060917,11060905,TXFE7,128,9943,2,56900,28966,28613
11060929,11060928,TXFE7,128,9943,2,56902,28968,28614
11061092,11061090,TXFE7,128,9943,2,56904,28969,28615
11061392,11061392,TXFE7,128,9944,1,56905,28970,28616
11061504,11061496,TXFE7,128,9943,5,56910,28971,28617
11061617,11061615,TXFE7,128,9943,1,56911,28972,28618
11061767,11061757,TXFE7,128,9943,1,56912,28973,28619
11061879,11061868,TXFE7,128,9944,1,56913,28974,28620
11061892,11061890,TXFE7,128,9943,1,56914,28975,28621
11062029,11062023,TXFE7,128,9944,2,56916,28976,28623
11062029,11062024,TXFE7,128,9944,2,56918,28977,28625
11062229,11062217,TXFE7,128,9943,2,56920,28978,28626
11062254,11062254,TXFE7,128,9943,1,56921,28979,28627
11062304,11062294,TXFE7,128,9944,1,56922,28980,28628
11062604,11062603,TXFE7,128,9944,1,56923,28981,28629
11062692,11062679,TXFE7,128,9944,1,56924,28982,28630
11063292,11063283,TXFE7,128,9943,1,56925,28983,28631
11063304,11063294,TXFE7,128,9944,1,56926,28984,28632
11063304,11063301,TXFE7,128,9943,4,56930,28987,28633
11063404,11063394,TXFE7,128,9943,1,56931,28988,28634
11063579,11063576,TXFE7,128,9943,10,56941,28989,28635
11063854,11063847,TXFE7,128,9943,6,56947,28993,28636
11063967,11063959,TXFE7,128,9944,1,56948,28994,28637
11064192,11064180,TXFE7,128,9943,1,56949,28995,28638
11064479,11064468,TXFE7,128,9943,1,56950,28996,28639
11064479,11064469,TXFE7,128,9943,1,56951,28997,28640
11064704,11064702,TXFE7,128,9944,1,56952,28998,28641
11064754,11064742,TXFE7,128,9943,2,56954,29000,28642
11065342,11065337,TXFE7,128,9943,1,56955,29001,28643
11070442,11070436,TXFE7,128,9944,1,56956,29002,28644
11070492,11070482,TXFE7,128,9944,2,56958,29003,28646
11070517,11070505,TXFE7,128,9944,2,56960,29004,28648
11070517,11070511,TXFE7,128,9944,1,56961,29005,28649
11070579,11070574,TXFE7,128,9943,1,56962,29006,28650
11070692,11070680,TXFE7,128,9943,1,56963,29007,28651
11071567,11071562,TXFE7,128,9943,2,56965,29009,28652
11071729,11071719,TXFE7,128,9943,3,56968,29010,28653
11071817,11071815,TXFE7,128,9943,1,56969,29011,28654
11071954,11071953,TXFE7,128,9943,1,56970,29012,28655
11072967,11072957,TXFE7,128,9943,1,56971,29013,28656
11073142,11073141,TXFE7,128,9943,1,56972,29014,28657
11073217,11073216,TXFE7,128,9943,1,56973,29015,28658
11074454,11074445,TXFE7,128,9943,1,56974,29016,28659
11074492,11074482,TXFE7,128,9943,1,56975,29017,28660
11074542,11074531,TXFE7,128,9944,4,56979,29018,28664
11074742,11074734,TXFE7,128,9944,2,56981,29019,28666
11074804,11074803,TXFE7,128,9943,2,56983,29021,28667
11074829,11074826,TXFE7,128,9944,1,56984,29022,28668
11074904,11074903,TXFE7,128,9944,1,56985,29023,28669
11075004,11075000,TXFE7,128,9944,2,56987,29024,28671
11075017,11075010,TXFE7,128,9943,2,56989,29026,28672
11075029,11075023,TXFE7,128,9944,1,56990,29027,28673
11075079,11075071,TXFE7,128,9944,1,56991,29028,28674
11075167,11075156,TXFE7,128,9944,1,56992,29029,28675
11075242,11075232,TXFE7,128,9944,1,56993,29030,28676
11075429,11075417,TXFE7,128,9944,1,56994,29031,28677
11080079,11080073,TXFE7,128,9944,1,56995,29032,28678
11080117,11080106,TXFE7,128,9944,2,56997,29033,28680
11080117,11080113,TXFE7,128,9944,2,56999,29034,28681
11080142,11080141,TXFE7,128,9944,10,57009,29035,28690
11080154,11080142,TXFE7,128,9944,2,57011,29036,28692
11080167,11080157,TXFE7,128,9944,2,57013,29037,28694
11080179,11080167,TXFE7,128,9944,2,57015,29038,28696
11080217,11080216,TXFE7,128,9944,5,57020,29039,28697
11080242,11080237,TXFE7,128,9944,10,57030,29040,28702
11080254,11080247,TXFE7,128,9944,1,57031,29041,28703
11080267,11080263,TXFE7,128,9943,3,57034,29043,28704
11080267,11080264,TXFE7,128,9944,10,57044,29044,28711
11080279,11080278,TXFE7,128,9944,39,57083,29045,28737
11080292,11080283,TXFE7,128,9945,10,57093,29046,28740
11080292,11080290,TXFE7,128,9944,3,57096,29048,28741
11080304,11080297,TXFE7,128,9945,13,57109,29049,28746
11080304,11080302,TXFE7,128,9945,10,57119,29050,28747
11080317,11080311,TXFE7,128,9945,3,57122,29051,28748
11080317,11080315,TXFE7,128,9945,3,57125,29052,28749
11080329,11080321,TXFE7,128,9945,11,57136,29053,28758
11080329,11080322,TXFE7,128,9945,11,57147,29054,28761
11080329,11080323,TXFE7,128,9945,10,57157,29055,28764
11080342,11080329,TXFE7,128,9945,2,57159,29056,28765
11080342,11080329,TXFE7,128,9945,4,57163,29057,28766
11080342,11080338,TXFE7,128,9945,2,57165,29058,28767
11080354,11080344,TXFE7,128,9944,1,57166,29059,28768
11080354,11080348,TXFE7,128,9945,2,57168,29060,28770
11080354,11080350,TXFE7,128,9944,1,57169,29061,28771
11080367,11080358,TXFE7,128,9945,2,57171,29062,28772
11080379,11080368,TXFE7,128,9945,15,57186,29063,28782
11080417,11080405,TXFE7,128,9945,15,57201,29064,28787
11080454,11080452,TXFE7,128,9945,2,57203,29065,28789
11080479,11080476,TXFE7,128,9944,1,57204,29066,28790
11080504,11080501,TXFE7,128,9945,10,57214,29067,28794
11080517,11080506,TXFE7,128,9945,10,57224,29068,28798
11080592,11080590,TXFE7,128,9944,1,57225,29069,28799
11080779,11080777,TXFE7,128,9945,1,57226,29070,28800
11080804,11080798,TXFE7,128,9944,1,57227,29071,28801
11080917,11080912,TXFE7,128,9945,2,57229,29072,28803
11080929,11080920,TXFE7,128,9945,1,57230,29073,28804
11080929,11080921,TXFE7,128,9945,3,57233,29074,28807
11081079,11081079,TXFE7,128,9945,1,57234,29075,28808
11081729,11081719,TXFE7,128,9945,1,57235,29076,28809
11081742,11081741,TXFE7,128,9945,7,57242,29077,28815
11081767,11081766,TXFE7,128,9945,1,57243,29078,28816
11081817,11081814,TXFE7,128,9945,1,57244,29079,28817
11082042,11082035,TXFE7,128,9945,1,57245,29080,28818
11082054,11082051,TXFE7,128,9945,5,57250,29081,28822
11082092,11082081,TXFE7,128,9945,3,57253,29082,28825
11082192,11082187,TXFE7,128,9945,1,57254,29083,28826
11082192,11082189,TXFE7,128,9945,2,57256,29084,28828
11082229,11082223,TXFE7,128,9945,2,57258,29085,28829
11082267,11082259,TXFE7,128,9945,3,57261,29086,28831
11082292,11082286,TXFE7,128,9944,1,57262,29087,28832
11082442,11082441,TXFE7,128,9945,10,57272,29088,28841
11082479,11082476,TXFE7,128,9945,1,57273,29089,28842
11082567,11082558,TXFE7,128,9945,2,57275,29090,28844
11082567,11082564,TXFE7,128,9945,1,57276,29091,28845
11082579,11082569,TXFE7,128,9945,2,57278,29092,28847
11082629,11082621,TXFE7,128,9945,1,57279,29093,28848
11082629,11082626,TXFE7,128,9945,1,57280,29094,28849
11082642,11082638,TXFE7,128,9945,1,57281,29095,28850
11082817,11082816,TXFE7,128,9945,4,57285,29096,28853
11082992,11082985,TXFE7,128,9945,1,57286,29097,28854
11083004,11082993,TXFE7,128,9945,1,57287,29098,28855
11083079,11083076,TXFE7,128,9944,1,57288,29099,28856
11083179,11083176,TXFE7,128,9945,3,57291,29100,28859
11083192,11083182,TXFE7,128,9945,3,57294,29101,28860
11083217,11083208,TXFE7,128,9945,1,57295,29102,28861
11083254,11083250,TXFE7,128,9945,2,57297,29103,28863
11083267,11083261,TXFE7,128,9945,2,57299,29104,28865
11083292,11083279,TXFE7,128,9946,10,57309,29105,28873
11083292,11083285,TXFE7,128,9945,2,57311,29106,28874
11083304,11083294,TXFE7,128,9946,4,57315,29107,28875
11083304,11083294,TXFE7,128,9946,1,57316,29108,28876
11083304,11083295,TXFE7,128,9946,1,57317,29109,28877
11083304,11083295,TXFE7,128,9946,12,57329,29110,28886
11083304,11083297,TXFE7,128,9946,1,57330,29111,28887
11083304,11083297,TXFE7,128,9946,20,57350,29112,28902
11083304,11083298,TXFE7,128,9946,1,57351,29113,28903
11083304,11083299,TXFE7,128,9946,1,57352,29114,28904
11083304,11083300,TXFE7,128,9945,2,57354,29116,28905
11083304,11083302,TXFE7,128,9946,1,57355,29117,28906
11083304,11083303,TXFE7,128,9946,1,57356,29118,28907
11083317,11083306,TXFE7,128,9946,10,57366,29119,28913
11083317,11083306,TXFE7,128,9946,8,57374,29120,28920
11083317,11083307,TXFE7,128,9946,10,57384,29121,28929
11083317,11083307,TXFE7,128,9946,1,57385,29122,28930
11083317,11083307,TXFE7,128,9946,1,57386,29123,28931
11083317,11083311,TXFE7,128,9946,1,57387,29124,28932
11083329,11083317,TXFE7,128,9945,1,57388,29125,28933
11083329,11083327,TXFE7,128,9946,4,57392,29126,28934
11083329,11083327,TXFE7,128,9946,1,57393,29127,28935
11083367,11083355,TXFE7,128,9945,1,57394,29128,28936
11083842,11083830,TXFE7,128,9945,1,57395,29129,28937
11083854,11083844,TXFE7,128,9946,3,57398,29130,28940
11083967,11083961,TXFE7,128,9946,1,57399,29131,28941
11084042,11084031,TXFE7,128,9946,8,57407,29132,28942
11084092,11084090,TXFE7,128,9946,2,57409,29133,28943
11084154,11084143,TXFE7,128,9946,2,57411,29134,28944
11084154,11084147,TXFE7,128,9946,1,57412,29135,28945
11084192,11084179,TXFE7,128,9945,4,57416,29137,28946
11084204,11084192,TXFE7,128,9945,1,57417,29138,28947
11084217,11084212,TXFE7,128,9945,1,57418,29139,28948
11084229,11084229,TXFE7,128,9946,1,57419,29140,28949
11084242,11084239,TXFE7,128,9945,1,57420,29141,28950
11084267,11084266,TXFE7,128,9945,3,57423,29143,28951
11084354,11084344,TXFE7,128,9945,1,57424,29144,28952
11084354,11084346,TXFE7,128,9945,5,57429,29147,28953
11084367,11084364,TXFE7,128,9945,1,57430,29148,28954
11084442,11084433,TXFE7,128,9946,1,57431,29149,28955
11084442,11084435,TXFE7,128,9945,1,57432,29150,28956
11084442,11084436,TXFE7,128,9945,1,57433,29151,28957
11084454,11084447,TXFE7,128,9945,5,57438,29154,28958
11084492,11084491,TXFE7,128,9945,2,57440,29155,28959
11084504,11084493,TXFE7,128,9945,2,57442,29156,28960
11084504,11084496,TXFE7,128,9945,2,57444,29157,28961
11084542,11084535,TXFE7,128,9945,1,57445,29158,28962
11084567,11084563,TXFE7,128,9945,5,57450,29159,28965
11084667,11084661,TXFE7,128,9945,2,57452,29160,28966
11084829,11084826,TXFE7,128,9945,2,57454,29161,28967
11085017,11085013,TXFE7,128,9945,4,57458,29162,28971
11085179,11085173,TXFE7,128,9945,2,57460,29163,28972
11085279,11085279,TXFE7,128,9945,4,57464,29164,28974
11085317,11085313,TXFE7,128,9945,1,57465,29165,28975
11085467,11085459,TXFE7,128,9945,2,57467,29166,28977
11085517,11085513,TXFE7,128,9945,1,57468,29167,28978
11085867,11085855,TXFE7,128,9945,1,57469,29168,28979
11085867,11085858,TXFE7,128,9945,1,57470,29169,28980
11085967,11085964,TXFE7,128,9945,1,57471,29170,28981
11090017,11090004,TXFE7,128,9945,2,57473,29171,28983
11090017,11090005,TXFE7,128,9945,2,57475,29172,28984
11090042,11090035,TXFE7,128,9945,2,57477,29173,28985
11090054,11090047,TXFE7,128,9945,6,57483,29174,28989
11090379,11090367,TXFE7,128,9945,1,57484,29175,28990
11090467,11090463,TXFE7,128,9945,5,57489,29176,28995
11090717,11090716,TXFE7,128,9945,1,57490,29177,28996
11091079,11091068,TXFE7,128,9944,1,57491,29178,28997
11091092,11091089,TXFE7,128,9945,3,57494,29179,28999
11091104,11091100,TXFE7,128,9945,3,57497,29180,29002
11091129,11091121,TXFE7,128,9945,2,57499,29181,29004
11091204,11091200,TXFE7,128,9944,40,57539,29201,29005
11091267,11091259,TXFE7,128,9945,1,57540,29202,29006
11091279,11091277,TXFE7,128,9945,1,57541,29203,29007
11091292,11091290,TXFE7,128,9945,1,57542,29204,29008
11091379,11091378,TXFE7,128,9944,2,57544,29206,29009
11091592,11091583,TXFE7,128,9944,9,57553,29212,29010
11091804,11091803,TXFE7,128,9944,5,57558,29214,29011
11091904,11091896,TXFE7,128,9944,1,57559,29215,29012
11091929,11091923,TXFE7,128,9944,1,57560,29216,29013
11092017,11092008,TXFE7,128,9944,1,57561,29217,29014
11092279,11092277,TXFE7,128,9944,1,57562,29218,29015
11092317,11092315,TXFE7,128,9944,1,57563,29219,29016
11092567,11092557,TXFE7,128,9944,11,57574,29223,29017
11092704,11092702,TXFE7,128,9944,1,57575,29224,29018
11092754,11092749,TXFE7,128,9945,2,57577,29225,29020
11092892,11092888,TXFE7,128,9944,1,57578,29226,29021
11092904,11092900,TXFE7,128,9944,1,57579,29227,29022
11093042,11093039,TXFE7,128,9944,1,57580,29228,29023
11093242,11093241,TXFE7,128,9944,1,57581,29229,29024
11093429,11093428,TXFE7,128,9944,1,57582,29230,29025
11093492,11093492,TXFE7,128,9945,15,57597,29231,29027
11093529,11093523,TXFE7,128,9945,15,57612,29232,29039
11093617,11093605,TXFE7,128,9945,1,57613,29233,29040
11093642,11093637,TXFE7,128,9945,1,57614,29234,29041
11093879,11093879,TXFE7,128,9945,15,57629,29235,29051
11093967,11093955,TXFE7,128,9945,1,57630,29236,29052
11094067,11094057,TXFE7,128,9945,1,57631,29237,29053
11094067,11094059,TXFE7,128,9945,1,57632,29238,29054
11094067,11094062,TXFE7,128,9945,1,57633,29239,29055
11094342,11094330,TXFE7,128,9944,24,57657,29251,29056
11094829,11094827,TXFE7,128,9943,1,57658,29252,29057
11095417,11095405,TXFE7,128,9943,1,57659,29253,29058
11100067,11100055,TXFE7,128,9943,1,57660,29254,29059
11100779,11100768,TXFE7,128,9943,1,57661,29255,29060
11100967,11100959,TXFE7,128,9944,1,57662,29256,29061
11100992,11100988,TXFE7,128,9944,29,57691,29257,29076
11101004,11100992,TXFE7,128,9944,4,57695,29258,29077
11101004,11100997,TXFE7,128,9944,1,57696,29259,29078
11101004,11100997,TXFE7,128,9944,1,57697,29260,29079
11101004,11100997,TXFE7,128,9944,1,57698,29261,29080
11101004,11100997,TXFE7,128,9944,1,57699,29262,29081
11101004,11100997,TXFE7,128,9944,17,57716,29263,29091
11101029,11101018,TXFE7,128,9945,1,57717,29264,29092
11101042,11101033,TXFE7,128,9944,1,57718,29265,29093
11101054,11101043,TXFE7,128,9945,2,57720,29266,29095
11101142,11101136,TXFE7,128,9945,1,57721,29267,29096
11101154,11101153,TXFE7,128,9945,1,57722,29268,29097
11101317,11101316,TXFE7,128,9944,1,57723,29269,29098
11101817,11101813,TXFE7,128,9945,1,57724,29270,29099
11101879,11101874,TXFE7,128,9944,1,57725,29271,29100
11102579,11102576,TXFE7,128,9944,2,57727,29272,29101
11102779,11102768,TXFE7,128,9944,4,57731,29273,29102
11102779,11102768,TXFE7,128,9944,1,57732,29274,29103
11102979,11102972,TXFE7,128,9944,4,57736,29277,29104
11103092,11103079,TXFE7,128,9944,1,57737,29278,29105
11103104,11103102,TXFE7,128,9944,1,57738,29279,29106
11103142,11103137,TXFE7,128,9944,10,57748,29284,29107
11103154,11103142,TXFE7,128,9944,1,57749,29285,29108
11103667,11103662,TXFE7,128,9944,2,57751,29286,29109
11103717,11103714,TXFE7,128,9944,1,57752,29287,29110
11104354,11104347,TXFE7,128,9943,12,57764,29294,29111
11104392,11104380,TXFE7,128,9943,4,57768,29295,29112
11104392,11104380,TXFE7,128,9943,8,57776,29298,29113
11104392,11104380,TXFE7,128,9943,2,57778,29299,29114
11104404,11104392,TXFE7,128,9943,4,57782,29302,29115
11104404,11104392,TXFE7,128,9943,2,57784,29303,29116
11104404,11104392,TXFE7,128,9943,4,57788,29305,29117
11104404,11104392,TXFE7,128,9943,29,57817,29321,29118
11104542,11104529,TXFE7,128,9943,3,57820,29322,29121
11104542,11104535,TXFE7,128,9942,1,57821,29323,29122
11104567,11104555,TXFE7,128,9942,3,57824,29324,29123
11104604,11104598,TXFE7,128,9942,1,57825,29325,29124
11104804,11104801,TXFE7,128,9943,2,57827,29326,29125
11104917,11104911,TXFE7,128,9943,1,57828,29327,29126
11104942,11104939,TXFE7,128,9943,1,57829,29328,29127
11105042,11105031,TXFE7,128,9942,1,57830,29329,29128
11105442,11105442,TXFE7,128,9943,1,57831,29330,29129
11105854,11105847,TXFE7,128,9943,1,57832,29331,29130
11110054,11110053,TXFE7,128,9943,1,57833,29332,29131
11110067,11110066,TXFE7,128,9943,1,57834,29333,29132
11110079,11110077,TXFE7,128,9942,2,57836,29335,29133
11110104,11110099,TXFE7,128,9943,2,57838,29336,29134
11110167,11110159,TXFE7,128,9942,1,57839,29337,29135
11110229,11110221,TXFE7,128,9942,2,57841,29338,29136
11111067,11111056,TXFE7,128,9943,5,57846,29339,29141
11111079,11111067,TXFE7,128,9943,4,57850,29340,29144
11111117,11111110,TXFE7,128,9943,2,57852,29341,29146
11111304,11111296,TXFE7,128,9943,3,57855,29342,29149
11111367,11111364,TXFE7,128,9943,1,57856,29343,29150
11111679,11111678,TXFE7,128,9942,1,57857,29344,29151
11111679,11111679,TXFE7,128,9942,1,57858,29345,29152
11112979,11112979,TXFE7,128,9942,1,57859,29346,29153
11113442,11113432,TXFE7,128,9942,1,57860,29347,29154
11114204,11114196,TXFE7,128,9942,1,57861,29348,29155
11114804,11114802,TXFE7,128,9943,2,57863,29349,29156
11120192,11120188,TXFE7,128,9942,1,57864,29350,29157
11120204,11120202,TXFE7,128,9942,1,57865,29351,29158
11120204,11120202,TXFE7,128,9942,1,57866,29352,29159
11120292,11120290,TXFE7,128,9942,1,57867,29353,29160
11120429,11120421,TXFE7,128,9942,5,57872,29354,29161
11120979,11120969,TXFE7,128,9943,2,57874,29355,29163
11121667,11121666,TXFE7,128,9943,1,57875,29356,29164
11122504,11122495,TXFE7,128,9942,7,57882,29362,29165
11123342,11123340,TXFE7,128,9943,1,57883,29363,29166
11123504,11123494,TXFE7,128,9942,1,57884,29364,29167
11123504,11123497,TXFE7,128,9942,1,57885,29365,29168
11123554,11123549,TXFE7,128,9942,1,57886,29366,29169
11123554,11123550,TXFE7,128,9942,1,57887,29367,29170
11123917,11123914,TXFE7,128,9942,1,57888,29368,29171
11124242,11124230,TXFE7,128,9942,1,57889,29369,29172
11124342,11124329,TXFE7,128,9942,5,57894,29372,29173
11124492,11124481,TXFE7,128,9942,3,57897,29375,29174
11124567,11124562,TXFE7,128,9942,2,57899,29377,29175
11124592,11124587,TXFE7,128,9942,1,57900,29378,29176
11124979,11124976,TXFE7,128,9943,1,57901,29379,29177
11125142,11125139,TXFE7,128,9942,1,57902,29380,29178
11125354,11125351,TXFE7,128,9943,1,57903,29381,29179
11125392,11125383,TXFE7,128,9943,1,57904,29382,29180
11125467,11125460,TXFE7,128,9943,1,57905,29383,29181
11125592,11125584,TXFE7,128,9943,2,57907,29384,29183
11125804,11125799,TXFE7,128,9943,1,57908,29385,29184
11125904,11125897,TXFE7,128,9943,2,57910,29386,29186
11130079,11130073,TXFE7,128,9942,1,57911,29387,29187
11130092,11130092,TXFE7,128,9943,1,57912,29388,29188
11130154,11130152,TXFE7,128,9943,1,57913,29389,29189
11130192,11130181,TXFE7,128,9943,2,57915,29390,29191
11130192,11130191,TXFE7,128,9943,2,57917,29391,29193
11130217,11130213,TXFE7,128,9943,1,57918,29392,29194
11130342,11130340,TXFE7,128,9943,1,57919,29393,29195
11130967,11130959,TXFE7,128,9943,25,57944,29394,29210
11131504,11131502,TXFE7,128,9944,1,57945,29395,29211
11131567,11131558,TXFE7,128,9943,1,57946,29396,29212
11131604,11131594,TXFE7,128,9944,5,57951,29397,29216
11131779,11131772,TXFE7,128,9944,4,57955,29398,29218
11131779,11131772,TXFE7,128,9944,2,57957,29399,29219
11131779,11131772,TXFE7,128,9944,2,57959,29400,29220
11131779,11131772,TXFE7,128,9944,1,57960,29401,29221
11131779,11131773,TXFE7,128,9944,6,57966,29402,29225
11131779,11131773,TXFE7,128,9944,2,57968,29403,29227
11131792,11131779,TXFE7,128,9944,2,57970,29404,29228
11131792,11131779,TXFE7,128,9944,2,57972,29405,29229
11131792,11131779,TXFE7,128,9944,4,57976,29406,29233
11131792,11131779,TXFE7,128,9944,1,57977,29407,29234
11131842,11131830,TXFE7,128,9944,2,57979,29408,29235
11131892,11131888,TXFE7,128,9944,1,57980,29409,29236
11131954,11131950,TXFE7,128,9943,1,57981,29410,29237
11131992,11131981,TXFE7,128,9943,1,57982,29411,29238
11132029,11132020,TXFE7,128,9944,1,57983,29412,29239
11132104,11132102,TXFE7,128,9944,1,57984,29413,29240
11132242,11132230,TXFE7,128,9944,4,57988,29414,29241
11132292,11132288,TXFE7,128,9944,1,57989,29415,29242
11132304,11132294,TXFE7,128,9944,1,57990,29416,29243
11132304,11132295,TXFE7,128,9944,1,57991,29417,29244
11132304,11132298,TXFE7,128,9944,1,57992,29418,29245
11132317,11132304,TXFE7,128,9944,1,57993,29419,29246
11132317,11132304,TXFE7,128,9944,1,57994,29420,29247
11132317,11132304,TXFE7,128,9944,1,57995,29421,29248
11132367,11132362,TXFE7,128,9944,2,57997,29422,29249
11132392,11132389,TXFE7,128,9944,2,57999,29423,29250
11132604,11132597,TXFE7,128,9944,3,58002,29425,29251
11132954,11132951,TXFE7,128,9944,1,58003,29426,29252
11133042,11133038,TXFE7,128,9944,1,58004,29427,29253
11133304,11133297,TXFE7,128,9944,10,58014,29430,29254
11133479,11133469,TXFE7,128,9945,2,58016,29431,29255
11133504,11133496,TXFE7,128,9945,2,58018,29432,29257
11133529,11133522,TXFE7,128,9944,1,58019,29433,29258
11133554,11133550,TXFE7,128,9944,1,58020,29434,29259
11133904,11133897,TXFE7,128,9944,20,58040,29442,29260
11133979,11133974,TXFE7,128,9944,3,58043,29443,29261
11134079,11134067,TXFE7,128,9944,1,58044,29444,29262
11134117,11134111,TXFE7,128,9944,8,58052,29446,29263
11134117,11134111,TXFE7,128,9944,2,58054,29447,29264
11134217,11134204,TXFE7,128,9944,2,58056,29449,29266
11134592,11134580,TXFE7,128,9944,1,58057,29450,29267
11134729,11134719,TXFE7,128,9945,1,58058,29451,29268
11135017,11135008,TXFE7,128,9945,1,58059,29452,29269
11135204,11135203,TXFE7,128,9944,1,58060,29453,29270
11135267,11135262,TXFE7,128,9945,1,58061,29454,29271
11135467,11135465,TXFE7,128,9944,5,58066,29456,29272
11135629,11135620,TXFE7,128,9945,2,58068,29457,29274
11140129,11140123,TXFE7,128,9945,1,58069,29458,29275
11140142,11140142,TXFE7,128,9945,1,58070,29459,29276
11140167,11140158,TXFE7,128,9945,2,58072,29460,29277
11140167,11140164,TXFE7,128,9945,2,58074,29461,29278
11140204,11140192,TXFE7,128,9945,89,58163,29462,29342
11140379,11140367,TXFE7,128,9946,1,58164,29463,29343
11140392,11140388,TXFE7,128,9946,5,58169,29464,29346
11140417,11140412,TXFE7,128,9946,1,58170,29465,29347
11140454,11140454,TXFE7,128,9946,5,58175,29466,29349
11140479,11140468,TXFE7,128,9946,6,58181,29467,29350
11140492,11140479,TXFE7,128,9946,2,58183,29468,29351
11140517,11140506,TXFE7,128,9946,1,58184,29469,29352
11140579,11140572,TXFE7,128,9946,1,58185,29470,29353
11140592,11140580,TXFE7,128,9946,5,58190,29471,29357
11140604,11140592,TXFE7,128,9946,1,58191,29472,29358
11140892,11140887,TXFE7,128,9946,2,58193,29473,29359
11140904,11140901,TXFE7,128,9945,4,58197,29474,29360
11140967,11140963,TXFE7,128,9945,10,58207,29478,29361
11141279,11141267,TXFE7,128,9945,3,58210,29481,29362
11141279,11141267,TXFE7,128,9945,1,58211,29482,29363
11141279,11141267,TXFE7,128,9945,2,58213,29483,29364
11141279,11141269,TXFE7,128,9945,4,58217,29484,29365
11141292,11141279,TXFE7,128,9945,1,58218,29485,29366
11141292,11141279,TXFE7,128,9945,1,58219,29486,29367
11141292,11141279,TXFE7,128,9945,2,58221,29487,29368
11141292,11141279,TXFE7,128,9945,3,58224,29488,29369
11141292,11141279,TXFE7,128,9945,4,58228,29489,29370
11141304,11141292,TXFE7,128,9945,2,58230,29491,29371
11141804,11141799,TXFE7,128,9945,5,58235,29492,29372
11141967,11141961,TXFE7,128,9945,2,58237,29493,29373
11141992,11141986,TXFE7,128,9945,1,58238,29494,29374
11142179,11142177,TXFE7,128,9944,5,58243,29496,29375
11142329,11142319,TXFE7,128,9945,1,58244,29497,29376
11142329,11142328,TXFE7,128,9945,5,58249,29498,29380
11142529,11142520,TXFE7,128,9944,1,58250,29499,29381
11143104,11143101,TXFE7,128,9945,1,58251,29500,29382
11143142,11143130,TXFE7,128,9945,1,58252,29501,29383
11143179,11143179,TXFE7,128,9944,10,58262,29504,29384
11143217,11143213,TXFE7,128,9945,2,58264,29505,29386
11143292,11143280,TXFE7,128,9944,10,58274,29513,29387
11143304,11143304,TXFE7,128,9945,1,58275,29514,29388
11143517,11143511,TXFE7,128,9944,5,58280,29515,29389
11144242,11144235,TXFE7,128,9945,1,58281,29516,29390
11144654,11144651,TXFE7,128,9945,4,58285,29517,29392
11144679,11144673,TXFE7,128,9945,4,58289,29518,29396
11144692,11144679,TXFE7,128,9945,4,58293,29519,29400
11145042,11145031,TXFE7,128,9945,2,58295,29520,29402
11145104,11145095,TXFE7,128,9945,6,58301,29521,29407
11145117,11145104,TXFE7,128,9945,1,58302,29522,29408
11145154,11145142,TXFE7,128,9945,1,58303,29523,29409
11145204,11145193,TXFE7,128,9944,4,58307,29526,29410
11145254,11145245,TXFE7,128,9945,1,58308,29527,29411
11145604,11145601,TXFE7,128,9946,1,58309,29528,29412
11145617,11145616,TXFE7,128,9946,3,58312,29529,29415
11145667,11145654,TXFE7,128,9945,7,58319,29530,29416
11145692,11145683,TXFE7,128,9945,1,58320,29531,29417
11145692,11145688,TXFE7,128,9945,1,58321,29532,29418
11145704,11145695,TXFE7,128,9945,1,58322,29533,29419
11145817,11145809,TXFE7,128,9945,1,58323,29534,29420
11150154,11150145,TXFE7,128,9945,1,58324,29535,29421
11150192,11150188,TXFE7,128,9946,4,58328,29536,29422
11150204,11150199,TXFE7,128,9946,3,58331,29537,29425
11150204,11150200,TXFE7,128,9946,8,58339,29538,29429
11150217,11150205,TXFE7,128,9946,12,58351,29539,29438
11150217,11150209,TXFE7,128,9946,1,58352,29540,29439
11150217,11150209,TXFE7,128,9946,4,58356,29541,29441
11150217,11150209,TXFE7,128,9946,1,58357,29542,29442
11150217,11150209,TXFE7,128,9946,2,58359,29543,29443
11150217,11150209,TXFE7,128,9946,1,58360,29544,29444
11150217,11150209,TXFE7,128,9946,1,58361,29545,29445
11150217,11150212,TXFE7,128,9946,6,58367,29546,29450
11150217,11150212,TXFE7,128,9946,2,58369,29547,29452
11150229,11150217,TXFE7,128,9946,3,58372,29548,29455
11150229,11150217,TXFE7,128,9946,2,58374,29549,29456
11150229,11150217,TXFE7,128,9946,2,58376,29550,29457
11150229,11150217,TXFE7,128,9946,4,58380,29551,29458
11150229,11150217,TXFE7,128,9946,1,58381,29552,29459
11150229,11150217,TXFE7,128,9946,2,58383,29553,29460
11150229,11150217,TXFE7,128,9946,1,58384,29554,29461
11150229,11150217,TXFE7,128,9946,1,58385,29555,29462
11150229,11150217,TXFE7,128,9946,14,58399,29556,29470
11150229,11150220,TXFE7,128,9947,8,58407,29557,29473
11150229,11150228,TXFE7,128,9947,10,58417,29558,29480
11150242,11150237,TXFE7,128,9947,2,58419,29559,29482
11150242,11150238,TXFE7,128,9947,1,58420,29560,29483
11150254,11150252,TXFE7,128,9947,7,58427,29561,29484
11150267,11150260,TXFE7,128,9947,2,58429,29562,29485
11150267,11150263,TXFE7,128,9947,7,58436,29563,29486
11150267,11150263,TXFE7,128,9947,1,58437,29564,29487
11150267,11150266,TXFE7,128,9947,1,58438,29565,29488
11150292,11150287,TXFE7,128,9946,1,58439,29566,29489
11150317,11150306,TXFE7,128,9946,1,58440,29567,29490
11150317,11150308,TXFE7,128,9947,4,58444,29568,29491
11150342,11150330,TXFE7,128,9946,1,58445,29569,29492
11150342,11150335,TXFE7,128,9946,2,58447,29570,29493
11150429,11150429,TXFE7,128,9946,1,58448,29571,29494
11150579,11150567,TXFE7,128,9947,2,58450,29572,29495
11150592,11150590,TXFE7,128,9946,1,58451,29573,29496
11150754,11150745,TXFE7,128,9946,1,58452,29574,29497
11150804,11150793,TXFE7,128,9947,2,58454,29575,29498
11150804,11150798,TXFE7,128,9947,2,58456,29576,29499
11150817,11150804,TXFE7,128,9947,1,58457,29577,29500
11150817,11150805,TXFE7,128,9947,2,58459,29578,29502
11150867,11150859,TXFE7,128,9946,1,58460,29579,29503
11150904,11150904,TXFE7,128,9947,1,58461,29580,29504
11150942,11150937,TXFE7,128,9947,1,58462,29581,29505
11150954,11150945,TXFE7,128,9947,2,58464,29582,29506
11151004,11151002,TXFE7,128,9947,4,58468,29583,29507
11151067,11151062,TXFE7,128,9947,10,58478,29584,29514
11151092,11151085,TXFE7,128,9947,1,58479,29585,29515
11151129,11151125,TXFE7,128,9947,1,58480,29586,29516
11151129,11151129,TXFE7,128,9947,1,58481,29587,29517
11151229,11151220,TXFE7,128,9946,20,58501,29595,29518
11151317,11151315,TXFE7,128,9947,40,58541,29596,29524
11151467,11151461,TXFE7,128,9947,4,58545,29597,29527
11151554,11151545,TXFE7,128,9947,1,58546,29598,29528
11151804,11151799,TXFE7,128,9947,4,58550,29599,29532
11152117,11152117,TXFE7,128,9947,1,58551,29600,29533
11152304,11152293,TXFE7,128,9946,1,58552,29601,29534
11152592,11152585,TXFE7,128,9946,2,58554,29602,29535
11152692,11152691,TXFE7,128,9947,1,58555,29603,29536
11152717,11152712,TXFE7,128,9947,1,58556,29604,29537
11152754,11152753,TXFE7,128,9947,2,58558,29605,29538
11152767,11152765,TXFE7,128,9947,2,58560,29606,29539
11152892,11152883,TXFE7,128,9946,1,58561,29607,29540
11153004,11152996,TXFE7,128,9947,1,58562,29608,29541
11153017,11153016,TXFE7,128,9947,1,58563,29609,29542
11153042,11153040,TXFE7,128,9947,1,58564,29610,29543
11153504,11153497,TXFE7,128,9947,1,58565,29611,29544
11153504,11153498,TXFE7,128,9947,2,58567,29612,29545
11153542,11153539,TXFE7,128,9946,1,58568,29613,29546
11153642,11153639,TXFE7,128,9947,1,58569,29614,29547
11153829,11153824,TXFE7,128,9946,2,58571,29616,29548
11153929,11153925,TXFE7,128,9947,1,58572,29617,29549
11154117,11154106,TXFE7,128,9947,1,58573,29618,29550
11154129,11154119,TXFE7,128,9946,2,58575,29619,29551
11154129,11154128,TXFE7,128,9947,3,58578,29620,29554
11154154,11154142,TXFE7,128,9947,7,58585,29621,29558
11154154,11154143,TXFE7,128,9947,6,58591,29622,29562
11154167,11154155,TXFE7,128,9947,1,58592,29623,29563
11154204,11154193,TXFE7,128,9947,2,58594,29624,29565
11154504,11154500,TXFE7,128,9947,1,58595,29625,29566
11154967,11154961,TXFE7,128,9947,1,58597,29627,29568
11155254,11155244,TXFE7,128,9947,1,58598,29628,29569
11155292,11155289,TXFE7,128,9947,2,58600,29629,29570
11155442,11155437,TXFE7,128,9947,1,58601,29630,29571
11155592,11155589,TXFE7,128,9947,5,58606,29631,29573
11155604,11155598,TXFE7,128,9946,5,58611,29635,29574
11155604,11155600,TXFE7,128,9946,1,58612,29636,29575
11160004,11160003,TXFE7,128,9947,1,58613,29637,29576
11160079,11160068,TXFE7,128,9947,5,58618,29638,29581
11160217,11160207,TXFE7,128,9946,1,58619,29639,29582
11160267,11160257,TXFE7,128,9947,2,58621,29640,29584
11160367,11160361,TXFE7,128,9947,1,58622,29641,29585
11160404,11160398,TXFE7,128,9947,2,58624,29642,29586
11160442,11160438,TXFE7,128,9947,1,58625,29643,29587
11160617,11160608,TXFE7,128,9947,5,58630,29644,29589
11160679,11160668,TXFE7,128,9947,10,58640,29645,29598
11160717,11160716,TXFE7,128,9947,1,58641,29646,29599
11160729,11160717,TXFE7,128,9947,38,58679,29647,29626
11160729,11160727,TXFE7,128,9948,1,58680,29648,29627
11160742,11160730,TXFE7,128,9948,5,58685,29649,29630
11160742,11160732,TXFE7,128,9948,4,58689,29650,29632
11160742,11160733,TXFE7,128,9948,1,58690,29651,29633
11160742,11160733,TXFE7,128,9948,2,58692,29652,29635
11160742,11160734,TXFE7,128,9948,1,58693,29653,29636
11160742,11160734,TXFE7,128,9948,3,58696,29654,29639
11160742,11160734,TXFE7,128,9948,1,58697,29655,29640
11160742,11160735,TXFE7,128,9948,2,58699,29656,29642
11160742,11160736,TXFE7,128,9948,1,58700,29657,29643
11160742,11160736,TXFE7,128,9948,2,58702,29658,29645
11160742,11160737,TXFE7,128,9948,2,58704,29659,29647
11160742,11160738,TXFE7,128,9948,2,58706,29660,29648
11160742,11160740,TXFE7,128,9947,1,58707,29661,29649
11160742,11160741,TXFE7,128,9948,2,58709,29662,29650
11160754,11160746,TXFE7,128,9948,1,58710,29663,29651
11160754,11160749,TXFE7,128,9948,2,58712,29664,29653
11160754,11160752,TXFE7,128,9948,2,58714,29665,29655
11160767,11160761,TXFE7,128,9948,1,58715,29666,29656
11160767,11160765,TXFE7,128,9948,4,58719,29667,29659
11160767,11160766,TXFE7,128,9948,10,58729,29668,29663
11160779,11160767,TXFE7,128,9948,1,58730,29669,29664
11160779,11160768,TXFE7,128,9948,10,58740,29670,29671
11160779,11160769,TXFE7,128,9948,2,58742,29671,29673
11160779,11160771,TXFE7,128,9948,6,58748,29672,29678
11160779,11160773,TXFE7,128,9948,3,58751,29673,29680
11160779,11160774,TXFE7,128,9948,1,58752,29674,29681
11160792,11160780,TXFE7,128,9948,18,58770,29675,29696
11160792,11160780,TXFE7,128,9948,18,58788,29676,29711
11160792,11160780,TXFE7,128,9948,6,58794,29677,29714
11160792,11160780,TXFE7,128,9948,18,58812,29678,29729
11160792,11160780,TXFE7,128,9948,18,58830,29679,29731
11160792,11160782,TXFE7,128,9948,18,58848,29680,29735
11160792,11160785,TXFE7,128,9948,4,58852,29681,29738
11160804,11160792,TXFE7,128,9949,2,58854,29682,29739
11160804,11160792,TXFE7,128,9949,7,58861,29683,29743
11160804,11160794,TXFE7,128,9949,4,58865,29684,29745
11160804,11160797,TXFE7,128,9949,2,58867,29685,29746
11160817,11160805,TXFE7,128,9949,19,58886,29686,29763
11160817,11160805,TXFE7,128,9949,2,58888,29687,29765
11160817,11160806,TXFE7,128,9949,5,58893,29688,29770
11160817,11160806,TXFE7,128,9949,2,58895,29689,29771
11160817,11160807,TXFE7,128,9949,1,58896,29690,29772
11160817,11160807,TXFE7,128,9949,39,58935,29691,29792
11160817,11160808,TXFE7,128,9949,4,58939,29692,29795
11160817,11160809,TXFE7,128,9949,1,58940,29693,29796
11160817,11160809,TXFE7,128,9949,1,58941,29694,29797
11160817,11160809,TXFE7,128,9949,1,58942,29695,29798
11160817,11160810,TXFE7,128,9949,1,58943,29696,29799
11160817,11160811,TXFE7,128,9949,1,58944,29697,29800
11160817,11160811,TXFE7,128,9949,1,58945,29698,29801
11160817,11160811,TXFE7,128,9949,1,58946,29699,29802
11160817,11160812,TXFE7,128,9949,1,58947,29700,29803
11160817,11160814,TXFE7,128,9949,6,58953,29701,29809
11160817,11160814,TXFE7,128,9949,5,58958,29702,29812
11160817,11160814,TXFE7,128,9949,1,58959,29703,29813
11160817,11160816,TXFE7,128,9949,1,58960,29704,29814
11160829,11160817,TXFE7,128,9949,1,58961,29705,29815
11160829,11160817,TXFE7,128,9949,5,58966,29706,29816
11160829,11160818,TXFE7,128,9949,1,58967,29707,29817
11160829,11160820,TXFE7,128,9949,8,58975,29708,29818
11160829,11160820,TXFE7,128,9949,1,58976,29709,29819
11160829,11160821,TXFE7,128,9949,2,58978,29710,29820
11160829,11160822,TXFE7,128,9949,4,58982,29711,29821
11160829,11160822,TXFE7,128,9949,1,58983,29712,29822
11160829,11160823,TXFE7,128,9949,4,58987,29713,29826
11160829,11160825,TXFE7,128,9949,1,58988,29714,29827
11160829,11160825,TXFE7,128,9949,1,58989,29715,29828
11160829,11160827,TXFE7,128,9949,1,58990,29716,29829
11160829,11160828,TXFE7,128,9949,4,58994,29717,29831
11160829,11160829,TXFE7,128,9948,5,58999,29720,29832
11160842,11160834,TXFE7,128,9949,4,59003,29721,29835
11160842,11160835,TXFE7,128,9949,1,59004,29722,29836
11160842,11160836,TXFE7,128,9949,2,59006,29723,29837
11160842,11160836,TXFE7,128,9949,1,59007,29724,29838
11160842,11160839,TXFE7,129,9949,2,59011,29725,29841
11160842,11160839,TXFE7,129,9950,2,59011,29725,29841
11160842,11160841,TXFE7,128,9949,2,59013,29726,29842
11160854,11160843,TXFE7,128,9949,3,59016,29727,29844
11160854,11160843,TXFE7,128,9949,1,59017,29728,29845
11160854,11160843,TXFE7,128,9949,1,59018,29729,29846
11160854,11160843,TXFE7,128,9949,2,59020,29730,29847
11160854,11160847,TXFE7,128,9949,1,59021,29731,29848
11160854,11160848,TXFE7,128,9949,1,59022,29732,29849
11160854,11160849,TXFE7,128,9949,1,59023,29733,29850
11160854,11160849,TXFE7,128,9949,1,59024,29734,29851
11160854,11160853,TXFE7,128,9949,1,59025,29735,29852
11160867,11160858,TXFE7,128,9948,1,59026,29736,29853
11160867,11160859,TXFE7,128,9949,1,59027,29737,29854
11160867,11160863,TXFE7,128,9949,1,59028,29738,29855
11160867,11160865,TXFE7,128,9949,6,59034,29739,29857
11160879,11160868,TXFE7,128,9949,1,59035,29740,29858
11160879,11160870,TXFE7,128,9949,1,59036,29741,29859
11160879,11160871,TXFE7,128,9949,1,59037,29742,29860
11160879,11160872,TXFE7,128,9950,3,59040,29743,29862
11160879,11160872,TXFE7,128,9948,1,59041,29744,29863
11160879,11160873,TXFE7,128,9950,1,59042,29745,29864
11160879,11160874,TXFE7,128,9948,1,59043,29746,29865
11160879,11160876,TXFE7,128,9950,1,59044,29747,29866
11160879,11160877,TXFE7,128,9950,1,59045,29748,29867
11160879,11160878,TXFE7,128,9950,12,59057,29749,29877
11160892,11160879,TXFE7,128,9949,2,59059,29750,29878
11160892,11160879,TXFE7,128,9949,4,59063,29751,29879
11160892,11160881,TXFE7,128,9950,1,59064,29752,29880
11160892,11160882,TXFE7,128,9950,1,59065,29753,29881
11160892,11160883,TXFE7,128,9950,1,59066,29754,29882
11160892,11160887,TXFE7,128,9950,1,59067,29755,29883
11160892,11160888,TXFE7,128,9950,6,59073,29756,29888
11160892,11160888,TXFE7,128,9950,3,59076,29757,29891
11160892,11160888,TXFE7,128,9948,1,59077,29758,29892
11160892,11160891,TXFE7,128,9950,2,59079,29759,29894
11160904,11160896,TXFE7,128,9949,1,59080,29760,29895
11160904,11160898,TXFE7,128,9950,6,59086,29761,29899
11160904,11160900,TXFE7,128,9950,5,59091,29762,29904
11160929,11160917,TXFE7,128,9949,1,59092,29763,29905
11160929,11160917,TXFE7,128,9948,4,59096,29766,29906
11160929,11160923,TXFE7,128,9949,1,59097,29767,29907
11160929,11160924,TXFE7,128,9949,2,59099,29768,29908
11160929,11160925,TXFE7,128,9949,2,59101,29769,29910
11160929,11160926,TXFE7,128,9950,2,59103,29770,29912
11160929,11160927,TXFE7,128,9950,9,59112,29771,29921
11160942,11160937,TXFE7,128,9948,1,59113,29772,29922
11160954,11160950,TXFE7,128,9949,1,59114,29773,29923
11160967,11160955,TXFE7,128,9949,4,59118,29774,29924
11160967,11160963,TXFE7,128,9949,8,59126,29775,29928
11160967,11160966,TXFE7,129,9949,2,59136,29776,29930
11160967,11160966,TXFE7,129,9950,8,59136,29776,29930
11160979,11160976,TXFE7,128,9948,3,59139,29777,29931
11160979,11160977,TXFE7,128,9950,2,59141,29778,29933
11160979,11160978,TXFE7,128,9950,1,59142,29779,29934
11160992,11160979,TXFE7,128,9950,1,59143,29780,29935
11160992,11160983,TXFE7,128,9949,1,59144,29781,29936
11160992,11160987,TXFE7,129,9949,1,59147,29782,29939
11160992,11160987,TXFE7,129,9950,2,59147,29782,29939
11161004,11160995,TXFE7,128,9948,1,59148,29783,29940
11161017,11161011,TXFE7,128,9949,1,59149,29784,29941
11161029,11161018,TXFE7,128,9949,17,59166,29785,29945
11161029,11161019,TXFE7,129,9949,10,59179,29786,29952
11161029,11161019,TXFE7,129,9950,3,59179,29786,29952
11161029,11161020,TXFE7,128,9948,27,59206,29798,29953
11161029,11161020,TXFE7,128,9948,6,59212,29803,29954
11161029,11161027,TXFE7,129,9949,1,59248,29804,29977
11161029,11161027,TXFE7,129,9950,35,59248,29804,29977
11161042,11161031,TXFE7,129,9949,1,59272,29805,29990
11161042,11161031,TXFE7,129,9950,23,59272,29805,29990
11161042,11161034,TXFE7,128,9950,17,59289,29806,30004
11161054,11161048,TXFE7,128,9950,6,59295,29807,30007
11161067,11161054,TXFE7,128,9950,1,59296,29808,30008
11161067,11161066,TXFE7,128,9949,1,59297,29809,30009
11161067,11161066,TXFE7,128,9950,1,59298,29810,30010
11161067,11161066,TXFE7,128,9950,1,59299,29811,30011
11161079,11161067,TXFE7,128,9949,7,59306,29814,30012
11161079,11161068,TXFE7,128,9950,1,59307,29815,30013
11161079,11161068,TXFE7,128,9950,1,59308,29816,30014
11161079,11161071,TXFE7,128,9950,1,59309,29817,30015
11161079,11161072,TXFE7,128,9950,1,59310,29818,30016
11161079,11161073,TXFE7,128,9950,1,59311,29819,30017
11161079,11161073,TXFE7,128,9950,8,59319,29820,30024
11161079,11161074,TXFE7,128,9950,1,59320,29821,30025
11161079,11161074,TXFE7,128,9950,1,59321,29822,30026
11161079,11161077,TXFE7,128,9950,1,59322,29823,30027
11161079,11161079,TXFE7,128,9950,1,59323,29824,30028
11161092,11161080,TXFE7,128,9950,1,59324,29825,30029
11161092,11161081,TXFE7,128,9950,1,59325,29826,30030
11161092,11161084,TXFE7,128,9949,2,59327,29827,30031
11161092,11161091,TXFE7,128,9950,4,59331,29828,30035
11161104,11161096,TXFE7,128,9949,3,59334,29830,30036
11161104,11161104,TXFE7,128,9949,5,59339,29832,30037
11161117,11161109,TXFE7,128,9950,2,59341,29833,30038
11161142,11161134,TXFE7,128,9950,2,59343,29834,30040
11161142,11161137,TXFE7,128,9950,10,59353,29835,30050
11161179,11161176,TXFE7,128,9950,1,59354,29836,30051
11161192,11161182,TXFE7,128,9950,2,59356,29837,30052
11161192,11161190,TXFE7,128,9950,5,59361,29838,30056
11161204,11161200,TXFE7,128,9949,1,59362,29839,30057
11161217,11161210,TXFE7,128,9949,3,59365,29842,30058
11161229,11161226,TXFE7,129,9949,9,59375,29843,30062
11161229,11161226,TXFE7,129,9950,1,59375,29843,30062
11161242,11161240,TXFE7,128,9949,1,59376,29844,30063
11161242,11161241,TXFE7,128,9950,2,59378,29845,30064
11161254,11161247,TXFE7,128,9949,1,59379,29846,30065
11161254,11161254,TXFE7,128,9950,1,59380,29847,30066
11161267,11161262,TXFE7,128,9948,2,59382,29848,30067
11161267,11161265,TXFE7,128,9950,2,59384,29849,30068
11161279,11161273,TXFE7,128,9949,1,59385,29850,30069
11161279,11161275,TXFE7,128,9950,2,59387,29851,30070
11161329,11161317,TXFE7,128,9948,1,59388,29852,30071
11161329,11161324,TXFE7,128,9948,1,59389,29853,30072
11161354,11161354,TXFE7,128,9948,2,59391,29854,30073
11161367,11161365,TXFE7,128,9948,2,59393,29855,30074
11161392,11161389,TXFE7,128,9949,1,59394,29856,30075
11161417,11161405,TXFE7,128,9948,12,59406,29864,30076
11161467,11161456,TXFE7,128,9947,1,59407,29865,30077
11161504,11161496,TXFE7,128,9948,5,59412,29866,30078
11161517,11161514,TXFE7,128,9948,1,59413,29867,30079
11161529,11161521,TXFE7,128,9948,1,59414,29868,30080
11161529,11161525,TXFE7,128,9948,4,59418,29869,30081
11161542,11161539,TXFE7,128,9948,2,59420,29870,30083
11161567,11161555,TXFE7,128,9948,1,59421,29871,30084
11161567,11161559,TXFE7,128,9948,1,59422,29872,30085
11161579,11161571,TXFE7,128,9948,1,59423,29873,30086
11161579,11161571,TXFE7,128,9948,1,59424,29874,30087
11161604,11161593,TXFE7,128,9948,1,59425,29875,30088
11161629,11161623,TXFE7,128,9948,5,59430,29876,30089
11161629,11161625,TXFE7,128,9948,1,59431,29877,30090
11161642,11161631,TXFE7,128,9948,2,59433,29878,30092
11161654,11161653,TXFE7,128,9947,1,59434,29879,30093
11161692,11161692,TXFE7,129,9948,8,59448,29880,30099
11161692,11161692,TXFE7,129,9949,6,59448,29880,30099
11161717,11161705,TXFE7,128,9949,1,59449,29881,30100
11161729,11161717,TXFE7,128,9948,1,59450,29882,30101
11161767,11161755,TXFE7,128,9948,2,59452,29884,30102
11161792,11161788,TXFE7,128,9948,1,59453,29885,30103
11161792,11161789,TXFE7,128,9949,5,59458,29886,30105
11161829,11161821,TXFE7,128,9948,1,59459,29887,30106
11161854,11161842,TXFE7,128,9948,10,59469,29888,30107
11161879,11161867,TXFE7,128,9948,1,59470,29889,30108
11161879,11161877,TXFE7,128,9949,1,59471,29890,30109
11161892,11161881,TXFE7,128,9949,2,59473,29891,30111
11161979,11161972,TXFE7,128,9949,1,59474,29892,30112
11161979,11161972,TXFE7,128,9949,1,59475,29893,30113
11162217,11162211,TXFE7,128,9948,5,59480,29895,30114
11162229,11162220,TXFE7,128,9948,1,59481,29896,30115
11162229,11162222,TXFE7,128,9948,14,59495,29905,30116
11162254,11162248,TXFE7,128,9948,2,59497,29906,30118
11162279,11162270,TXFE7,128,9948,2,59499,29907,30119
11162317,11162315,TXFE7,128,9947,5,59504,29908,30120
11162329,11162322,TXFE7,128,9948,2,59506,29909,30121
11162329,11162329,TXFE7,128,9948,5,59511,29910,30125
11162454,11162447,TXFE7,128,9947,1,59512,29911,30126
11162504,11162492,TXFE7,128,9948,6,59518,29912,30128
11162504,11162496,TXFE7,128,9948,2,59520,29913,30130
11162504,11162497,TXFE7,128,9948,2,59522,29914,30131
11162504,11162498,TXFE7,128,9948,2,59524,29915,30133
11162504,11162499,TXFE7,128,9948,2,59526,29916,30135
11162504,11162500,TXFE7,128,9948,2,59528,29917,30136
11162504,11162500,TXFE7,128,9948,2,59530,29918,30137
11162504,11162502,TXFE7,128,9948,2,59532,29919,30138
11162504,11162503,TXFE7,128,9948,2,59534,29920,30139
11162504,11162504,TXFE7,128,9948,2,59536,29921,30140
11162542,11162539,TXFE7,128,9947,2,59538,29922,30141
11162742,11162737,TXFE7,128,9947,1,59539,29923,30142
11162742,11162741,TXFE7,128,9947,2,59541,29925,30143
11162779,11162770,TXFE7,128,9947,2,59543,29926,30144
11162804,11162798,TXFE7,128,9947,10,59553,29930,30145
11162804,11162801,TXFE7,128,9947,1,59554,29931,30146
11162817,11162804,TXFE7,128,9947,4,59558,29934,30147
11162817,11162804,TXFE7,128,9947,4,59562,29938,30148
11162817,11162805,TXFE7,128,9947,11,59573,29948,30149
11162829,11162824,TXFE7,128,9947,1,59574,29949,30150
11162829,11162826,TXFE7,128,9947,1,59575,29950,30151
11162879,11162874,TXFE7,128,9946,2,59577,29952,30152
11162929,11162925,TXFE7,128,9947,1,59578,29953,30153
11162942,11162931,TXFE7,128,9947,1,59579,29954,30154
11162967,11162960,TXFE7,128,9947,1,59580,29955,30155
11163004,11163003,TXFE7,128,9948,2,59582,29956,30156
11163004,11163003,TXFE7,128,9948,2,59584,29957,30157
11163017,11163005,TXFE7,128,9948,2,59586,29958,30158
11163229,11163217,TXFE7,128,9947,10,59596,29962,30159
11163229,11163229,TXFE7,128,9948,2,59598,29963,30161
11163242,11163230,TXFE7,128,9947,1,59599,29964,30162
11163267,11163265,TXFE7,128,9948,1,59600,29965,30163
11163442,11163439,TXFE7,128,9947,1,59601,29966,30164
11163479,11163473,TXFE7,128,9947,2,59603,29968,30165
11163492,11163484,TXFE7,128,9947,1,59604,29969,30166
11163492,11163484,TXFE7,128,9947,1,59605,29970,30167
11163529,11163526,TXFE7,128,9948,1,59606,29971,30168
11163579,11163571,TXFE7,128,9947,1,59607,29972,30169
11163642,11163636,TXFE7,128,9948,1,59608,29973,30170
11163654,11163644,TXFE7,128,9947,1,59609,29974,30171
11163717,11163712,TXFE7,128,9948,14,59623,29975,30175
11163804,11163792,TXFE7,128,9947,4,59627,29979,30176
11163954,11163945,TXFE7,128,9947,1,59628,29980,30177
11163954,11163946,TXFE7,128,9947,10,59638,29981,30180
11163992,11163990,TXFE7,128,9947,1,59639,29982,30181
11164267,11164263,TXFE7,128,9947,1,59640,29983,30182
11164267,11164264,TXFE7,128,9947,1,59641,29984,30183
11164329,11164319,TXFE7,128,9947,3,59644,29985,30186
11164379,11164369,TXFE7,128,9947,1,59645,29986,30187
11164379,11164370,TXFE7,128,9947,1,59646,29987,30188
11164479,11164477,TXFE7,128,9947,1,59647,29988,30189
11164504,11164500,TXFE7,128,9947,1,59648,29989,30190
11164592,11164580,TXFE7,128,9947,6,59654,29993,30191
11164654,11164652,TXFE7,128,9947,1,59655,29994,30192
11164704,11164698,TXFE7,128,9947,1,59656,29995,30193
11164742,11164733,TXFE7,128,9948,1,59657,29996,30194
11164892,11164889,TXFE7,128,9947,1,59658,29997,30195
11164904,11164892,TXFE7,128,9947,5,59663,30000,30196
11164942,11164941,TXFE7,128,9947,1,59664,30001,30197
11165042,11165033,TXFE7,128,9948,2,59666,30002,30199
11165154,11165145,TXFE7,128,9947,2,59668,30004,30200
11165167,11165159,TXFE7,128,9947,1,59669,30005,30201
11165204,11165193,TXFE7,128,9948,1,59670,30006,30202
11165329,11165320,TXFE7,128,9948,1,59671,30007,30203
11165379,11165379,TXFE7,128,9947,1,59672,30008,30204
11165429,11165425,TXFE7,128,9947,1,59673,30009,30205
11165592,11165589,TXFE7,128,9948,2,59675,30010,30207
11165842,11165833,TXFE7,128,9948,1,59676,30011,30208
11165942,11165934,TXFE7,128,9947,1,59677,30012,30209
11170067,11170066,TXFE7,128,9948,1,59678,30013,30210
11170104,11170093,TXFE7,128,9948,2,59680,30014,30211
11170117,11170112,TXFE7,128,9948,1,59681,30015,30212
11170129,11170124,TXFE7,128,9948,1,59682,30016,30213
11170142,11170137,TXFE7,128,9947,1,59683,30017,30214
11170167,11170164,TXFE7,128,9948,1,59684,30018,30215
11170392,11170383,TXFE7,128,9948,1,59685,30019,30216
11170492,11170483,TXFE7,128,9947,1,59686,30020,30217
11170542,11170531,TXFE7,128,9948,2,59688,30021,30219
11170567,11170564,TXFE7,128,9948,1,59689,30022,30220
11170592,11170583,TXFE7,128,9947,1,59690,30023,30221
11170804,11170794,TXFE7,128,9947,1,59691,30024,30222
11170804,11170795,TXFE7,128,9948,1,59692,30025,30223
11170829,11170823,TXFE7,128,9947,1,59693,30026,30224
11170879,11170867,TXFE7,128,9947,1,59694,30027,30225
11170979,11170971,TXFE7,128,9947,1,59695,30028,30226
11170979,11170978,TXFE7,128,9947,2,59697,30029,30227
11171004,11170997,TXFE7,128,9948,2,59699,30030,30228
11171017,11171012,TXFE7,128,9948,1,59700,30031,30229
11171067,11171060,TXFE7,128,9948,3,59703,30032,30230
11171067,11171063,TXFE7,128,9948,1,59704,30033,30231
11171079,11171069,TXFE7,128,9947,1,59705,30034,30232
11171079,11171074,TXFE7,128,9948,1,59706,30035,30233
11171079,11171075,TXFE7,128,9948,2,59708,30036,30235
11171079,11171076,TXFE7,128,9948,1,59709,30037,30236
11171079,11171076,TXFE7,128,9948,1,59710,30038,30237
11171104,11171100,TXFE7,128,9948,1,59711,30039,30238
11171229,11171229,TXFE7,128,9947,2,59713,30041,30239
11171317,11171310,TXFE7,128,9947,9,59722,30045,30240
11171379,11171378,TXFE7,128,9947,4,59726,30047,30241
11171392,11171380,TXFE7,128,9947,21,59747,30060,30242
11171792,11171784,TXFE7,128,9947,1,59748,30061,30243
11171829,11171820,TXFE7,128,9947,1,59749,30062,30244
11171892,11171891,TXFE7,128,9946,87,59836,30117,30245
11171892,11171891,TXFE7,128,9946,1,59837,30118,30246
11171904,11171892,TXFE7,128,9945,2,59839,30119,30247
11171904,11171894,TXFE7,128,9946,1,59840,30120,30248
11171904,11171897,TXFE7,128,9945,1,59841,30121,30249
11171942,11171938,TXFE7,128,9946,1,59842,30122,30250
11171942,11171939,TXFE7,128,9946,1,59843,30123,30251
11171954,11171950,TXFE7,128,9945,1,59844,30124,30252
11171992,11171988,TXFE7,128,9945,5,59849,30125,30253
11172079,11172078,TXFE7,128,9946,1,59850,30126,30254
11172104,11172101,TXFE7,128,9945,1,59851,30127,30255
11172192,11172191,TXFE7,128,9945,1,59852,30128,30256
11172229,11172219,TXFE7,128,9946,1,59853,30129,30257
11172279,11172279,TXFE7,128,9945,2,59855,30131,30258
11172292,11172291,TXFE7,128,9946,3,59858,30132,30261
11172417,11172416,TXFE7,128,9946,1,59859,30133,30262
11172629,11172627,TXFE7,128,9946,3,59862,30134,30263
11172729,11172717,TXFE7,128,9945,1,59863,30135,30264
11172892,11172886,TXFE7,128,9945,1,59864,30136,30265
11172954,11172944,TXFE7,128,9945,2,59866,30138,30266
11173042,11173038,TXFE7,128,9945,1,59867,30139,30267
11173117,11173109,TXFE7,128,9945,1,59868,30140,30268
11173467,11173457,TXFE7,128,9946,5,59873,30141,30273
11173542,11173532,TXFE7,128,9946,1,59874,30142,30274
11173629,11173627,TXFE7,128,9945,1,59875,30143,30275
11173654,11173653,TXFE7,128,9946,2,59877,30144,30277
11173679,11173673,TXFE7,128,9945,1,59878,30145,30278
11173692,11173680,TXFE7,128,9946,1,59879,30146,30279
11174029,11174018,TXFE7,128,9946,1,59880,30147,30280
11174029,11174023,TXFE7,128,9946,1,59881,30148,30281
11174092,11174087,TXFE7,128,9946,1,59882,30149,30282
11174167,11174158,TXFE7,128,9946,1,59883,30150,30283
11174217,11174205,TXFE7,128,9946,1,59884,30151,30284
11174254,11174247,TXFE7,128,9946,1,59885,30152,30285
11174292,11174285,TXFE7,128,9946,1,59886,30153,30286
11174342,11174336,TXFE7,128,9946,1,59887,30154,30287
11174554,11174546,TXFE7,128,9945,81,59968,30208,30288
11174567,11174554,TXFE7,128,9944,2,59970,30210,30289
11174579,11174570,TXFE7,128,9944,1,59971,30211,30290
11174579,11174570,TXFE7,128,9944,1,59972,30212,30291
11174579,11174571,TXFE7,128,9944,1,59973,30213,30292
11174579,11174571,TXFE7,128,9944,1,59974,30214,30293
11174579,11174572,TXFE7,128,9944,1,59975,30215,30294
11174604,11174597,TXFE7,128,9944,1,59976,30216,30295
11174604,11174603,TXFE7,128,9944,1,59977,30217,30296
11174617,11174610,TXFE7,128,9944,1,59978,30218,30297
11174629,11174618,TXFE7,128,9944,1,59979,30219,30298
11174629,11174626,TXFE7,128,9944,1,59980,30220,30299
11174667,11174661,TXFE7,128,9944,5,59985,30225,30300
11174717,11174716,TXFE7,128,9944,1,59986,30226,30301
11174892,11174890,TXFE7,128,9944,1,59987,30227,30302
11175029,11175025,TXFE7,128,9944,1,59988,30228,30303
11175042,11175038,TXFE7,128,9944,1,59989,30229,30304
11175204,11175193,TXFE7,128,9945,1,59990,30230,30305
11175217,11175214,TXFE7,128,9944,2,59992,30232,30306
11175267,11175256,TXFE7,128,9944,1,59993,30233,30307
11175317,11175304,TXFE7,128,9945,1,59994,30234,30308
11175429,11175423,TXFE7,128,9945,2,59996,30235,30309
11175454,11175449,TXFE7,128,9944,2,59998,30236,30310
11175542,11175540,TXFE7,128,9945,2,60000,30237,30311
11175617,11175604,TXFE7,128,9944,1,60001,30238,30312
11175617,11175610,TXFE7,128,9944,4,60005,30241,30313
11175992,11175982,TXFE7,128,9945,1,60006,30242,30314
11180354,11180345,TXFE7,128,9944,1,60007,30243,30315
11180379,11180379,TXFE7,128,9944,1,60008,30244,30316
11180404,11180392,TXFE7,128,9945,3,60011,30245,30317
11180429,11180428,TXFE7,128,9945,1,60012,30246,30318
11180454,11180454,TXFE7,128,9945,2,60014,30247,30319
11180629,11180622,TXFE7,128,9944,1,60015,30248,30320
11180879,11180872,TXFE7,128,9945,1,60016,30249,30321
11180904,11180896,TXFE7,128,9945,1,60017,30250,30322
11180904,11180903,TXFE7,128,9945,1,60018,30251,30323
11180954,11180954,TXFE7,128,9944,1,60019,30252,30324
11181054,11181048,TXFE7,128,9944,1,60020,30253,30325
11181067,11181058,TXFE7,128,9944,1,60021,30254,30326
11181092,11181083,TXFE7,128,9944,1,60022,30255,30327
11181192,11181186,TXFE7,128,9944,2,60024,30257,30328
11181404,11181398,TXFE7,128,9944,1,60025,30258,30329
11181492,11181486,TXFE7,128,9944,1,60026,30259,30330
11181504,11181501,TXFE7,128,9944,5,60031,30260,30331
11181554,11181549,TXFE7,128,9944,1,60032,30261,30332
11181617,11181607,TXFE7,128,9944,4,60036,30263,30333
11181629,11181625,TXFE7,128,9944,4,60040,30265,30334
11181704,11181697,TXFE7,128,9944,1,60041,30266,30335
11181817,11181813,TXFE7,128,9944,1,60042,30267,30336
11181867,11181867,TXFE7,128,9944,1,60043,30268,30337
11181892,11181886,TXFE7,128,9944,1,60044,30269,30338
11181904,11181898,TXFE7,128,9945,3,60047,30270,30341
11181904,11181902,TXFE7,128,9944,1,60048,30271,30342
11181942,11181935,TXFE7,128,9944,1,60049,30272,30343
11181992,11181983,TXFE7,128,9945,3,60052,30273,30345
11182079,11182071,TXFE7,128,9944,2,60054,30274,30346
11182079,11182075,TXFE7,128,9945,3,60057,30275,30349
11182167,11182166,TXFE7,128,9945,3,60060,30276,30352
11182204,11182200,TXFE7,128,9944,1,60061,30277,30353
11182267,11182261,TXFE7,128,9945,3,60064,30278,30356
11182329,11182327,TXFE7,128,9945,3,60067,30279,30359
11182904,11182895,TXFE7,128,9945,12,60079,30280,30360
11182904,11182897,TXFE7,128,9945,3,60082,30281,30361
11182904,11182898,TXFE7,128,9944,6,60088,30284,30362
11182904,11182901,TXFE7,128,9945,3,60091,30285,30363
11182904,11182902,TXFE7,128,9945,3,60094,30286,30365
11182904,11182903,TXFE7,128,9944,9,60103,30290,30366
11182904,11182904,TXFE7,128,9945,12,60115,30291,30371
11182917,11182906,TXFE7,128,9944,9,60124,30297,30372
11182917,11182908,TXFE7,128,9944,6,60130,30299,30373
11182917,11182909,TXFE7,128,9945,1,60131,30300,30374
11182917,11182909,TXFE7,128,9945,6,60137,30301,30375
11183529,11183521,TXFE7,128,9945,2,60139,30302,30376
11183654,11183654,TXFE7,128,9944,3,60142,30305,30377
11183667,11183658,TXFE7,128,9945,2,60144,30306,30378
11183742,11183730,TXFE7,128,9944,3,60147,30307,30379
11183804,11183804,TXFE7,128,9944,3,60150,30308,30380
11183879,11183877,TXFE7,128,9944,7,60157,30309,30381
11184167,11184158,TXFE7,128,9945,2,60159,30310,30383
11184192,11184184,TXFE7,128,9945,1,60160,30311,30384
11184204,11184193,TXFE7,128,9945,1,60161,30312,30385
11184367,11184366,TXFE7,128,9944,2,60163,30314,30386
11184504,11184494,TXFE7,128,9944,6,60169,30315,30387
11184654,11184644,TXFE7,128,9945,52,60221,30316,30418
11184667,11184659,TXFE7,128,9946,4,60225,30317,30420
11184679,11184667,TXFE7,128,9946,4,60229,30318,30423
11184729,11184718,TXFE7,128,9946,1,60230,30319,30424
11184742,11184737,TXFE7,128,9945,2,60232,30320,30425
11184967,11184963,TXFE7,128,9946,2,60234,30321,30427
11185079,11185075,TXFE7,128,9946,1,60235,30322,30428
11185142,11185139,TXFE7,128,9946,1,60236,30323,30429
11185229,11185225,TXFE7,128,9945,2,60238,30324,30430
11185242,11185236,TXFE7,128,9945,3,60241,30325,30431
11185667,11185655,TXFE7,128,9945,1,60242,30326,30432
11185892,11185890,TXFE7,128,9946,24,60266,30327,30449
11190767,11190760,TXFE7,128,9946,9,60275,30328,30453
11190829,11190822,TXFE7,128,9946,4,60279,30329,30454
11190829,11190827,TXFE7,128,9946,2,60281,30330,30455
11190842,11190836,TXFE7,128,9946,2,60283,30331,30456
11190842,11190837,TXFE7,128,9946,4,60287,30332,30458
11190867,11190862,TXFE7,128,9946,1,60288,30333,30459
11190879,11190868,TXFE7,128,9946,2,60290,30334,30461
11190879,11190875,TXFE7,128,9946,1,60291,30335,30462
11190917,11190908,TXFE7,128,9946,3,60294,30336,30465
11191579,11191577,TXFE7,128,9946,2,60296,30337,30466
11191667,11191660,TXFE7,128,9946,1,60297,30338,30467
11192029,11192022,TXFE7,128,9946,42,60339,30339,30479
11192042,11192040,TXFE7,128,9946,2,60341,30340,30480
11192279,11192272,TXFE7,128,9946,1,60342,30341,30481
11192454,11192449,TXFE7,128,9947,3,60345,30342,30484
11192942,11192930,TXFE7,128,9947,1,60346,30343,30485
11192967,11192960,TXFE7,128,9946,3,60349,30344,30486
11192979,11192969,TXFE7,128,9946,1,60350,30345,30487
11192979,11192970,TXFE7,128,9946,2,60352,30346,30488
11193117,11193111,TXFE7,128,9946,1,60353,30347,30489
11193279,11193268,TXFE7,128,9946,1,60354,30348,30490
11193279,11193269,TXFE7,128,9947,4,60358,30349,30491
11193454,11193446,TXFE7,128,9946,2,60360,30350,30492
11193504,11193496,TXFE7,128,9946,1,60361,30351,30493
11194092,11194086,TXFE7,128,9946,1,60362,30352,30494
11194092,11194091,TXFE7,128,9947,1,60363,30353,30495
11194104,11194100,TXFE7,128,9946,2,60365,30354,30496
11194179,11194175,TXFE7,128,9946,1,60366,30355,30497
11194317,11194310,TXFE7,128,9947,49,60415,30356,30524
11194342,11194329,TXFE7,128,9947,2,60417,30357,30525
11194342,11194329,TXFE7,128,9947,2,60419,30358,30527
11194342,11194329,TXFE7,128,9947,5,60424,30359,30528
11194342,11194329,TXFE7,128,9947,2,60426,30360,30530
11194342,11194329,TXFE7,128,9947,2,60428,30361,30532
11194342,11194329,TXFE7,128,9947,1,60429,30362,30533
11194354,11194342,TXFE7,128,9947,1,60430,30363,30534
11194467,11194455,TXFE7,128,9946,1,60431,30364,30535
11194617,11194617,TXFE7,128,9947,1,60432,30365,30536
11194767,11194762,TXFE7,128,9946,2,60434,30367,30537
11195254,11195248,TXFE7,128,9947,11,60445,30368,30542
11195942,11195932,TXFE7,128,9947,1,60446,30369,30543
11200079,11200077,TXFE7,128,9947,14,60460,30370,30552
11200104,11200093,TXFE7,128,9947,1,60461,30371,30553
11200104,11200101,TXFE7,128,9947,1,60462,30372,30554
11200104,11200102,TXFE7,128,9948,1,60463,30373,30555
11200142,11200136,TXFE7,128,9947,1,60464,30374,30556
11200167,11200161,TXFE7,128,9946,2,60466,30376,30557
11200179,11200169,TXFE7,128,9947,1,60467,30377,30558
11200179,11200174,TXFE7,128,9947,1,60468,30378,30559
11200192,11200188,TXFE7,128,9947,1,60469,30379,30560
11200192,11200191,TXFE7,128,9947,2,60471,30380,30562
11200204,11200193,TXFE7,128,9947,3,60474,30381,30563
11200267,11200255,TXFE7,128,9947,2,60476,30382,30564
11200542,11200532,TXFE7,128,9947,1,60477,30383,30565
11200554,11200543,TXFE7,128,9947,2,60479,30384,30566
11200654,11200645,TXFE7,128,9948,1,60480,30385,30567
11200817,11200811,TXFE7,128,9947,1,60481,30386,30568
11200817,11200814,TXFE7,128,9947,1,60482,30387,30569
11200829,11200824,TXFE7,128,9947,1,60483,30388,30570
11201154,11201143,TXFE7,129,9947,2,60490,30389,30576
11201154,11201143,TXFE7,129,9948,5,60490,30389,30576
11201392,11201380,TXFE7,128,9947,1,60491,30390,30577
11201592,11201586,TXFE7,128,9947,1,60492,30391,30578
11201729,11201718,TXFE7,128,9947,1,60493,30392,30579
11201792,11201788,TXFE7,128,9947,1,60494,30393,30580
11201854,11201852,TXFE7,128,9947,1,60495,30394,30581
11202254,11202253,TXFE7,128,9947,1,60496,30395,30582
11202417,11202415,TXFE7,128,9947,2,60498,30396,30584
11202467,11202455,TXFE7,128,9947,2,60500,30397,30586
11202742,11202735,TXFE7,128,9947,1,60501,30398,30587
11203367,11203360,TXFE7,128,9947,2,60503,30399,30589
11203717,11203705,TXFE7,128,9947,2,60505,30400,30590
11204092,11204079,TXFE7,128,9946,4,60509,30401,30591
11204217,11204214,TXFE7,128,9946,7,60516,30405,30592
11204317,11204316,TXFE7,128,9947,2,60518,30406,30593
11204504,11204495,TXFE7,128,9946,1,60519,30407,30594
11204667,11204661,TXFE7,128,9946,1,60520,30408,30595
11204879,11204868,TXFE7,128,9947,5,60525,30409,30597
11204929,11204923,TXFE7,128,9946,2,60527,30411,30598
11204967,11204961,TXFE7,128,9946,10,60537,30418,30599
11204979,11204967,TXFE7,128,9946,1,60538,30419,30600
11205004,11204997,TXFE7,128,9946,1,60539,30420,30601
11205017,11205007,TXFE7,128,9946,1,60540,30421,30602
11205154,11205146,TXFE7,128,9946,3,60543,30422,30604
11205167,11205158,TXFE7,128,9945,2,60545,30424,30605
11205242,11205236,TXFE7,128,9946,2,60547,30425,30607
11205242,11205237,TXFE7,128,9945,1,60548,30426,30608
11205254,11205249,TXFE7,128,9947,3,60551,30427,30610
11205254,11205249,TXFE7,128,9945,2,60553,30429,30611
11205529,11205527,TXFE7,128,9946,1,60554,30430,30612
11205817,11205805,TXFE7,128,9946,1,60555,30431,30613
11205842,11205837,TXFE7,128,9946,1,60556,30432,30614
11205879,11205869,TXFE7,128,9946,1,60557,30433,30615
11205879,11205878,TXFE7,128,9947,1,60558,30434,30616
11210029,11210019,TXFE7,128,9946,1,60559,30435,30617
11211142,11211137,TXFE7,128,9946,1,60560,30436,30618
11211167,11211167,TXFE7,128,9946,1,60561,30437,30619
11211504,11211498,TXFE7,128,9946,1,60562,30438,30620
11211517,11211506,TXFE7,128,9946,2,60564,30439,30622
11211629,11211624,TXFE7,128,9945,3,60567,30440,30623
11212067,11212066,TXFE7,128,9945,1,60568,30441,30624
11212154,11212145,TXFE7,128,9945,1,60569,30442,30625
11212279,11212279,TXFE7,128,9945,1,60570,30443,30626
11212404,11212395,TXFE7,128,9946,2,60572,30444,30628
11212667,11212663,TXFE7,128,9946,5,60577,30445,30630
11213354,11213343,TXFE7,128,9946,1,60578,30446,30631
11213517,11213508,TXFE7,128,9945,2,60580,30447,30632
11213642,11213632,TXFE7,128,9945,1,60581,30448,30633
11213892,11213879,TXFE7,128,9945,1,60582,30449,30634
11214467,11214454,TXFE7,128,9946,4,60586,30450,30638
11214479,11214467,TXFE7,128,9946,1,60587,30451,30639
11214479,11214476,TXFE7,128,9946,1,60588,30452,30640
11214542,11214541,TXFE7,128,9946,1,60589,30453,30641
11214704,11214694,TXFE7,128,9945,4,60593,30454,30642
11214717,11214705,TXFE7,128,9946,1,60594,30455,30643
11214942,11214934,TXFE7,128,9946,5,60599,30456,30648
11215042,11215039,TXFE7,128,9945,2,60601,30457,30649
11215654,11215649,TXFE7,128,9946,1,60602,30458,30650
11215854,11215848,TXFE7,128,9945,1,60603,30459,30651
11215954,11215948,TXFE7,128,9946,19,60622,30460,30663
11215967,11215954,TXFE7,128,9946,1,60623,30461,30664
11215967,11215959,TXFE7,128,9946,1,60624,30462,30665
11215979,11215976,TXFE7,128,9945,1,60625,30463,30666
11220117,11220108,TXFE7,128,9946,6,60631,30464,30670
11220242,11220234,TXFE7,128,9946,1,60632,30465,30671
11220429,11220424,TXFE7,128,9946,2,60634,30466,30672
11220679,11220668,TXFE7,128,9947,20,60654,30467,30681
11220729,11220728,TXFE7,128,9946,1,60655,30468,30682
11220779,11220774,TXFE7,128,9947,1,60656,30469,30683
11220792,11220780,TXFE7,128,9947,9,60665,30470,30684
11220792,11220780,TXFE7,128,9947,1,60666,30471,30685
11220792,11220780,TXFE7,128,9947,2,60668,30472,30686
11220792,11220780,TXFE7,128,9947,8,60676,30473,30689
11220792,11220780,TXFE7,128,9947,1,60677,30474,30690
11220792,11220780,TXFE7,128,9947,2,60679,30475,30692
11220792,11220780,TXFE7,128,9947,4,60683,30476,30696
11220792,11220780,TXFE7,128,9947,6,60689,30477,30697
11220792,11220780,TXFE7,128,9947,1,60690,30478,30698
11220792,11220780,TXFE7,128,9947,1,60691,30479,30699
11220792,11220780,TXFE7,128,9947,1,60692,30480,30700
11220792,11220780,TXFE7,128,9947,1,60693,30481,30701
11220792,11220780,TXFE7,128,9947,3,60696,30482,30702
11220792,11220780,TXFE7,128,9947,1,60697,30483,30703
11220792,11220780,TXFE7,128,9947,15,60712,30484,30708
11220792,11220780,TXFE7,128,9947,1,60713,30485,30709
11220792,11220780,TXFE7,128,9947,6,60719,30486,30714
11220792,11220780,TXFE7,128,9947,1,60720,30487,30715
11220792,11220780,TXFE7,128,9947,2,60722,30488,30717
11220804,11220792,TXFE7,128,9947,9,60731,30489,30722
11220804,11220792,TXFE7,128,9947,3,60734,30490,30724
11220904,11220900,TXFE7,128,9948,2,60736,30491,30725
11220929,11220922,TXFE7,128,9948,20,60756,30492,30733
11220942,11220939,TXFE7,128,9948,1,60757,30493,30734
11220967,11220961,TXFE7,128,9948,1,60758,30494,30735
11221079,11221067,TXFE7,128,9948,1,60759,30495,30736
11221154,11221150,TXFE7,128,9948,2,60761,30496,30737
11221229,11221221,TXFE7,128,9947,1,60762,30497,30738
11221267,11221256,TXFE7,128,9948,6,60768,30498,30744
11221304,11221293,TXFE7,128,9948,1,60769,30499,30745
11221367,11221357,TXFE7,128,9948,1,60770,30500,30746
11221517,11221509,TXFE7,128,9948,1,60771,30501,30747
11221642,11221640,TXFE7,128,9947,1,60772,30502,30748
11221642,11221640,TXFE7,128,9947,1,60773,30503,30749
11221642,11221640,TXFE7,128,9947,8,60781,30508,30750
11221642,11221641,TXFE7,128,9947,8,60789,30513,30751
11221642,11221641,TXFE7,128,9947,1,60790,30514,30752
11221642,11221641,TXFE7,128,9947,1,60791,30515,30753
11221642,11221641,TXFE7,128,9947,2,60793,30516,30754
11221654,11221650,TXFE7,128,9947,1,60794,30517,30755
11221704,11221692,TXFE7,128,9947,5,60799,30518,30757
11221729,11221718,TXFE7,128,9947,5,60804,30519,30759
11222129,11222121,TXFE7,128,9947,1,60805,30520,30760
11222354,11222344,TXFE7,128,9947,3,60808,30521,30762
11222579,11222571,TXFE7,128,9947,1,60809,30522,30763
11222717,11222716,TXFE7,128,9947,1,60810,30523,30764
11222779,11222768,TXFE7,128,9946,5,60815,30524,30765
11223379,11223372,TXFE7,128,9947,1,60816,30525,30766
11223654,11223642,TXFE7,128,9947,10,60826,30526,30771
11223667,11223654,TXFE7,128,9947,1,60827,30527,30772
11223729,11223719,TXFE7,128,9947,1,60828,30528,30773
11223767,11223755,TXFE7,128,9947,1,60829,30529,30774
11223779,11223767,TXFE7,128,9947,1,60830,30530,30775
11223792,11223789,TXFE7,128,9947,1,60831,30531,30776
11223867,11223855,TXFE7,128,9947,1,60832,30532,30777
11224617,11224605,TXFE7,128,9947,1,60833,30533,30778
11224704,11224704,TXFE7,128,9948,1,60834,30534,30779
11225004,11224994,TXFE7,128,9948,7,60841,30535,30783
11225117,11225108,TXFE7,128,9947,1,60842,30536,30784
11225192,11225183,TXFE7,128,9947,1,60843,30537,30785
11225367,11225358,TXFE7,128,9948,1,60844,30538,30786
11225379,11225374,TXFE7,128,9947,1,60845,30539,30787
11225429,11225418,TXFE7,128,9947,1,60846,30540,30788
11225567,11225555,TXFE7,128,9947,1,60847,30541,30789
11225579,11225567,TXFE7,128,9948,1,60848,30542,30790
11230079,11230077,TXFE7,128,9948,1,60849,30543,30791
11230129,11230128,TXFE7,128,9948,1,60850,30544,30792
11230167,11230159,TXFE7,128,9948,1,60851,30545,30793
11230229,11230218,TXFE7,128,9948,1,60852,30546,30794
11230254,11230243,TXFE7,128,9948,1,60853,30547,30795
11230267,11230263,TXFE7,128,9948,1,60854,30548,30796
11230704,11230700,TXFE7,128,9948,3,60857,30549,30798
11230742,11230736,TXFE7,128,9948,1,60858,30550,30799
11230967,11230955,TXFE7,128,9948,1,60859,30551,30800
11231142,11231132,TXFE7,128,9948,3,60862,30552,30802
11231467,11231457,TXFE7,128,9948,2,60864,30553,30803
11231867,11231858,TXFE7,128,9948,5,60869,30554,30807
11231879,11231874,TXFE7,128,9947,3,60872,30555,30808
11231929,11231926,TXFE7,128,9948,3,60875,30556,30811
11232192,11232183,TXFE7,128,9948,3,60878,30557,30814
11232267,11232261,TXFE7,128,9948,1,60879,30558,30815
11232454,11232453,TXFE7,128,9948,5,60884,30559,30819
11232779,11232767,TXFE7,128,9948,1,60885,30560,30820
11232992,11232980,TXFE7,128,9947,1,60886,30561,30821
11232992,11232980,TXFE7,128,9947,1,60887,30562,30822
11232992,11232980,TXFE7,128,9947,13,60900,30566,30823
11233004,11232992,TXFE7,128,9947,2,60902,30567,30824
11233004,11232992,TXFE7,128,9947,1,60903,30568,30825
11233004,11232992,TXFE7,128,9947,3,60906,30571,30826
11233004,11232992,TXFE7,128,9947,4,60910,30575,30827
11233004,11232993,TXFE7,128,9947,1,60911,30576,30828
11233017,11233004,TXFE7,128,9947,6,60917,30578,30829
11233017,11233004,TXFE7,128,9947,2,60919,30580,30830
11233017,11233004,TXFE7,128,9947,2,60921,30581,30831
11233017,11233004,TXFE7,128,9947,2,60923,30582,30832
11233017,11233004,TXFE7,128,9947,1,60924,30583,30833
11233017,11233004,TXFE7,128,9947,2,60926,30584,30834
11233017,11233004,TXFE7,128,9947,3,60929,30587,30835
11233367,11233366,TXFE7,128,9947,2,60931,30588,30837
11234054,11234043,TXFE7,128,9947,1,60932,30589,30838
11234192,11234188,TXFE7,128,9947,1,60933,30590,30839
11234217,11234209,TXFE7,128,9947,1,60934,30591,30840
11234404,11234396,TXFE7,128,9946,5,60939,30592,30841
11234792,11234787,TXFE7,128,9946,4,60943,30593,30842
11235004,11234993,TXFE7,128,9947,1,60944,30594,30843
11235092,11235081,TXFE7,129,9947,19,60964,30595,30851
11235092,11235081,TXFE7,129,9948,1,60964,30595,30851
11235467,11235462,TXFE7,128,9947,1,60965,30596,30852
11235754,11235744,TXFE7,128,9947,1,60966,30597,30853
11240029,11240022,TXFE7,128,9947,1,60967,30598,30854
11240754,11240752,TXFE7,128,9947,1,60968,30599,30855
11240929,11240924,TXFE7,128,9946,2,60970,30600,30856
11241017,11241006,TXFE7,128,9946,1,60971,30601,30857
11241254,11241253,TXFE7,128,9947,1,60972,30602,30858
11241642,11241639,TXFE7,128,9947,1,60973,30603,30859
11241717,11241705,TXFE7,128,9946,1,60974,30604,30860
11241754,11241749,TXFE7,128,9947,5,60979,30605,30863
11241879,11241872,TXFE7,128,9947,1,60980,30606,30864
11242117,11242110,TXFE7,128,9947,1,60981,30607,30865
11242192,11242187,TXFE7,128,9947,7,60988,30608,30869
11242204,11242192,TXFE7,128,9947,11,60999,30609,30870
11242242,11242239,TXFE7,128,9948,2,61001,30610,30871
11242254,11242252,TXFE7,128,9948,3,61004,30611,30872
11242342,11242337,TXFE7,128,9947,1,61005,30612,30873
11242467,11242465,TXFE7,128,9947,1,61006,30613,30874
11242729,11242729,TXFE7,128,9947,3,61009,30615,30875
11242742,11242740,TXFE7,128,9947,1,61010,30616,30876
11242879,11242878,TXFE7,128,9948,1,61011,30617,30877
11243129,11243125,TXFE7,128,9948,2,61013,30618,30878
11243579,11243575,TXFE7,128,9947,5,61018,30621,30879
11244179,11244172,TXFE7,128,9947,1,61019,30622,30880
11244204,11244200,TXFE7,128,9948,1,61020,30623,30881
11244304,11244301,TXFE7,128,9948,2,61022,30624,30883
11244692,11244683,TXFE7,128,9948,5,61027,30625,30886
11245117,11245113,TXFE7,128,9948,1,61028,30626,30887
11245642,11245635,TXFE7,128,9947,3,61031,30627,30888
11245704,11245694,TXFE7,128,9948,1,61032,30628,30889
11245779,11245779,TXFE7,128,9947,1,61033,30629,30890
11250092,11250086,TXFE7,128,9948,1,61034,30630,30891
11250529,11250523,TXFE7,128,9947,1,61035,30631,30892
11250604,11250598,TXFE7,128,9948,1,61036,30632,30893
11250617,11250611,TXFE7,128,9948,4,61040,30633,30895
11250617,11250614,TXFE7,128,9948,1,61041,30634,30896
11250617,11250614,TXFE7,128,9948,1,61042,30635,30897
11250617,11250616,TXFE7,128,9948,3,61045,30636,30899
11250679,11250676,TXFE7,128,9947,1,61046,30637,30900
11250692,11250684,TXFE7,128,9947,1,61047,30638,30901
11250829,11250826,TXFE7,128,9947,3,61050,30641,30902
11250879,11250867,TXFE7,128,9948,1,61051,30642,30903
11251004,11251004,TXFE7,128,9948,1,61052,30643,30904
11251017,11251006,TXFE7,128,9948,1,61053,30644,30905
11251054,11251049,TXFE7,128,9947,1,61054,30645,30906
11251079,11251079,TXFE7,128,9948,1,61055,30646,30907
11251429,11251427,TXFE7,128,9948,10,61065,30647,30912
11251479,11251471,TXFE7,128,9948,1,61066,30648,30913
11251492,11251484,TXFE7,128,9948,3,61069,30649,30914
11251529,11251527,TXFE7,128,9948,2,61071,30650,30916
11251804,11251795,TXFE7,128,9948,2,61073,30652,30918
11252192,11252188,TXFE7,128,9948,1,61074,30653,30919
11252779,11252769,TXFE7,128,9947,1,61075,30654,30920
11252829,11252825,TXFE7,128,9948,1,61076,30655,30921
11252954,11252949,TXFE7,128,9948,1,61077,30656,30922
11252954,11252950,TXFE7,128,9947,1,61078,30657,30923
11253192,11253185,TXFE7,128,9948,3,61081,30658,30925
11253354,11253346,TXFE7,128,9947,1,61082,30659,30926
11253692,11253685,TXFE7,128,9948,1,61083,30660,30927
11253742,11253737,TXFE7,128,9947,1,61084,30661,30928
11254479,11254479,TXFE7,128,9947,1,61085,30662,30929
11254704,11254704,TXFE7,128,9948,1,61086,30663,30930
11255017,11255012,TXFE7,128,9947,1,61087,30664,30931
11255154,11255142,TXFE7,128,9948,3,61090,30665,30934
11255217,11255210,TXFE7,128,9948,1,61091,30666,30935
11255517,11255512,TXFE7,128,9948,3,61094,30667,30938
11255554,11255545,TXFE7,128,9948,3,61097,30668,30940
11255617,11255605,TXFE7,128,9948,2,61099,30669,30942
11255629,11255619,TXFE7,128,9948,1,61100,30670,30943
11255667,11255659,TXFE7,128,9948,1,61101,30671,30944
11255717,11255709,TXFE7,128,9947,10,61111,30677,30945
11255779,11255768,TXFE7,128,9948,2,61113,30678,30946
11255804,11255798,TXFE7,128,9948,1,61114,30679,30947
11255842,11255834,TXFE7,128,9947,2,61116,30681,30948
11255854,11255847,TXFE7,128,9948,3,61119,30682,30951
11260054,11260050,TXFE7,128,9948,1,61120,30683,30952
11260067,11260066,TXFE7,128,9948,1,61121,30684,30953
11260179,11260168,TXFE7,128,9948,1,61122,30685,30954
11260279,11260271,TXFE7,128,9948,3,61125,30686,30956
11260304,11260300,TXFE7,128,9948,1,61126,30687,30957
11260304,11260304,TXFE7,128,9948,1,61127,30688,30958
11260379,11260368,TXFE7,128,9948,2,61129,30689,30960
11260417,11260409,TXFE7,128,9948,1,61130,30690,30961
11260492,11260488,TXFE7,128,9948,3,61133,30691,30962
11260517,11260505,TXFE7,128,9948,3,61136,30692,30964
11260529,11260518,TXFE7,128,9948,1,61137,30693,30965
11260529,11260527,TXFE7,128,9948,3,61140,30694,30968
11260554,11260543,TXFE7,128,9948,3,61143,30695,30971
11260567,11260560,TXFE7,128,9948,1,61144,30696,30972
11260567,11260564,TXFE7,128,9948,1,61145,30697,30973
11260579,11260571,TXFE7,128,9948,1,61146,30698,30974
11260579,11260576,TXFE7,128,9948,1,61147,30699,30975
11260592,11260588,TXFE7,128,9948,2,61149,30700,30977
11260604,11260602,TXFE7,128,9948,1,61150,30701,30978
11260654,11260646,TXFE7,128,9948,1,61151,30702,30979
11260667,11260657,TXFE7,128,9948,2,61153,30703,30980
11260679,11260667,TXFE7,128,9948,1,61154,30704,30981
11260704,11260692,TXFE7,128,9948,1,61155,30705,30982
11260754,11260748,TXFE7,128,9948,1,61156,30706,30983
11260804,11260798,TXFE7,128,9948,1,61157,30707,30984
11260817,11260814,TXFE7,128,9948,1,61158,30708,30985
11260842,11260834,TXFE7,128,9948,2,61160,30709,30987
11260904,11260892,TXFE7,128,9948,3,61163,30710,30989
11260929,11260927,TXFE7,128,9948,4,61167,30711,30991
11261017,11261007,TXFE7,128,9948,1,61168,30712,30992
11261067,11261063,TXFE7,128,9948,1,61169,30713,30993
11261129,11261118,TXFE7,128,9948,1,61170,30714,30994
11261179,11261174,TXFE7,128,9948,1,61171,30715,30995
11261192,11261184,TXFE7,128,9948,2,61173,30717,30996
11261267,11261267,TXFE7,129,9948,1,61175,30718,30998
11261267,11261267,TXFE7,129,9949,1,61175,30718,30998
11261279,11261271,TXFE7,128,9949,2,61177,30719,30999
11261279,11261271,TXFE7,128,9949,2,61179,30720,31001
11261292,11261286,TXFE7,128,9949,6,61185,30721,31005
11261317,11261307,TXFE7,128,9949,8,61193,30722,31007
11261317,11261308,TXFE7,128,9949,6,61199,30723,31011
11261317,11261309,TXFE7,128,9949,1,61200,30724,31012
11261317,11261312,TXFE7,128,9949,1,61201,30725,31013
11261317,11261312,TXFE7,128,9949,2,61203,30726,31014
11261354,11261348,TXFE7,128,9949,6,61209,30727,31019
11261442,11261430,TXFE7,128,9949,1,61210,30728,31020
11261454,11261451,TXFE7,128,9948,1,61211,30729,31021
11261492,11261485,TXFE7,128,9949,1,61212,30730,31022
11261692,11261686,TXFE7,128,9949,2,61214,30731,31024
11261967,11261961,TXFE7,128,9949,2,61216,30732,31025
11262017,11262016,TXFE7,128,9948,1,61217,30733,31026
11262179,11262172,TXFE7,128,9949,2,61219,30734,31027
11262192,11262183,TXFE7,128,9948,8,61227,30737,31028
11262217,11262210,TXFE7,128,9949,1,61228,30738,31029
11262242,11262240,TXFE7,128,9949,3,61231,30739,31030
11262842,11262834,TXFE7,128,9949,2,61233,30740,31032
11262929,11262929,TXFE7,128,9948,1,61234,30741,31033
11262942,11262934,TXFE7,128,9949,1,61235,30742,31034
11262979,11262979,TXFE7,128,9948,12,61247,30750,31035
11263054,11263043,TXFE7,128,9949,4,61251,30751,31037
11263079,11263077,TXFE7,128,9949,2,61253,30752,31039
11263167,11263160,TXFE7,128,9949,1,61254,30753,31040
11263217,11263205,TXFE7,128,9949,2,61256,30754,31042
11263229,11263219,TXFE7,128,9948,1,61257,30755,31043
11263229,11263220,TXFE7,128,9948,1,61258,30756,31044
11263317,11263308,TXFE7,128,9948,2,61260,30757,31045
11263379,11263377,TXFE7,128,9948,1,61261,30758,31046
11263392,11263388,TXFE7,128,9948,10,61271,30767,31047
11263442,11263440,TXFE7,128,9948,2,61273,30768,31048
11263492,11263488,TXFE7,128,9948,1,61274,30769,31049
11263667,11263656,TXFE7,128,9948,1,61275,30770,31050
11263667,11263665,TXFE7,128,9948,2,61277,30771,31051
11263929,11263919,TXFE7,128,9948,1,61278,30772,31052
11264017,11264005,TXFE7,128,9948,1,61279,30773,31053
11264029,11264024,TXFE7,128,9948,2,61281,30774,31054
11264292,11264280,TXFE7,128,9948,2,61283,30775,31055
11264329,11264328,TXFE7,128,9948,1,61284,30776,31056
11264367,11264361,TXFE7,128,9948,1,61285,30777,31057
11264479,11264474,TXFE7,128,9948,3,61288,30778,31058
11264579,11264572,TXFE7,128,9948,2,61290,30779,31059
11264617,11264610,TXFE7,128,9948,1,61291,30780,31060
11264717,11264706,TXFE7,128,9948,1,61292,30781,31061
11264779,11264775,TXFE7,128,9948,2,61294,30782,31062
11264917,11264908,TXFE7,128,9948,2,61296,30783,31063
11265029,11265021,TXFE7,128,9948,1,61297,30784,31064
11265254,11265246,TXFE7,128,9948,1,61298,30785,31065
11265642,11265631,TXFE7,128,9947,5,61303,30786,31066
11265679,11265669,TXFE7,128,9947,1,61304,30787,31067
11265804,11265802,TXFE7,128,9948,1,61305,30788,31068
11265929,11265919,TXFE7,128,9947,1,61306,30789,31069
11270054,11270042,TXFE7,128,9947,1,61307,30790,31070
11270367,11270360,TXFE7,128,9947,1,61308,30791,31071
11270467,11270467,TXFE7,128,9947,1,61309,30792,31072
11270579,11270574,TXFE7,128,9947,1,61310,30793,31073
11270629,11270629,TXFE7,128,9947,5,61315,30794,31074
11270692,11270690,TXFE7,128,9947,1,61316,30795,31075
11271067,11271065,TXFE7,128,9947,4,61320,30797,31076
11271117,11271112,TXFE7,128,9947,1,61321,30798,31077
11271342,11271332,TXFE7,128,9947,1,61322,30799,31078
11271529,11271525,TXFE7,128,9947,2,61324,30801,31079
11271679,11271667,TXFE7,128,9947,1,61325,30802,31080
11271867,11271858,TXFE7,128,9947,1,61326,30803,31081
11271917,11271912,TXFE7,128,9947,1,61327,30804,31082
11272342,11272336,TXFE7,128,9947,2,61329,30806,31083
11272354,11272343,TXFE7,128,9948,1,61330,30807,31084
11272404,11272397,TXFE7,128,9948,1,61331,30808,31085
11272454,11272449,TXFE7,128,9947,2,61333,30810,31086
11272504,11272502,TXFE7,128,9948,1,61334,30811,31087
11272529,11272522,TXFE7,128,9947,1,61335,30812,31088
11272604,11272602,TXFE7,128,9947,1,61336,30813,31089
11272679,11272676,TXFE7,128,9948,1,61337,30814,31090
11272692,11272691,TXFE7,128,9948,1,61338,30815,31091
11272804,11272799,TXFE7,128,9947,1,61339,30816,31092
11272879,11272875,TXFE7,128,9947,5,61344,30819,31093
11273192,11273191,TXFE7,128,9948,1,61345,30820,31094
11273342,11273337,TXFE7,128,9948,7,61352,30821,31096
11273467,11273464,TXFE7,128,9948,1,61353,30822,31097
11273954,11273943,TXFE7,128,9947,1,61354,30823,31098
11274254,11274248,TXFE7,128,9948,1,61355,30824,31099
11274679,11274671,TXFE7,128,9947,2,61357,30826,31100
11274729,11274717,TXFE7,128,9947,37,61394,30855,31101
11274979,11274968,TXFE7,128,9947,2,61396,30856,31102
11275292,11275290,TXFE7,128,9947,1,61397,30857,31103
11275379,11275369,TXFE7,128,9947,1,61398,30858,31104
11280192,11280189,TXFE7,128,9947,6,61404,30859,31107
11280229,11280224,TXFE7,128,9947,1,61405,30860,31108
11280342,11280329,TXFE7,128,9947,1,61406,30861,31109
11280342,11280329,TXFE7,128,9947,4,61410,30862,31111
11280354,11280342,TXFE7,128,9947,9,61419,30863,31118
11280354,11280343,TXFE7,128,9947,2,61421,30864,31120
11280367,11280354,TXFE7,128,9947,2,61423,30865,31122
11280517,11280512,TXFE7,128,9947,2,61425,30866,31124
11280592,11280581,TXFE7,128,9947,1,61426,30867,31125
11281254,11281250,TXFE7,128,9946,1,61427,30868,31126
11281317,11281306,TXFE7,128,9947,1,61428,30869,31127
11281479,11281473,TXFE7,128,9947,1,61429,30870,31128
11281604,11281601,TXFE7,128,9947,1,61430,30871,31129
11281829,11281818,TXFE7,128,9946,1,61431,30872,31130
11281854,11281848,TXFE7,128,9946,2,61433,30873,31131
11281854,11281853,TXFE7,128,9947,1,61434,30874,31132
11281929,11281926,TXFE7,128,9946,1,61435,30875,31133
11281929,11281926,TXFE7,128,9946,3,61438,30876,31134
11281929,11281926,TXFE7,128,9946,2,61440,30877,31135
11281929,11281926,TXFE7,128,9946,2,61442,30878,31136
11281929,11281927,TXFE7,128,9946,51,61493,30891,31137
11281929,11281927,TXFE7,128,9946,2,61495,30892,31138
11281929,11281927,TXFE7,128,9946,4,61499,30896,31139
11281942,11281929,TXFE7,128,9946,2,61501,30897,31140
11281942,11281929,TXFE7,128,9946,8,61509,30902,31141
11281942,11281929,TXFE7,128,9946,4,61513,30905,31142
11281942,11281929,TXFE7,128,9946,10,61523,30910,31143
11281942,11281929,TXFE7,128,9946,7,61530,30916,31144
11281954,11281942,TXFE7,128,9945,2,61532,30918,31145
11281954,11281942,TXFE7,128,9945,2,61534,30920,31146
11282004,11282004,TXFE7,128,9946,1,61535,30921,31147
11282017,11282006,TXFE7,128,9946,3,61538,30922,31149
11282017,11282006,TXFE7,128,9946,1,61539,30923,31150
11282029,11282027,TXFE7,128,9946,1,61540,30924,31151
11282029,11282028,TXFE7,128,9946,3,61543,30925,31152
11282104,11282103,TXFE7,128,9946,1,61544,30926,31153
11282379,11282378,TXFE7,128,9946,1,61545,30927,31154
11282454,11282449,TXFE7,128,9946,1,61546,30928,31155
11282492,11282480,TXFE7,128,9946,2,61548,30929,31156
11282529,11282523,TXFE7,128,9946,10,61558,30934,31157
11282529,11282529,TXFE7,128,9946,3,61561,30935,31158
11282692,11282688,TXFE7,128,9946,1,61562,30936,31159
11282742,11282737,TXFE7,128,9946,1,61563,30937,31160
11282842,11282837,TXFE7,128,9946,1,61564,30938,31161
11283379,11283376,TXFE7,128,9947,3,61567,30939,31163
11283554,11283543,TXFE7,128,9946,1,61568,30940,31164
11283554,11283544,TXFE7,128,9946,1,61569,30941,31165
11283742,11283738,TXFE7,128,9946,6,61575,30943,31166
11283792,11283787,TXFE7,128,9946,6,61581,30946,31167
11283842,11283841,TXFE7,128,9946,1,61582,30947,31168
11284304,11284301,TXFE7,128,9946,2,61584,30949,31169
11284329,11284326,TXFE7,128,9946,1,61585,30950,31170
11284329,11284329,TXFE7,128,9946,1,61586,30951,31171
11284454,11284446,TXFE7,128,9946,2,61588,30952,31172
11284592,11284581,TXFE7,128,9946,11,61599,30956,31173
11284817,11284808,TXFE7,128,9945,1,61600,30957,31174
11284904,11284897,TXFE7,128,9945,1,61601,30958,31175
11285229,11285217,TXFE7,128,9946,50,61651,30959,31184
11285229,11285217,TXFE7,128,9946,2,61653,30960,31185
11285242,11285229,TXFE7,128,9946,4,61657,30961,31186
11285242,11285229,TXFE7,128,9946,11,61668,30962,31195
11285279,11285279,TXFE7,128,9946,5,61673,30965,31196
11285742,11285736,TXFE7,128,9946,2,61685,30975,31206
11290017,11290014,TXFE7,128,9946,1,61686,30976,31207
11290067,11290066,TXFE7,128,9945,1,61687,30977,31208
11290079,11290067,TXFE7,128,9946,1,61688,30978,31209
11290117,11290115,TXFE7,128,9946,2,61690,30979,31210
11290254,11290254,TXFE7,128,9946,3,61693,30980,31212
11290454,11290450,TXFE7,128,9946,1,61694,30981,31213
11290467,11290466,TXFE7,128,9945,1,61695,30982,31214
11290679,11290669,TXFE7,128,9946,4,61699,30983,31217
11290679,11290673,TXFE7,128,9946,1,61700,30984,31218
11290692,11290679,TXFE7,128,9946,1,61701,30985,31219
11290817,11290811,TXFE7,128,9946,1,61702,30986,31220
11291004,11290998,TXFE7,128,9945,1,61703,30987,31221
11291029,11291023,TXFE7,128,9946,1,61704,30988,31222
11291142,11291131,TXFE7,128,9945,2,61706,30990,31223
11291142,11291132,TXFE7,128,9945,2,61708,30992,31224
11291142,11291135,TXFE7,128,9945,2,61710,30994,31225
11291142,11291136,TXFE7,128,9945,2,61712,30995,31226
11291142,11291138,TXFE7,128,9945,2,61714,30996,31227
11292004,11291998,TXFE7,128,9945,1,61715,30997,31228
11292154,11292144,TXFE7,128,9946,2,61717,30998,31230
11292279,11292278,TXFE7,128,9945,1,61718,30999,31231
11292654,11292652,TXFE7,128,9945,1,61719,31000,31232
11293142,11293133,TXFE7,128,9945,2,61721,31002,31233
11294129,11294124,TXFE7,128,9945,1,61722,31003,31234
11294692,11294680,TXFE7,128,9945,1,61723,31004,31235
11294754,11294749,TXFE7,128,9945,1,61724,31005,31236
11295367,11295364,TXFE7,128,9945,3,61727,31007,31237
11295404,11295395,TXFE7,128,9946,1,61728,31008,31238
11295454,11295443,TXFE7,128,9945,1,61729,31009,31239
11295479,11295474,TXFE7,128,9946,1,61730,31010,31240
11295842,11295842,TXFE7,128,9945,2,61732,31012,31241
11295892,11295887,TXFE7,128,9945,1,61733,31013,31242
11300079,11300078,TXFE7,128,9945,2,61735,31015,31243
11300167,11300158,TXFE7,128,9945,1,61736,31016,31244
11300342,11300334,TXFE7,128,9945,1,61737,31017,31245
11300354,11300353,TXFE7,128,9945,7,61744,31022,31246
11300617,11300612,TXFE7,128,9946,1,61745,31023,31247
11300679,11300670,TXFE7,128,9946,4,61749,31024,31250
11300779,11300767,TXFE7,128,9946,15,61764,31025,31260
11300804,11300798,TXFE7,128,9946,2,61766,31026,31262
11300904,11300896,TXFE7,128,9946,1,61767,31027,31263
11301842,11301833,TXFE7,128,9945,1,61768,31028,31264
11302529,11302527,TXFE7,128,9945,1,61769,31029,31265
11303579,11303573,TXFE7,128,9945,1,61770,31030,31266
11303779,11303768,TXFE7,128,9945,2,61772,31032,31267
11304279,11304269,TXFE7,128,9945,1,61773,31033,31268
11304429,11304428,TXFE7,128,9945,1,61774,31034,31269
11304504,11304501,TXFE7,128,9945,1,61775,31035,31270
11304642,11304632,TXFE7,128,9945,1,61776,31036,31271
11304792,11304782,TXFE7,128,9945,1,61777,31037,31272
11304904,11304904,TXFE7,128,9945,1,61778,31038,31273
11305104,11305095,TXFE7,128,9945,1,61779,31039,31274
11305342,11305333,TXFE7,128,9945,2,61781,31040,31275
11305542,11305540,TXFE7,128,9946,1,61782,31041,31276
11310067,11310055,TXFE7,128,9945,2,61784,31043,31277
11310642,11310629,TXFE7,128,9945,1,61785,31044,31278
11310817,11310812,TXFE7,128,9946,1,61786,31045,31279
11310867,11310856,TXFE7,128,9946,1,61787,31046,31280
11311029,11311022,TXFE7,128,9946,1,61788,31047,31281
11311242,11311241,TXFE7,128,9945,2,61790,31049,31282
11311304,11311296,TXFE7,128,9946,1,61791,31050,31283
11311817,11311815,TXFE7,128,9946,1,61792,31051,31284
11311929,11311927,TXFE7,128,9946,5,61797,31052,31286
11311942,11311929,TXFE7,128,9946,2,61799,31053,31288
11312117,11312112,TXFE7,128,9946,1,61800,31054,31289
11312229,11312222,TXFE7,128,9945,3,61803,31057,31290
11312254,11312248,TXFE7,128,9946,2,61805,31058,31291
11312329,11312321,TXFE7,128,9946,1,61806,31059,31292
11312329,11312329,TXFE7,128,9946,1,61807,31060,31293
11312379,11312371,TXFE7,128,9946,2,61809,31061,31295
11312417,11312413,TXFE7,128,9946,1,61810,31062,31296
11312642,11312630,TXFE7,128,9946,1,61811,31063,31297
11312779,11312771,TXFE7,128,9946,1,61812,31064,31298
11312829,11312827,TXFE7,128,9946,1,61813,31065,31299
11312842,11312829,TXFE7,128,9946,6,61819,31066,31301
11312842,11312829,TXFE7,128,9946,4,61823,31067,31302
11312854,11312842,TXFE7,128,9946,2,61825,31068,31304
11312854,11312842,TXFE7,128,9946,3,61828,31069,31306
11312854,11312842,TXFE7,128,9946,4,61832,31070,31307
11312854,11312842,TXFE7,128,9946,2,61834,31071,31308
11312867,11312854,TXFE7,128,9946,6,61840,31072,31312
11312867,11312854,TXFE7,128,9946,2,61842,31073,31314
11312867,11312854,TXFE7,128,9946,2,61844,31074,31316
11312867,11312854,TXFE7,128,9946,2,61846,31075,31318
11312867,11312861,TXFE7,128,9946,1,61847,31076,31319
11312879,11312867,TXFE7,128,9946,9,61856,31077,31323
11312879,11312867,TXFE7,128,9946,3,61859,31078,31326
11312904,11312896,TXFE7,128,9947,1,61860,31079,31327
11312904,11312897,TXFE7,128,9947,1,61861,31080,31328
11312904,11312897,TXFE7,128,9947,2,61863,31081,31330
11312917,11312907,TXFE7,128,9947,5,61868,31082,31332
11312929,11312918,TXFE7,128,9947,11,61879,31083,31336
11312954,11312953,TXFE7,128,9946,1,61880,31084,31337
11313092,11313084,TXFE7,128,9947,1,61881,31085,31338
11313217,11313214,TXFE7,128,9947,1,61882,31086,31339
11313454,11313451,TXFE7,128,9947,5,61887,31087,31342
11313492,11313480,TXFE7,128,9947,1,61888,31088,31343
11313542,11313530,TXFE7,128,9947,1,61889,31089,31344
11313592,11313580,TXFE7,128,9947,1,61890,31090,31345
11313604,11313592,TXFE7,128,9947,1,61891,31091,31346
11313617,11313604,TXFE7,128,9947,2,61893,31092,31347
11313692,11313686,TXFE7,128,9947,3,61896,31093,31350
11313742,11313736,TXFE7,128,9947,1,61897,31094,31351
11313792,11313786,TXFE7,128,9947,1,61898,31095,31352
11314017,11314006,TXFE7,128,9946,1,61899,31096,31353
11314092,11314089,TXFE7,128,9947,1,61900,31097,31354
11314979,11314968,TXFE7,128,9947,1,61901,31098,31355
11315317,11315315,TXFE7,128,9947,2,61903,31099,31356
11315504,11315499,TXFE7,128,9947,4,61907,31100,31360
11315692,11315683,TXFE7,128,9947,1,61908,31101,31361
11315929,11315926,TXFE7,128,9947,1,61909,31102,31362
11320054,11320048,TXFE7,128,9947,1,61910,31103,31363
11320079,11320072,TXFE7,128,9947,1,61911,31104,31364
11320092,11320087,TXFE7,128,9947,3,61914,31105,31365
11320092,11320089,TXFE7,128,9947,1,61915,31106,31366
11320204,11320192,TXFE7,128,9947,1,61916,31107,31367
11320229,11320220,TXFE7,128,9947,1,61917,31108,31368
11320242,11320240,TXFE7,128,9947,1,61918,31109,31369
11320267,11320257,TXFE7,128,9947,1,61919,31110,31370
11320279,11320273,TXFE7,128,9947,22,61941,31111,31381
11320279,11320278,TXFE7,128,9947,1,61942,31112,31382
11320292,11320279,TXFE7,128,9947,8,61950,31113,31383
11320292,11320279,TXFE7,128,9947,6,61956,31114,31385
11320292,11320279,TXFE7,128,9947,2,61958,31115,31386
11320304,11320292,TXFE7,128,9947,2,61960,31116,31388
11320342,11320334,TXFE7,128,9947,1,61961,31117,31389
11320842,11320841,TXFE7,128,9947,2,61963,31119,31390
11321042,11321038,TXFE7,128,9948,1,61964,31120,31391
11321229,11321227,TXFE7,128,9948,1,61965,31121,31392
11321367,11321355,TXFE7,128,9947,1,61966,31122,31393
11321642,11321632,TXFE7,128,9948,1,61967,31123,31394
11322579,11322569,TXFE7,128,9948,30,61997,31124,31411
11322717,11322714,TXFE7,128,9947,1,61998,31125,31412
11322904,11322893,TXFE7,128,9948,1,61999,31126,31413
11323054,11323046,TXFE7,128,9948,1,62000,31127,31414
11323104,11323100,TXFE7,128,9948,1,62001,31128,31415
11323354,11323354,TXFE7,128,9948,1,62002,31129,31416
11323417,11323410,TXFE7,128,9948,14,62016,31130,31422
11323467,11323466,TXFE7,128,9948,14,62030,31131,31432
11323467,11323467,TXFE7,128,9947,1,62031,31132,31433
11323479,11323471,TXFE7,128,9948,1,62032,31133,31434
11323479,11323472,TXFE7,128,9948,14,62046,31134,31439
11323517,11323505,TXFE7,128,9948,2,62048,31135,31440
11323617,11323605,TXFE7,128,9947,1,62049,31136,31441
11323804,11323799,TXFE7,128,9948,1,62050,31137,31442
11324367,11324362,TXFE7,128,9948,2,62052,31138,31443
11324867,11324867,TXFE7,128,9948,2,62054,31139,31444
11324954,11324951,TXFE7,128,9948,2,62056,31140,31445
11324967,11324955,TXFE7,128,9948,7,62063,31141,31449
11325117,11325112,TXFE7,128,9948,1,62064,31142,31450
11325192,11325184,TXFE7,128,9948,1,62065,31143,31451
11325317,11325310,TXFE7,128,9948,2,62067,31144,31453
11325379,11325375,TXFE7,128,9948,1,62068,31145,31454
11325554,11325543,TXFE7,128,9948,2,62070,31146,31455
11325604,11325600,TXFE7,128,9948,1,62071,31147,31456
11325604,11325602,TXFE7,128,9948,1,62072,31148,31457
11325604,11325603,TXFE7,128,9948,1,62073,31149,31458
11325979,11325975,TXFE7,128,9948,5,62078,31150,31460
11325992,11325990,TXFE7,128,9948,2,62080,31151,31462
11330142,11330141,TXFE7,128,9948,1,62081,31152,31463
11330154,11330148,TXFE7,128,9948,2,62083,31153,31465
11330167,11330155,TXFE7,128,9948,1,62084,31154,31466
11330179,11330167,TXFE7,128,9948,4,62088,31155,31470
11330179,11330167,TXFE7,128,9948,2,62090,31156,31472
11330179,11330179,TXFE7,128,9949,2,62092,31157,31474
11330192,11330180,TXFE7,128,9949,7,62099,31158,31480
11330192,11330184,TXFE7,128,9948,1,62100,31159,31481
11330204,11330200,TXFE7,128,9949,4,62104,31160,31482
11330217,11330210,TXFE7,128,9949,25,62129,31161,31501
11330217,11330211,TXFE7,128,9949,2,62131,31162,31502
11330217,11330212,TXFE7,128,9949,1,62132,31163,31503
11330217,11330214,TXFE7,128,9949,1,62133,31164,31504
11330217,11330216,TXFE7,128,9948,1,62134,31165,31505
11330292,11330283,TXFE7,128,9949,1,62135,31166,31506
11330292,11330286,TXFE7,128,9949,1,62136,31167,31507
11330329,11330317,TXFE7,128,9949,2,62138,31168,31509
11330792,11330790,TXFE7,128,9949,1,62139,31169,31510
11330817,11330808,TXFE7,128,9949,7,62146,31170,31517
11331192,11331185,TXFE7,128,9949,1,62147,31171,31518
11331354,11331344,TXFE7,128,9948,1,62148,31172,31519
11332342,11332330,TXFE7,128,9948,2,62150,31174,31520
11332354,11332344,TXFE7,128,9948,20,62170,31177,31521
11332367,11332354,TXFE7,128,9948,4,62174,31180,31522
11332367,11332362,TXFE7,128,9948,6,62180,31183,31523
11332392,11332379,TXFE7,128,9948,1,62181,31184,31524
11332567,11332566,TXFE7,128,9948,1,62182,31185,31525
11332579,11332579,TXFE7,128,9947,1,62183,31186,31526
11332654,11332649,TXFE7,128,9947,1,62184,31187,31527
11332704,11332700,TXFE7,128,9948,1,62185,31188,31528
11333192,11333188,TXFE7,128,9947,1,62186,31189,31529
11333217,11333215,TXFE7,128,9948,1,62187,31190,31530
11333467,11333463,TXFE7,128,9948,2,62189,31191,31531
11333804,11333803,TXFE7,128,9948,1,62190,31192,31532
11334204,11334203,TXFE7,128,9947,1,62191,31193,31533
11334904,11334892,TXFE7,128,9948,11,62202,31194,31539
11334917,11334909,TXFE7,128,9949,1,62203,31195,31540
11335117,11335114,TXFE7,128,9948,4,62207,31197,31541
11335142,11335139,TXFE7,128,9949,1,62208,31198,31542
11335267,11335257,TXFE7,128,9948,1,62209,31199,31543
11335392,11335381,TXFE7,128,9948,1,62210,31200,31544
11335442,11335435,TXFE7,128,9948,1,62211,31201,31545
11335567,11335557,TXFE7,128,9948,2,62213,31203,31546
11335729,11335726,TXFE7,128,9948,3,62216,31205,31547
11335767,11335757,TXFE7,128,9948,1,62217,31206,31548
11335854,11335842,TXFE7,128,9948,1,62218,31207,31549
11340092,11340086,TXFE7,128,9949,3,62221,31208,31550
11340154,11340151,TXFE7,128,9949,1,62222,31209,31551
11340279,11340268,TXFE7,128,9949,1,62223,31210,31552
11340829,11340824,TXFE7,128,9948,3,62226,31213,31553
11341167,11341155,TXFE7,128,9949,1,62227,31214,31554
11341317,11341316,TXFE7,128,9948,2,62229,31216,31555
11342292,11342285,TXFE7,128,9948,1,62230,31217,31556
11342592,11342582,TXFE7,128,9948,1,62231,31218,31557
11343279,11343278,TXFE7,128,9948,2,62233,31219,31558
11343529,11343520,TXFE7,128,9948,2,62235,31220,31559
11343592,11343589,TXFE7,128,9948,2,62237,31221,31560
11343617,11343604,TXFE7,128,9948,4,62241,31222,31561
11343629,11343617,TXFE7,128,9948,2,62243,31224,31562
11343654,11343650,TXFE7,128,9948,35,62278,31243,31563
11343667,11343657,TXFE7,128,9947,1,62279,31244,31564
11343717,11343712,TXFE7,128,9948,1,62280,31245,31565
11343842,11343835,TXFE7,128,9948,1,62281,31246,31566
11344654,11344650,TXFE7,128,9947,1,62282,31247,31567
11345592,11345582,TXFE7,128,9947,1,62283,31248,31568
11345629,11345626,TXFE7,128,9947,1,62284,31249,31569
11345679,11345678,TXFE7,128,9948,1,62285,31250,31570
11345692,11345681,TXFE7,128,9947,1,62286,31251,31571
11345792,11345784,TXFE7,128,9947,2,62288,31253,31572
11345804,11345801,TXFE7,128,9947,3,62291,31256,31573
11345917,11345911,TXFE7,128,9947,1,62292,31257,31574
11345942,11345934,TXFE7,128,9947,1,62293,31258,31575
11350067,11350064,TXFE7,128,9948,1,62294,31259,31576
11350079,11350078,TXFE7,128,9948,1,62295,31260,31577
11350429,11350424,TXFE7,128,9947,1,62296,31261,31578
11352542,11352539,TXFE7,128,9947,1,62297,31262,31579
11353242,11353239,TXFE7,128,9947,1,62298,31263,31580
11353554,11353547,TXFE7,128,9948,1,62299,31264,31581
11353554,11353553,TXFE7,128,9948,1,62300,31265,31582
11355204,11355202,TXFE7,128,9947,1,62301,31266,31583
11355629,11355628,TXFE7,128,9947,1,62302,31267,31584
11360117,11360116,TXFE7,128,9947,1,62303,31268,31585
11360154,11360149,TXFE7,128,9948,1,62304,31269,31586
11360154,11360152,TXFE7,128,9948,1,62305,31270,31587
11360154,11360154,TXFE7,128,9948,1,62306,31271,31588
11360167,11360157,TXFE7,128,9948,1,62307,31272,31589
11360204,11360196,TXFE7,128,9947,1,62308,31273,31590
11360729,11360722,TXFE7,128,9947,1,62309,31274,31591
11361104,11361097,TXFE7,128,9947,1,62310,31275,31592
11361729,11361727,TXFE7,128,9947,2,62312,31277,31593
11362429,11362423,TXFE7,128,9947,1,62313,31278,31594
11363417,11363410,TXFE7,128,9947,1,62314,31279,31595
11363717,11363715,TXFE7,128,9948,1,62315,31280,31596
11364017,11364016,TXFE7,128,9947,1,62316,31281,31597
11365529,11365519,TXFE7,128,9947,1,62317,31282,31598
11365817,11365814,TXFE7,128,9947,1,62318,31283,31599
11365929,11365927,TXFE7,128,9947,2,62320,31284,31600
11365992,11365989,TXFE7,128,9947,3,62323,31285,31601
11370004,11365992,TXFE7,128,9947,2,62325,31286,31602
11370004,11365992,TXFE7,128,9947,6,62331,31287,31603
11370004,11365992,TXFE7,128,9947,4,62335,31289,31604
11370017,11370004,TXFE7,128,9947,1,62336,31290,31605
11370017,11370004,TXFE7,128,9947,1,62337,31291,31606
11370017,11370004,TXFE7,128,9947,11,62348,31299,31607
11370029,11370021,TXFE7,128,9947,2,62350,31301,31608
11370029,11370022,TXFE7,128,9947,1,62351,31302,31609
11370029,11370026,TXFE7,128,9947,5,62356,31306,31610
11370042,11370029,TXFE7,128,9947,1,62357,31307,31611
11370042,11370029,TXFE7,128,9947,6,62363,31311,31612
11370042,11370029,TXFE7,128,9947,4,62367,31314,31613
11370079,11370068,TXFE7,128,9946,1,62368,31315,31614
11371704,11371694,TXFE7,128,9946,2,62370,31316,31615
11372254,11372245,TXFE7,128,9946,1,62371,31317,31616
11372279,11372279,TXFE7,128,9946,1,62372,31318,31617
11372467,11372466,TXFE7,128,9946,1,62373,31319,31618
11373367,11373358,TXFE7,128,9947,1,62374,31320,31619
11373829,11373828,TXFE7,128,9947,1,62375,31321,31620
11373942,11373932,TXFE7,128,9947,1,62376,31322,31621
11374192,11374183,TXFE7,128,9947,1,62377,31323,31622
11374242,11374234,TXFE7,128,9947,1,62378,31324,31623
11374592,11374588,TXFE7,128,9947,2,62380,31325,31625
11375004,11374992,TXFE7,128,9947,1,62381,31326,31626
11375204,11375194,TXFE7,128,9946,1,62382,31327,31627
11375692,11375679,TXFE7,128,9947,3,62385,31328,31628
11375704,11375692,TXFE7,128,9947,2,62387,31329,31630
11375704,11375692,TXFE7,128,9947,5,62392,31330,31634
11375717,11375704,TXFE7,128,9947,1,62393,31331,31635
11375967,11375961,TXFE7,128,9946,1,62394,31332,31636
11380554,11380543,TXFE7,128,9946,1,62395,31333,31637
11380742,11380740,TXFE7,128,9947,1,62396,31334,31638
11380779,11380775,TXFE7,128,9947,1,62397,31335,31639
11380867,11380863,TXFE7,128,9946,1,62398,31336,31640
11381417,11381411,TXFE7,128,9946,25,62423,31344,31641
11381454,11381442,TXFE7,128,9946,4,62427,31348,31642
11381579,11381575,TXFE7,128,9946,1,62428,31349,31643
11381592,11381586,TXFE7,128,9946,41,62469,31372,31644
11382354,11382347,TXFE7,128,9946,1,62470,31373,31645
11382917,11382910,TXFE7,128,9946,4,62474,31374,31649
11382967,11382955,TXFE7,128,9946,5,62479,31375,31650
11382979,11382967,TXFE7,128,9946,1,62480,31376,31651
11383029,11383028,TXFE7,128,9946,2,62482,31377,31652
11383704,11383701,TXFE7,128,9946,2,62484,31379,31653
11385817,11385808,TXFE7,128,9946,1,62485,31380,31654
11385942,11385941,TXFE7,128,9946,1,62486,31381,31655
11390042,11390035,TXFE7,128,9946,2,62488,31383,31656
11390292,11390291,TXFE7,128,9947,6,62497,31386,31662
11391629,11391618,TXFE7,128,9946,1,62498,31387,31663
11391992,11391983,TXFE7,128,9947,3,62501,31388,31666
11392279,11392274,TXFE7,128,9947,2,62503,31389,31667
11392979,11392972,TXFE7,128,9947,1,62504,31390,31668
11393529,11393519,TXFE7,128,9947,1,62505,31391,31669
11393592,11393590,TXFE7,128,9947,14,62519,31392,31679
11393604,11393592,TXFE7,128,9947,2,62521,31393,31680
11393604,11393592,TXFE7,128,9947,2,62523,31394,31682
11393604,11393596,TXFE7,128,9947,1,62524,31395,31683
11393617,11393604,TXFE7,128,9947,2,62526,31396,31685
11393629,11393617,TXFE7,128,9947,4,62530,31397,31688
11393629,11393617,TXFE7,128,9947,12,62542,31398,31698
11393967,11393966,TXFE7,128,9948,4,62546,31399,31700
11394317,11394306,TXFE7,128,9947,1,62547,31400,31701
11394329,11394326,TXFE7,128,9947,1,62548,31401,31702
11394404,11394400,TXFE7,128,9947,3,62551,31404,31703
11394479,11394469,TXFE7,128,9948,1,62552,31405,31704
11394692,11394681,TXFE7,128,9948,2,62554,31406,31706
11395267,11395266,TXFE7,128,9947,15,62569,31416,31707
11395279,11395277,TXFE7,128,9947,1,62570,31417,31708
11395292,11395282,TXFE7,128,9947,1,62571,31418,31709
11400129,11400124,TXFE7,128,9946,1,62572,31419,31710
11400154,11400148,TXFE7,128,9947,1,62573,31420,31711
11400154,11400153,TXFE7,129,9947,17,62604,31421,31730
11400154,11400153,TXFE7,129,9948,14,62604,31421,31730
11400242,11400232,TXFE7,128,9946,1,62605,31422,31731
11400342,11400330,TXFE7,128,9946,1,62606,31423,31732
11400367,11400361,TXFE7,128,9946,1,62607,31424,31733
11400442,11400435,TXFE7,128,9947,10,62617,31425,31737
11400454,11400452,TXFE7,128,9948,2,62619,31426,31739
11400542,11400540,TXFE7,128,9947,1,62620,31427,31740
11400567,11400566,TXFE7,129,9947,1,62622,31428,31742
11400567,11400566,TXFE7,129,9948,1,62622,31428,31742
11400579,11400569,TXFE7,128,9948,1,62623,31429,31743
11400604,11400594,TXFE7,128,9948,3,62626,31430,31744
11400767,11400762,TXFE7,128,9947,1,62627,31431,31745
11400817,11400806,TXFE7,128,9947,1,62628,31432,31746
11400942,11400930,TXFE7,128,9947,1,62629,31433,31747
11401254,11401251,TXFE7,128,9947,1,62630,31434,31748
11401379,11401370,TXFE7,128,9947,1,62631,31435,31749
11401417,11401405,TXFE7,128,9947,2,62633,31436,31750
11401992,11401986,TXFE7,128,9947,1,62634,31437,31751
11402229,11402220,TXFE7,128,9947,1,62635,31438,31752
11402729,11402723,TXFE7,128,9947,1,62636,31439,31753
11403529,11403528,TXFE7,128,9947,2,62638,31440,31755
11403979,11403978,TXFE7,128,9947,1,62639,31441,31756
11404279,11404270,TXFE7,128,9947,2,62641,31442,31758
11404442,11404436,TXFE7,128,9947,3,62644,31444,31759
11405367,11405355,TXFE7,128,9946,1,62645,31445,31760
11405779,11405776,TXFE7,128,9947,1,62646,31446,31761
11405979,11405972,TXFE7,128,9946,1,62647,31447,31762
11410029,11410024,TXFE7,128,9947,2,62649,31448,31763
11410317,11410315,TXFE7,128,9947,2,62651,31449,31764
11410329,11410321,TXFE7,128,9947,3,62654,31450,31766
11410417,11410409,TXFE7,128,9947,1,62655,31451,31767
11411229,11411220,TXFE7,128,9946,1,62656,31452,31768
11411817,11411804,TXFE7,128,9947,1,62657,31453,31769
11412392,11412384,TXFE7,128,9947,10,62667,31454,31773
11412404,11412392,TXFE7,128,9947,2,62669,31455,31775
11413017,11413016,TXFE7,128,9947,1,62670,31456,31776
11413279,11413275,TXFE7,128,9947,1,62671,31457,31777
11413554,11413552,TXFE7,128,9948,1,62672,31458,31778
11414067,11414059,TXFE7,128,9947,1,62673,31459,31779
11414192,11414187,TXFE7,128,9947,1,62674,31460,31780
11414279,11414275,TXFE7,128,9948,2,62676,31461,31781
11415042,11415040,TXFE7,128,9948,2,62678,31462,31783
11415417,11415409,TXFE7,128,9947,1,62679,31463,31784
11420379,11420374,TXFE7,128,9947,1,62680,31464,31785
11420542,11420542,TXFE7,128,9947,1,62681,31465,31786
11420879,11420874,TXFE7,128,9947,9,62690,31469,31787
11420892,11420879,TXFE7,128,9947,4,62694,31472,31788
11421142,11421137,TXFE7,128,9946,1,62695,31473,31789
11422379,11422374,TXFE7,128,9946,10,62705,31480,31790
11422417,11422414,TXFE7,128,9947,1,62706,31481,31791
11422654,11422647,TXFE7,128,9946,1,62707,31482,31792
11424242,11424241,TXFE7,128,9947,1,62708,31483,31793
11424292,11424291,TXFE7,128,9947,2,62710,31484,31795
11424329,11424328,TXFE7,128,9947,2,62712,31485,31796
11424904,11424895,TXFE7,128,9947,1,62713,31486,31797
11424929,11424926,TXFE7,128,9947,1,62714,31487,31798
11425029,11425021,TXFE7,128,9947,2,62716,31488,31800
11425267,11425258,TXFE7,128,9946,6,62722,31492,31801
11425292,11425280,TXFE7,128,9947,8,62730,31493,31807
11425417,11425409,TXFE7,128,9948,1,62731,31494,31808
11425417,11425412,TXFE7,128,9947,1,62732,31495,31809
11425692,11425684,TXFE7,128,9947,1,62733,31496,31810
11430867,11430866,TXFE7,128,9947,1,62734,31497,31811
11431492,11431484,TXFE7,128,9948,1,62735,31498,31812
11431667,11431654,TXFE7,128,9948,5,62740,31499,31817
11431667,11431654,TXFE7,128,9948,1,62741,31500,31818
11431679,11431667,TXFE7,128,9948,5,62746,31501,31820
11431704,11431697,TXFE7,128,9948,5,62751,31502,31823
11431754,11431752,TXFE7,128,9948,1,62752,31503,31824
11431804,11431796,TXFE7,128,9948,6,62758,31504,31830
11431842,11431831,TXFE7,128,9948,5,62763,31505,31834
11431854,11431846,TXFE7,128,9948,5,62768,31506,31836
11432142,11432141,TXFE7,128,9948,1,62769,31507,31837
11432179,11432167,TXFE7,128,9948,2,62771,31508,31838
11432179,11432172,TXFE7,128,9948,32,62803,31509,31857
11432179,11432172,TXFE7,128,9948,2,62805,31510,31858
11432192,11432179,TXFE7,128,9948,2,62807,31511,31860
11432192,11432179,TXFE7,128,9948,15,62822,31512,31873
11433329,11433323,TXFE7,128,9948,1,62823,31513,31874
11433442,11433440,TXFE7,128,9949,1,62824,31514,31875
11433467,11433458,TXFE7,128,9949,2,62826,31515,31877
11433467,11433458,TXFE7,128,9949,10,62836,31516,31885
11433467,11433459,TXFE7,128,9949,2,62838,31517,31887
11433479,11433471,TXFE7,128,9949,2,62840,31518,31888
11433667,11433665,TXFE7,128,9948,1,62841,31519,31889
11433679,11433669,TXFE7,128,9949,4,62845,31520,31893
11433792,11433787,TXFE7,128,9949,1,62846,31521,31894
11434104,11434099,TXFE7,128,9949,6,62852,31522,31900
11434154,11434151,TXFE7,128,9949,5,62857,31523,31904
11434154,11434153,TXFE7,128,9949,1,62858,31524,31905
11434204,11434193,TXFE7,128,9949,1,62859,31525,31906
11434204,11434193,TXFE7,128,9949,2,62861,31526,31907
11434204,11434199,TXFE7,128,9949,5,62866,31527,31908
11434254,11434246,TXFE7,128,9949,1,62867,31528,31909
11434292,11434285,TXFE7,128,9949,1,62868,31529,31910
11434379,11434375,TXFE7,128,9949,1,62869,31530,31911
11434492,11434487,TXFE7,128,9949,1,62870,31531,31912
11434617,11434613,TXFE7,128,9949,1,62871,31532,31913
11435179,11435172,TXFE7,128,9949,1,62872,31533,31914
11435979,11435976,TXFE7,128,9949,1,62873,31534,31915
11440042,11440037,TXFE7,128,9949,1,62874,31535,31916
11440054,11440045,TXFE7,128,9948,5,62879,31540,31917
11440054,11440054,TXFE7,128,9949,1,62880,31541,31918
11440067,11440064,TXFE7,128,9948,1,62881,31542,31919
11440067,11440065,TXFE7,128,9948,5,62886,31547,31920
11440079,11440078,TXFE7,128,9949,1,62887,31548,31921
11440092,11440088,TXFE7,128,9948,1,62888,31549,31922
11440117,11440116,TXFE7,128,9948,1,62889,31550,31923
11440142,11440130,TXFE7,128,9948,1,62890,31551,31924
11440167,11440154,TXFE7,128,9949,3,62893,31552,31927
11440217,11440212,TXFE7,128,9948,1,62894,31553,31928
11440479,11440470,TXFE7,128,9948,3,62897,31554,31929
11440529,11440528,TXFE7,128,9948,2,62899,31555,31930
11440579,11440567,TXFE7,128,9948,1,62900,31556,31931
11441392,11441390,TXFE7,128,9949,2,62902,31557,31933
11441504,11441497,TXFE7,128,9948,2,62904,31558,31934
11441592,11441584,TXFE7,128,9949,1,62905,31559,31935
11441854,11441850,TXFE7,128,9948,4,62909,31561,31936
11442029,11442028,TXFE7,128,9947,1,62910,31562,31937
11442267,11442260,TXFE7,128,9947,1,62911,31563,31938
11442292,11442283,TXFE7,128,9948,1,62912,31564,31939
11442304,11442292,TXFE7,128,9949,15,62927,31565,31950
11442304,11442292,TXFE7,128,9949,1,62928,31566,31951
11442304,11442292,TXFE7,128,9949,21,62949,31567,31966
11442304,11442292,TXFE7,128,9949,1,62950,31568,31967
11442304,11442292,TXFE7,128,9949,8,62958,31569,31971
11442304,11442292,TXFE7,128,9949,5,62963,31570,31973
11442304,11442293,TXFE7,128,9949,1,62964,31571,31974
11442304,11442294,TXFE7,128,9949,2,62966,31572,31976
11442304,11442295,TXFE7,128,9949,1,62967,31573,31977
11442304,11442303,TXFE7,128,9950,80,63047,31574,32024
11442317,11442304,TXFE7,128,9950,4,63051,31575,32027
11442317,11442305,TXFE7,128,9949,1,63052,31576,32028
11442317,11442308,TXFE7,128,9950,15,63067,31577,32034
11442317,11442310,TXFE7,128,9950,5,63072,31578,32037
11442317,11442311,TXFE7,128,9950,1,63073,31579,32038
11442317,11442311,TXFE7,128,9950,1,63074,31580,32039
11442317,11442312,TXFE7,128,9950,1,63075,31581,32040
11442317,11442313,TXFE7,128,9950,2,63077,31582,32042
11442317,11442314,TXFE7,128,9950,1,63078,31583,32043
11442317,11442314,TXFE7,128,9950,1,63079,31584,32044
11442317,11442315,TXFE7,128,9950,1,63080,31585,32045
11442317,11442317,TXFE7,128,9950,2,63082,31586,32047
11442329,11442317,TXFE7,128,9950,1,63083,31587,32048
11442329,11442317,TXFE7,128,9950,1,63084,31588,32049
11442329,11442317,TXFE7,128,9950,2,63086,31589,32051
11442329,11442317,TXFE7,128,9950,5,63091,31590,32055
11442329,11442317,TXFE7,128,9950,9,63100,31591,32063
11442329,11442317,TXFE7,128,9950,1,63101,31592,32064
11442329,11442319,TXFE7,128,9950,1,63102,31593,32065
11442329,11442321,TXFE7,128,9950,6,63108,31594,32066
11442329,11442322,TXFE7,128,9950,2,63110,31595,32068
11442329,11442325,TXFE7,128,9950,5,63115,31596,32073
11442329,11442325,TXFE7,128,9950,4,63119,31597,32075
11442342,11442329,TXFE7,128,9950,11,63130,31598,32081
11442342,11442336,TXFE7,128,9951,1,63131,31599,32082
11442342,11442340,TXFE7,128,9951,6,63137,31600,32088
11442354,11442343,TXFE7,128,9951,1,63138,31601,32089
11442354,11442344,TXFE7,128,9951,6,63144,31602,32095
11442354,11442345,TXFE7,128,9951,2,63146,31603,32096
11442354,11442345,TXFE7,128,9951,2,63148,31604,32098
11442354,11442345,TXFE7,128,9951,1,63149,31605,32099
11442354,11442346,TXFE7,128,9951,5,63154,31606,32100
11442354,11442346,TXFE7,128,9951,1,63155,31607,32101
11442354,11442347,TXFE7,128,9951,1,63156,31608,32102
11442354,11442348,TXFE7,128,9951,5,63161,31609,32103
11442354,11442349,TXFE7,128,9951,4,63165,31610,32106
11442354,11442349,TXFE7,128,9951,1,63166,31611,32107
11442354,11442349,TXFE7,128,9951,1,63167,31612,32108
11442354,11442350,TXFE7,128,9951,1,63168,31613,32109
11442354,11442351,TXFE7,128,9951,42,63210,31614,32137
11442354,11442351,TXFE7,128,9951,1,63211,31615,32138
11442354,11442351,TXFE7,128,9951,1,63212,31616,32139
11442354,11442351,TXFE7,128,9951,26,63238,31617,32153
11442354,11442351,TXFE7,128,9951,1,63239,31618,32154
11442354,11442351,TXFE7,128,9951,2,63241,31619,32155
11442354,11442353,TXFE7,128,9951,1,63242,31620,32156
11442354,11442353,TXFE7,128,9951,1,63243,31621,32157
11442354,11442353,TXFE7,128,9951,1,63244,31622,32158
11442354,11442353,TXFE7,128,9951,1,63245,31623,32159
11442354,11442354,TXFE7,128,9951,1,63246,31624,32160
11442354,11442354,TXFE7,128,9951,1,63247,31625,32161
11442354,11442354,TXFE7,128,9951,1,63248,31626,32162
11442354,11442354,TXFE7,128,9951,1,63249,31627,32163
11442354,11442354,TXFE7,128,9951,1,63250,31628,32164
11442367,11442355,TXFE7,128,9952,16,63266,31629,32174
11442367,11442361,TXFE7,128,9952,24,63290,31630,32185
11442367,11442363,TXFE7,128,9952,1,63291,31631,32186
11442367,11442364,TXFE7,128,9952,7,63298,31632,32190
11442367,11442365,TXFE7,128,9952,1,63299,31633,32191
11442367,11442366,TXFE7,128,9952,1,63300,31634,32192
11442367,11442366,TXFE7,128,9952,1,63301,31635,32193
11442367,11442367,TXFE7,128,9952,1,63302,31636,32194
11442379,11442368,TXFE7,128,9952,1,63303,31637,32195
11442379,11442368,TXFE7,128,9952,1,63304,31638,32196
11442379,11442368,TXFE7,128,9952,1,63305,31639,32197
11442379,11442369,TXFE7,128,9952,6,63311,31640,32203
11442379,11442370,TXFE7,128,9952,4,63315,31641,32206
11442379,11442372,TXFE7,128,9952,1,63316,31642,32207
11442379,11442372,TXFE7,128,9952,5,63321,31643,32212
11442379,11442372,TXFE7,128,9952,24,63345,31644,32226
11442379,11442373,TXFE7,128,9952,1,63346,31645,32227
11442379,11442373,TXFE7,128,9952,2,63348,31646,32229
11442379,11442374,TXFE7,128,9952,1,63349,31647,32230
11442379,11442376,TXFE7,128,9952,1,63350,31648,32231
11442379,11442377,TXFE7,128,9952,4,63354,31649,32234
11442379,11442378,TXFE7,128,9952,1,63355,31650,32235
11442392,11442379,TXFE7,128,9952,1,63356,31651,32236
11442392,11442379,TXFE7,128,9952,2,63358,31652,32238
11442392,11442385,TXFE7,129,9952,9,63382,31653,32248
11442392,11442385,TXFE7,129,9953,15,63382,31653,32248
11442392,11442385,TXFE7,128,9953,1,63383,31654,32249
11442392,11442386,TXFE7,128,9953,1,63384,31655,32250
11442392,11442388,TXFE7,128,9953,1,63385,31656,32251
11442392,11442388,TXFE7,128,9953,1,63386,31657,32252
11442404,11442392,TXFE7,128,9952,1,63387,31658,32253
11442404,11442392,TXFE7,128,9952,4,63391,31659,32254
11442404,11442395,TXFE7,128,9952,2,63393,31660,32255
11442404,11442395,TXFE7,128,9952,2,63395,31661,32256
11442404,11442396,TXFE7,128,9952,1,63396,31662,32257
11442404,11442396,TXFE7,129,9952,2,63408,31663,32263
11442404,11442396,TXFE7,129,9953,10,63408,31663,32263
11442404,11442397,TXFE7,128,9953,16,63424,31664,32276
11442404,11442398,TXFE7,128,9953,5,63429,31665,32279
11442404,11442398,TXFE7,128,9953,1,63430,31666,32280
11442404,11442399,TXFE7,128,9953,5,63435,31667,32281
11442404,11442399,TXFE7,128,9953,2,63437,31668,32283
11442404,11442400,TXFE7,128,9952,2,63439,31670,32284
11442404,11442401,TXFE7,128,9951,1,63440,31671,32285
11442404,11442402,TXFE7,128,9952,1,63441,31672,32286
11442404,11442403,TXFE7,128,9952,2,63443,31673,32287
11442404,11442403,TXFE7,128,9952,2,63445,31674,32288
11442404,11442404,TXFE7,128,9952,1,63446,31675,32289
11442404,11442404,TXFE7,128,9952,1,63447,31676,32290
11442417,11442405,TXFE7,128,9953,6,63453,31677,32295
11442417,11442407,TXFE7,128,9953,2,63455,31678,32297
11442417,11442407,TXFE7,128,9952,2,63457,31679,32298
11442417,11442407,TXFE7,128,9952,2,63459,31680,32299
11442417,11442407,TXFE7,128,9952,2,63461,31681,32300
11442417,11442407,TXFE7,128,9952,1,63462,31682,32301
11442417,11442407,TXFE7,128,9952,1,63463,31683,32302
11442417,11442410,TXFE7,128,9952,1,63464,31684,32303
11442417,11442413,TXFE7,128,9952,4,63468,31685,32306
11442417,11442413,TXFE7,128,9952,1,63469,31686,32307
11442417,11442413,TXFE7,129,9952,1,63479,31687,32312
11442417,11442413,TXFE7,129,9953,9,63479,31687,32312
11442417,11442416,TXFE7,128,9952,1,63480,31688,32313
11442417,11442416,TXFE7,128,9952,1,63481,31689,32314
11442429,11442417,TXFE7,128,9952,2,63483,31690,32315
11442429,11442417,TXFE7,128,9952,6,63489,31691,32316
11442429,11442419,TXFE7,129,9952,8,63501,31692,32324
11442429,11442419,TXFE7,129,9953,4,63501,31692,32324
11442429,11442419,TXFE7,128,9953,16,63517,31693,32333
11442429,11442419,TXFE7,128,9953,12,63529,31694,32341
11442429,11442419,TXFE7,128,9953,1,63530,31695,32342
11442429,11442420,TXFE7,128,9953,16,63546,31696,32348
11442429,11442421,TXFE7,128,9953,1,63547,31697,32349
11442429,11442422,TXFE7,128,9953,3,63550,31698,32352
11442429,11442424,TXFE7,128,9953,1,63551,31699,32353
11442429,11442424,TXFE7,128,9953,5,63556,31700,32355
11442429,11442425,TXFE7,128,9952,4,63560,31702,32356
11442429,11442427,TXFE7,128,9952,1,63561,31703,32357
11442429,11442427,TXFE7,128,9952,2,63563,31704,32358
11442429,11442429,TXFE7,130,9952,3,63569,31705,32361
11442429,11442429,TXFE7,130,9953,1,63569,31705,32361
11442429,11442429,TXFE7,130,9954,2,63569,31705,32361
11442429,11442429,TXFE7,128,9954,6,63575,31706,32366
11442442,11442430,TXFE7,128,9954,19,63594,31707,32376
11442442,11442430,TXFE7,128,9954,2,63596,31708,32377
11442442,11442435,TXFE7,129,9953,2,63601,31709,32380
11442442,11442435,TXFE7,129,9954,3,63601,31709,32380
11442442,11442436,TXFE7,128,9954,1,63602,31710,32381
11442442,11442436,TXFE7,128,9954,2,63604,31711,32382
11442442,11442436,TXFE7,128,9954,2,63606,31712,32383
11442442,11442439,TXFE7,128,9954,1,63607,31713,32384
11442442,11442439,TXFE7,128,9954,1,63608,31714,32385
11442442,11442440,TXFE7,128,9954,6,63614,31715,32389
11442454,11442442,TXFE7,128,9954,4,63618,31716,32393
11442454,11442444,TXFE7,128,9953,4,63622,31718,32394
11442454,11442444,TXFE7,128,9953,6,63628,31720,32395
11442454,11442444,TXFE7,128,9953,2,63630,31721,32396
11442454,11442444,TXFE7,128,9954,14,63644,31722,32406
11442454,11442447,TXFE7,128,9954,2,63646,31723,32407
11442454,11442447,TXFE7,128,9954,1,63647,31724,32408
11442467,11442456,TXFE7,128,9954,2,63649,31725,32409
11442467,11442457,TXFE7,128,9954,2,63651,31726,32410
11442467,11442457,TXFE7,128,9954,1,63652,31727,32411
11442467,11442459,TXFE7,128,9953,1,63653,31728,32412
11442467,11442460,TXFE7,128,9954,1,63654,31729,32413
11442467,11442463,TXFE7,128,9954,2,63656,31730,32414
11442479,11442468,TXFE7,128,9953,1,63657,31731,32415
11442479,11442474,TXFE7,128,9954,6,63663,31732,32417
11442479,11442474,TXFE7,128,9954,4,63667,31733,32421
11442479,11442479,TXFE7,128,9954,6,63673,31734,32426
11442479,11442479,TXFE7,128,9954,2,63675,31735,32428
11442492,11442481,TXFE7,128,9954,1,63676,31736,32429
11442492,11442484,TXFE7,128,9954,3,63679,31737,32431
11442492,11442489,TXFE7,128,9954,6,63685,31738,32432
11442492,11442491,TXFE7,128,9954,8,63693,31739,32436
11442492,11442491,TXFE7,128,9953,7,63700,31743,32437
11442492,11442491,TXFE7,128,9954,2,63702,31744,32439
11442504,11442492,TXFE7,128,9954,2,63704,31745,32441
11442504,11442498,TXFE7,128,9954,2,63706,31746,32442
11442504,11442499,TXFE7,128,9954,2,63708,31747,32444
11442517,11442504,TXFE7,128,9954,6,63714,31748,32446
11442517,11442506,TXFE7,128,9954,1,63715,31749,32447
11442517,11442509,TXFE7,128,9954,2,63717,31750,32448
11442517,11442510,TXFE7,128,9954,1,63718,31751,32449
11442517,11442514,TXFE7,128,9953,1,63719,31752,32450
11442517,11442514,TXFE7,128,9954,1,63720,31753,32451
11442517,11442515,TXFE7,128,9954,1,63721,31754,32452
11442529,11442519,TXFE7,128,9953,1,63722,31755,32453
11442529,11442520,TXFE7,128,9954,1,63723,31756,32454
11442529,11442521,TXFE7,128,9954,1,63724,31757,32455
11442529,11442521,TXFE7,128,9954,1,63725,31758,32456
11442529,11442522,TXFE7,128,9954,1,63726,31759,32457
11442529,11442523,TXFE7,128,9954,1,63727,31760,32458
11442529,11442524,TXFE7,128,9955,1,63728,31761,32459
11442529,11442524,TXFE7,128,9955,2,63730,31762,32460
11442529,11442525,TXFE7,128,9955,1,63731,31763,32461
11442529,11442525,TXFE7,128,9955,1,63732,31764,32462
11442529,11442527,TXFE7,128,9955,2,63734,31765,32464
11442529,11442529,TXFE7,128,9954,1,63735,31766,32465
11442542,11442530,TXFE7,128,9955,1,63736,31767,32466
11442542,11442533,TXFE7,128,9955,5,63741,31768,32468
11442542,11442534,TXFE7,128,9955,3,63744,31769,32469
11442542,11442534,TXFE7,128,9955,6,63750,31770,32473
11442542,11442535,TXFE7,128,9955,2,63752,31771,32475
11442542,11442537,TXFE7,128,9955,2,63754,31772,32477
11442542,11442540,TXFE7,128,9954,2,63756,31773,32478
11442554,11442542,TXFE7,128,9954,2,63758,31774,32479
11442554,11442551,TXFE7,129,9954,2,63764,31775,32483
11442554,11442551,TXFE7,129,9955,4,63764,31775,32483
11442567,11442556,TXFE7,128,9954,1,63765,31776,32484
11442567,11442558,TXFE7,128,9955,6,63771,31777,32487
11442567,11442559,TXFE7,128,9955,6,63777,31778,32493
11442567,11442561,TXFE7,128,9953,2,63779,31779,32494
11442567,11442563,TXFE7,128,9955,1,63780,31780,32495
11442567,11442563,TXFE7,128,9955,3,63783,31781,32498
11442567,11442565,TXFE7,128,9954,1,63784,31782,32499
11442567,11442566,TXFE7,128,9955,2,63786,31783,32500
11442579,11442571,TXFE7,128,9954,1,63787,31784,32501
11442579,11442574,TXFE7,128,9954,2,63789,31785,32502
11442579,11442578,TXFE7,128,9955,1,63790,31786,32503
11442592,11442580,TXFE7,128,9954,1,63791,31787,32504
11442592,11442581,TXFE7,128,9955,1,63792,31788,32505
11442592,11442581,TXFE7,128,9955,1,63793,31789,32506
11442592,11442586,TXFE7,128,9954,1,63794,31790,32507
11442592,11442588,TXFE7,128,9954,1,63795,31791,32508
11442592,11442589,TXFE7,128,9954,1,63796,31792,32509
11442592,11442592,TXFE7,128,9954,1,63797,31793,32510
11442604,11442594,TXFE7,128,9954,4,63801,31794,32511
11442604,11442596,TXFE7,128,9954,1,63802,31795,32512
11442604,11442597,TXFE7,128,9953,1,63803,31796,32513
11442617,11442608,TXFE7,128,9954,1,63804,31797,32514
11442617,11442609,TXFE7,128,9953,1,63805,31798,32515
11442617,11442609,TXFE7,128,9954,1,63806,31799,32516
11442617,11442610,TXFE7,128,9953,1,63807,31800,32517
11442617,11442610,TXFE7,128,9953,1,63808,31801,32518
11442617,11442611,TXFE7,128,9953,1,63809,31802,32519
11442617,11442613,TXFE7,128,9954,6,63815,31803,32521
11442617,11442615,TXFE7,128,9954,1,63816,31804,32522
11442617,11442616,TXFE7,128,9954,1,63817,31805,32523
11442629,11442622,TXFE7,128,9953,1,63818,31806,32524
11442629,11442625,TXFE7,128,9954,1,63819,31807,32525
11442642,11442631,TXFE7,128,9954,2,63821,31808,32526
11442642,11442638,TXFE7,128,9954,1,63822,31809,32527
11442654,11442642,TXFE7,128,9953,1,63823,31810,32528
11442667,11442657,TXFE7,128,9954,1,63824,31811,32529
11442667,11442663,TXFE7,128,9954,2,63826,31812,32530
11442667,11442665,TXFE7,128,9953,1,63827,31813,32531
11442679,11442677,TXFE7,128,9952,1,63828,31814,32532
11442679,11442679,TXFE7,128,9953,1,63829,31815,32533
11442704,11442693,TXFE7,128,9952,7,63836,31817,32534
11442729,11442726,TXFE7,128,9953,2,63838,31818,32536
11442742,11442740,TXFE7,128,9953,2,63840,31819,32537
11442754,11442744,TXFE7,128,9952,1,63841,31820,32538
11442767,11442765,TXFE7,128,9953,1,63842,31821,32539
11442779,11442774,TXFE7,128,9954,2,63844,31822,32541
11442779,11442778,TXFE7,128,9954,2,63846,31823,32542
11442792,11442781,TXFE7,128,9954,2,63848,31824,32543
11442792,11442782,TXFE7,128,9953,3,63851,31825,32544
11442792,11442787,TXFE7,128,9954,1,63852,31826,32545
11442792,11442791,TXFE7,128,9953,1,63853,31827,32546
11442792,11442791,TXFE7,128,9954,1,63854,31828,32547
11442804,11442799,TXFE7,128,9954,2,63856,31829,32549
11442804,11442801,TXFE7,128,9953,1,63857,31830,32550
11442829,11442823,TXFE7,128,9954,2,63859,31831,32551
11442829,11442828,TXFE7,128,9954,10,63869,31832,32554
11442842,11442836,TXFE7,128,9954,6,63875,31833,32557
11442854,11442849,TXFE7,128,9954,4,63879,31834,32558
11442867,11442854,TXFE7,128,9954,3,63882,31835,32559
11442892,11442879,TXFE7,128,9954,3,63885,31836,32560
11442892,11442887,TXFE7,128,9955,5,63890,31837,32562
11442904,11442895,TXFE7,128,9953,1,63891,31838,32563
11442904,11442904,TXFE7,128,9953,1,63892,31839,32564
11442917,11442910,TXFE7,128,9954,1,63893,31840,32565
11442942,11442938,TXFE7,128,9954,1,63894,31841,32566
11443004,11442992,TXFE7,128,9954,1,63895,31842,32567
11443004,11442994,TXFE7,128,9954,1,63896,31843,32568
11443004,11443001,TXFE7,128,9954,2,63898,31844,32570
11443017,11443010,TXFE7,128,9954,2,63900,31845,32572
11443017,11443011,TXFE7,128,9953,1,63901,31846,32573
11443017,11443013,TXFE7,128,9954,1,63902,31847,32574
11443017,11443014,TXFE7,128,9954,1,63903,31848,32575
11443042,11443041,TXFE7,128,9954,1,63904,31849,32576
11443054,11443043,TXFE7,128,9954,1,63905,31850,32577
11443054,11443050,TXFE7,128,9953,1,63906,31851,32578
11443067,11443056,TXFE7,128,9953,1,63907,31852,32579
11443067,11443060,TXFE7,128,9954,1,63908,31853,32580
11443079,11443072,TXFE7,128,9954,2,63910,31854,32582
11443079,11443072,TXFE7,128,9953,1,63911,31855,32583
11443104,11443095,TXFE7,128,9954,3,63914,31856,32586
11443117,11443113,TXFE7,128,9953,2,63916,31858,32587
11443129,11443119,TXFE7,128,9954,1,63917,31859,32588
11443154,11443145,TXFE7,128,9954,5,63922,31860,32592
11443154,11443147,TXFE7,128,9954,1,63923,31861,32593
11443167,11443157,TXFE7,128,9954,2,63925,31862,32595
11443167,11443164,TXFE7,128,9954,1,63926,31863,32596
11443179,11443175,TXFE7,128,9954,1,63927,31864,32597
11443254,11443245,TXFE7,128,9954,2,63929,31865,32598
11443254,11443248,TXFE7,128,9954,1,63930,31866,32599
11443254,11443252,TXFE7,128,9954,1,63931,31867,32600
11443279,11443277,TXFE7,128,9954,2,63933,31868,32601
11443279,11443278,TXFE7,128,9953,1,63934,31869,32602
11443317,11443308,TXFE7,128,9953,20,63954,31873,32603
11443317,11443314,TXFE7,128,9954,2,63956,31874,32605
11443354,11443349,TXFE7,128,9953,2,63958,31876,32606
11443379,11443377,TXFE7,128,9954,2,63960,31877,32608
11443454,11443450,TXFE7,128,9954,1,63961,31878,32609
11443467,11443455,TXFE7,128,9953,1,63962,31879,32610
11443467,11443459,TXFE7,128,9954,5,63967,31880,32613
11443467,11443466,TXFE7,128,9953,2,63969,31881,32614
11443492,11443491,TXFE7,128,9954,1,63970,31882,32615
11443517,11443516,TXFE7,128,9953,2,63972,31883,32616
11443529,11443519,TXFE7,128,9953,1,63973,31884,32617
11443567,11443562,TXFE7,128,9954,1,63974,31885,32618
11443567,11443564,TXFE7,128,9954,1,63975,31886,32619
11443567,11443565,TXFE7,128,9954,5,63980,31887,32621
11443567,11443566,TXFE7,128,9954,3,63983,31888,32624
11443604,11443601,TXFE7,128,9953,5,63988,31892,32625
11443629,11443621,TXFE7,128,9953,5,63993,31897,32626
11443642,11443638,TXFE7,128,9954,1,63994,31898,32627
11443654,11443646,TXFE7,128,9953,5,63999,31901,32628
11443679,11443677,TXFE7,128,9954,2,64001,31902,32630
11443692,11443679,TXFE7,128,9954,2,64003,31903,32632
11443692,11443691,TXFE7,128,9953,1,64004,31904,32633
11443742,11443741,TXFE7,128,9954,1,64005,31905,32634
11443792,11443790,TXFE7,128,9954,5,64010,31906,32635
11443817,11443805,TXFE7,128,9954,25,64035,31907,32647
11443817,11443810,TXFE7,128,9954,1,64036,31908,32648
11443817,11443816,TXFE7,128,9954,2,64038,31909,32649
11443829,11443826,TXFE7,128,9955,5,64043,31910,32653
11443842,11443829,TXFE7,128,9954,1,64044,31911,32654
11443842,11443836,TXFE7,128,9954,1,64045,31912,32655
11443854,11443842,TXFE7,128,9954,5,64050,31914,32656
11443854,11443842,TXFE7,128,9954,1,64051,31915,32657
11443854,11443850,TXFE7,128,9955,1,64052,31916,32658
11443867,11443861,TXFE7,128,9954,2,64054,31917,32660
11443879,11443869,TXFE7,128,9955,3,64057,31918,32663
11443879,11443876,TXFE7,128,9954,1,64058,31919,32664
11443892,11443886,TXFE7,128,9955,1,64059,31920,32665
11443904,11443892,TXFE7,128,9954,6,64065,31922,32666
11443904,11443897,TXFE7,128,9955,2,64067,31923,32668
11443917,11443907,TXFE7,128,9955,1,64068,31924,32669
11443929,11443926,TXFE7,128,9954,1,64069,31925,32670
11443929,11443928,TXFE7,128,9955,1,64070,31926,32671
11443929,11443929,TXFE7,128,9955,1,64071,31927,32672
11443942,11443930,TXFE7,128,9955,1,64072,31928,32673
11443942,11443932,TXFE7,128,9954,5,64077,31929,32674
11443954,11443953,TXFE7,128,9955,1,64078,31930,32675
11444092,11444085,TXFE7,128,9953,1,64079,31931,32676
11444092,11444088,TXFE7,128,9954,2,64081,31932,32678
11444104,11444095,TXFE7,128,9955,1,64082,31933,32679
11444104,11444098,TXFE7,128,9953,1,64083,31934,32680
11444154,11444145,TXFE7,129,9954,2,64089,31935,32684
11444154,11444145,TXFE7,129,9955,4,64089,31935,32684
11444167,11444158,TXFE7,128,9954,1,64090,31936,32685
11444179,11444168,TXFE7,128,9955,1,64091,31937,32686
11444179,11444172,TXFE7,128,9954,2,64093,31938,32687
11444192,11444181,TXFE7,128,9954,1,64094,31939,32688
11444192,11444191,TXFE7,128,9954,1,64095,31940,32689
11444204,11444196,TXFE7,128,9954,1,64096,31941,32690
11444204,11444198,TXFE7,128,9954,1,64097,31942,32691
11444204,11444202,TXFE7,128,9954,3,64100,31943,32692
11444217,11444211,TXFE7,128,9954,1,64101,31944,32693
11444229,11444218,TXFE7,128,9954,1,64102,31945,32694
11444229,11444221,TXFE7,128,9954,1,64103,31946,32695
11444254,11444245,TXFE7,128,9955,5,64108,31947,32699
11444267,11444259,TXFE7,128,9955,1,64109,31948,32700
11444304,11444298,TXFE7,128,9954,2,64111,31949,32701
11444342,11444330,TXFE7,129,9954,9,64171,31977,32702
11444342,11444330,TXFE7,129,9953,51,64171,31977,32702
11444354,11444349,TXFE7,128,9954,25,64196,31978,32716
11444367,11444355,TXFE7,128,9953,2,64198,31980,32717
11444367,11444367,TXFE7,128,9955,1,64199,31981,32718
11444392,11444379,TXFE7,128,9954,1,64200,31982,32719
11444404,11444393,TXFE7,128,9953,1,64201,31983,32720
11444404,11444393,TXFE7,128,9955,7,64208,31984,32725
11444404,11444401,TXFE7,128,9955,4,64212,31985,32728
11444417,11444408,TXFE7,128,9954,1,64213,31986,32729
11444429,11444417,TXFE7,128,9954,2,64215,31988,32730
11444442,11444437,TXFE7,128,9955,1,64216,31989,32731
11444442,11444441,TXFE7,128,9955,1,64217,31990,32732
11444454,11444444,TXFE7,128,9955,1,64218,31991,32733
11444454,11444448,TXFE7,128,9955,1,64219,31992,32734
11444454,11444449,TXFE7,128,9955,1,64220,31993,32735
11444479,11444468,TXFE7,128,9953,1,64221,31994,32736
11444479,11444476,TXFE7,128,9954,1,64222,31995,32737
11444492,11444486,TXFE7,128,9953,1,64223,31996,32738
11444504,11444495,TXFE7,128,9954,2,64225,31997,32739
11444504,11444504,TXFE7,129,9954,6,64234,31998,32744
11444504,11444504,TXFE7,129,9955,3,64234,31998,32744
11444529,11444520,TXFE7,128,9955,3,64237,31999,32747
11444579,11444568,TXFE7,128,9955,1,64238,32000,32748
11444579,11444572,TXFE7,128,9955,5,64243,32001,32751
11444629,11444622,TXFE7,128,9955,1,64244,32002,32752
11444667,11444660,TXFE7,128,9955,42,64286,32003,32774
11444667,11444662,TXFE7,128,9955,5,64291,32004,32778
11444679,11444667,TXFE7,128,9955,6,64297,32005,32780
11444679,11444667,TXFE7,128,9955,2,64299,32006,32781
11444679,11444667,TXFE7,128,9955,4,64303,32007,32783
11444679,11444667,TXFE7,128,9955,4,64307,32008,32785
11444679,11444667,TXFE7,128,9955,13,64320,32009,32797
11444692,11444688,TXFE7,128,9955,2,64322,32010,32798
11444704,11444693,TXFE7,128,9956,1,64323,32011,32799
11444704,11444694,TXFE7,128,9956,8,64331,32012,32805
11444717,11444705,TXFE7,128,9956,1,64332,32013,32806
11444717,11444705,TXFE7,128,9956,1,64333,32014,32807
11444717,11444705,TXFE7,128,9956,1,64334,32015,32808
11444717,11444705,TXFE7,128,9956,4,64338,32016,32811
11444717,11444706,TXFE7,128,9956,6,64344,32017,32817
11444717,11444706,TXFE7,128,9955,1,64345,32018,32818
11444717,11444706,TXFE7,128,9956,10,64355,32019,32826
11444717,11444708,TXFE7,128,9956,5,64360,32020,32827
11444717,11444712,TXFE7,128,9956,1,64361,32021,32828
11444717,11444714,TXFE7,128,9956,4,64365,32022,32829
11444729,11444720,TXFE7,128,9956,2,64367,32023,32830
11444729,11444722,TXFE7,128,9955,1,64368,32024,32831
11444729,11444724,TXFE7,128,9956,4,64372,32025,32832
11444729,11444725,TXFE7,128,9956,2,64374,32026,32833
11444729,11444725,TXFE7,128,9956,1,64375,32027,32834
11444729,11444726,TXFE7,128,9956,10,64385,32028,32836
11444729,11444726,TXFE7,128,9956,1,64386,32029,32837
11444742,11444731,TXFE7,128,9956,5,64391,32030,32842
11444742,11444733,TXFE7,128,9955,1,64392,32031,32843
11444742,11444734,TXFE7,128,9956,1,64393,32032,32844
11444742,11444734,TXFE7,128,9956,1,64394,32033,32845
11444742,11444736,TXFE7,128,9956,2,64396,32034,32846
11444767,11444759,TXFE7,128,9956,10,64406,32035,32852
11444792,11444785,TXFE7,128,9956,1,64407,32036,32853
11444792,11444786,TXFE7,128,9956,2,64409,32037,32855
11444817,11444812,TXFE7,128,9956,11,64420,32038,32863
11444817,11444814,TXFE7,128,9955,1,64421,32039,32864
11444829,11444819,TXFE7,128,9956,1,64422,32040,32865
11444829,11444824,TXFE7,128,9955,1,64423,32041,32866
11444842,11444829,TXFE7,128,9955,1,64424,32042,32867
11444842,11444836,TXFE7,128,9955,1,64425,32043,32868
11444854,11444846,TXFE7,128,9955,1,64426,32044,32869
11444854,11444847,TXFE7,128,9955,1,64427,32045,32870
11444867,11444858,TXFE7,128,9955,1,64428,32046,32871
11444867,11444865,TXFE7,128,9956,1,64429,32047,32872
11444904,11444897,TXFE7,128,9955,1,64430,32048,32873
11444917,11444905,TXFE7,128,9956,1,64431,32049,32874
11444954,11444950,TXFE7,128,9956,3,64434,32050,32876
11444979,11444968,TXFE7,128,9956,1,64435,32051,32877
11444979,11444971,TXFE7,128,9956,1,64436,32052,32878
11444979,11444974,TXFE7,128,9956,1,64437,32053,32879
11444992,11444979,TXFE7,128,9956,1,64438,32054,32880
11445004,11444992,TXFE7,128,9956,2,64440,32055,32881
11445004,11444992,TXFE7,128,9956,2,64442,32056,32882
11445004,11445001,TXFE7,128,9957,1,64443,32057,32883
11445017,11445006,TXFE7,128,9957,6,64449,32058,32888
11445017,11445007,TXFE7,128,9957,2,64451,32059,32890
11445017,11445008,TXFE7,128,9957,5,64456,32060,32893
11445017,11445009,TXFE7,128,9956,2,64458,32061,32894
11445017,11445010,TXFE7,128,9957,3,64461,32062,32895
11445017,11445010,TXFE7,128,9957,5,64466,32063,32896
11445017,11445010,TXFE7,128,9957,6,64472,32064,32897
11445017,11445010,TXFE7,128,9957,1,64473,32065,32898
11445017,11445012,TXFE7,128,9957,10,64483,32066,32908
11445029,11445018,TXFE7,128,9957,6,64489,32067,32912
11445029,11445021,TXFE7,128,9957,6,64495,32068,32915
11445029,11445029,TXFE7,128,9957,37,64532,32069,32932
11445042,11445038,TXFE7,128,9956,5,64537,32073,32933
11445042,11445040,TXFE7,128,9957,1,64538,32074,32934
11445054,11445051,TXFE7,128,9957,1,64539,32075,32935
11445067,11445064,TXFE7,128,9957,2,64541,32076,32937
11445067,11445066,TXFE7,128,9957,5,64546,32077,32938
11445079,11445070,TXFE7,128,9957,7,64553,32078,32939
11445079,11445071,TXFE7,128,9958,2,64555,32079,32940
11445079,11445073,TXFE7,128,9956,1,64556,32080,32941
11445079,11445075,TXFE7,128,9958,1,64557,32081,32942
11445092,11445079,TXFE7,128,9957,3,64560,32082,32943
11445092,11445081,TXFE7,128,9957,3,64563,32084,32944
11445092,11445081,TXFE7,128,9957,1,64564,32085,32945
11445092,11445082,TXFE7,128,9958,1,64565,32086,32946
11445092,11445082,TXFE7,128,9957,6,64571,32089,32947
11445092,11445083,TXFE7,128,9958,1,64572,32090,32948
11445092,11445083,TXFE7,128,9958,1,64573,32091,32949
11445092,11445083,TXFE7,128,9956,2,64575,32093,32950
11445092,11445083,TXFE7,128,9958,5,64580,32094,32953
11445092,11445083,TXFE7,128,9958,10,64590,32095,32961
11445092,11445084,TXFE7,128,9958,1,64591,32096,32962
11445092,11445084,TXFE7,128,9956,2,64593,32098,32963
11445092,11445084,TXFE7,128,9958,1,64594,32099,32964
11445092,11445085,TXFE7,128,9958,3,64597,32100,32967
11445092,11445086,TXFE7,128,9958,1,64598,32101,32968
11445092,11445086,TXFE7,128,9958,1,64599,32102,32969
11445092,11445090,TXFE7,128,9958,3,64602,32103,32972
11445104,11445095,TXFE7,128,9958,2,64604,32104,32973
11445104,11445098,TXFE7,128,9958,1,64605,32105,32974
11445104,11445101,TXFE7,128,9957,1,64606,32106,32975
11445104,11445102,TXFE7,128,9958,3,64609,32107,32977
11445104,11445102,TXFE7,128,9957,1,64610,32108,32978
11445104,11445103,TXFE7,128,9958,3,64613,32109,32980
11445117,11445105,TXFE7,128,9958,2,64615,32110,32981
11445117,11445106,TXFE7,128,9958,1,64616,32111,32982
11445117,11445106,TXFE7,128,9957,6,64622,32113,32983
11445117,11445109,TXFE7,128,9958,39,64661,32114,33013
11445117,11445116,TXFE7,128,9958,3,64664,32115,33015
11445142,11445137,TXFE7,128,9957,1,64665,32116,33016
11445154,11445146,TXFE7,128,9957,1,64666,32117,33017
11445154,11445150,TXFE7,128,9958,2,64668,32118,33019
11445154,11445153,TXFE7,128,9958,1,64669,32119,33020
11445167,11445154,TXFE7,128,9957,1,64670,32120,33021
11445167,11445157,TXFE7,128,9958,1,64671,32121,33022
11445167,11445165,TXFE7,128,9957,5,64676,32122,33023
11445179,11445167,TXFE7,128,9957,3,64679,32124,33024
11445179,11445171,TXFE7,128,9957,1,64680,32125,33025
11445179,11445174,TXFE7,128,9958,75,64755,32126,33067
11445179,11445176,TXFE7,128,9957,1,64756,32127,33068
11445192,11445179,TXFE7,128,9957,1,64757,32128,33069
11445192,11445180,TXFE7,128,9958,1,64758,32129,33070
11445204,11445193,TXFE7,128,9958,5,64763,32130,33075
11445204,11445196,TXFE7,128,9958,1,64764,32131,33076
11445204,11445203,TXFE7,128,9958,5,64769,32132,33077
11445217,11445207,TXFE7,128,9957,1,64770,32133,33078
11445217,11445212,TXFE7,128,9957,1,64771,32134,33079
11445229,11445218,TXFE7,128,9958,1,64772,32135,33080
11445229,11445228,TXFE7,128,9958,2,64774,32136,33082
11445242,11445232,TXFE7,128,9958,1,64775,32137,33083
11445242,11445236,TXFE7,128,9958,1,64776,32138,33084
11445254,11445245,TXFE7,128,9958,10,64786,32139,33088
11445254,11445245,TXFE7,128,9957,10,64796,32144,33089
11445254,11445249,TXFE7,128,9958,1,64797,32145,33090
11445267,11445262,TXFE7,128,9958,7,64804,32146,33095
11445279,11445271,TXFE7,128,9958,1,64805,32147,33096
11445279,11445277,TXFE7,128,9956,1,64806,32148,33097
11445292,11445285,TXFE7,128,9957,2,64808,32149,33098
11445292,11445288,TXFE7,128,9957,1,64809,32150,33099
11445304,11445292,TXFE7,128,9957,2,64811,32151,33100
11445304,11445298,TXFE7,128,9956,2,64813,32152,33101
11445304,11445299,TXFE7,128,9957,1,64814,32153,33102
11445304,11445301,TXFE7,128,9957,1,64815,32154,33103
11445304,11445302,TXFE7,129,9957,1,64817,32156,33104
11445304,11445302,TXFE7,129,9956,1,64817,32156,33104
11445342,11445338,TXFE7,128,9957,1,64818,32157,33105
11445354,11445349,TXFE7,128,9957,1,64819,32158,33106
11445367,11445359,TXFE7,128,9957,3,64822,32159,33107
11445367,11445366,TXFE7,128,9957,3,64825,32160,33108
11445379,11445367,TXFE7,128,9957,1,64826,32161,33109
11445379,11445376,TXFE7,128,9958,1,64827,32162,33110
11445379,11445378,TXFE7,128,9958,2,64829,32163,33112
11445392,11445383,TXFE7,128,9958,1,64830,32164,33113
11445404,11445392,TXFE7,128,9957,3,64833,32167,33114
11445404,11445396,TXFE7,128,9957,1,64834,32168,33115
11445429,11445419,TXFE7,128,9957,1,64835,32169,33116
11445429,11445420,TXFE7,129,9957,2,64842,32170,33121
11445429,11445420,TXFE7,129,9958,5,64842,32170,33121
11445429,11445422,TXFE7,128,9958,2,64844,32171,33122
11445442,11445432,TXFE7,128,9957,15,64859,32177,33123
11445442,11445434,TXFE7,128,9957,1,64860,32178,33124
11445442,11445439,TXFE7,128,9957,3,64863,32179,33125
11445454,11445452,TXFE7,128,9956,9,64872,32182,33126
11445467,11445458,TXFE7,128,9957,1,64873,32183,33127
11445479,11445472,TXFE7,128,9957,1,64874,32184,33128
11445479,11445475,TXFE7,128,9956,1,64875,32185,33129
11445479,11445479,TXFE7,128,9957,3,64878,32186,33130
11445492,11445485,TXFE7,128,9957,2,64880,32187,33132
11445492,11445490,TXFE7,128,9958,1,64881,32188,33133
11445504,11445492,TXFE7,128,9957,14,64895,32190,33134
11445517,11445504,TXFE7,128,9957,2,64897,32192,33135
11445542,11445530,TXFE7,128,9957,1,64898,32193,33136
11445554,11445542,TXFE7,128,9957,3,64901,32194,33137
11445554,11445543,TXFE7,128,9958,1,64902,32195,33138
11445554,11445551,TXFE7,128,9956,1,64903,32196,33139
11445567,11445557,TXFE7,128,9957,1,64904,32197,33140
11445579,11445577,TXFE7,128,9957,1,64905,32198,33141
11445579,11445579,TXFE7,128,9958,1,64906,32199,33142
11445592,11445580,TXFE7,128,9956,1,64907,32200,33143
11445592,11445585,TXFE7,128,9957,1,64908,32201,33144
11445617,11445604,TXFE7,128,9957,1,64909,32202,33145
11445629,11445617,TXFE7,128,9957,1,64910,32203,33146
11445629,11445623,TXFE7,128,9958,8,64918,32204,33149
11445629,11445626,TXFE7,128,9958,2,64920,32205,33151
11445642,11445639,TXFE7,128,9956,1,64921,32206,33152
11445654,11445649,TXFE7,128,9957,1,64922,32207,33153
11445667,11445660,TXFE7,128,9957,1,64923,32208,33154
11445679,11445670,TXFE7,128,9957,2,64925,32210,33155
11445754,11445750,TXFE7,128,9958,3,64928,32211,33156
11445779,11445767,TXFE7,128,9957,1,64929,32212,33157
11445779,11445773,TXFE7,128,9957,1,64930,32213,33158
11445792,11445788,TXFE7,128,9957,1,64931,32214,33159
11445804,11445795,TXFE7,128,9958,5,64936,32215,33163
11445829,11445817,TXFE7,128,9958,1,64937,32216,33164
11445829,11445822,TXFE7,128,9957,1,64938,32217,33165
11445829,11445823,TXFE7,128,9958,4,64942,32218,33167
11445842,11445831,TXFE7,128,9958,2,64944,32219,33168
11445842,11445838,TXFE7,128,9957,1,64945,32220,33169
11445879,11445873,TXFE7,128,9958,10,64955,32221,33176
11445892,11445886,TXFE7,128,9958,3,64958,32222,33178
11445904,11445896,TXFE7,128,9958,3,64961,32223,33180
11445917,11445913,TXFE7,128,9958,1,64962,32224,33181
11445942,11445932,TXFE7,128,9958,1,64963,32225,33182
11445942,11445936,TXFE7,128,9958,1,64964,32226,33183
11445954,11445942,TXFE7,128,9958,4,64968,32227,33184
11445954,11445942,TXFE7,128,9958,7,64975,32228,33185
11445954,11445945,TXFE7,128,9958,1,64976,32229,33186
11445954,11445945,TXFE7,128,9959,1,64977,32230,33187
11445967,11445955,TXFE7,129,9958,2,64996,32231,33204
11445967,11445955,TXFE7,129,9959,17,64996,32231,33204
11445967,11445955,TXFE7,128,9959,2,64998,32232,33206
11445967,11445955,TXFE7,128,9959,1,64999,32233,33207
11445967,11445957,TXFE7,128,9959,1,65000,32234,33208
11445967,11445957,TXFE7,128,9959,5,65005,32235,33212
11445967,11445958,TXFE7,128,9957,1,65006,32236,33213
11445967,11445958,TXFE7,128,9959,5,65011,32237,33218
11445967,11445959,TXFE7,129,9958,2,65014,32238,33221
11445967,11445959,TXFE7,129,9959,1,65014,32238,33221
11445967,11445959,TXFE7,128,9959,10,65024,32239,33222
11445967,11445959,TXFE7,128,9957,2,65026,32240,33223
11445967,11445960,TXFE7,129,9958,1,65031,32241,33226
11445967,11445960,TXFE7,129,9959,4,65031,32241,33226
11445967,11445960,TXFE7,128,9959,1,65032,32242,33227
11445967,11445961,TXFE7,128,9959,1,65033,32243,33228
11445967,11445961,TXFE7,128,9959,3,65036,32244,33231
11445967,11445963,TXFE7,128,9959,2,65038,32245,33233
11445967,11445964,TXFE7,128,9959,30,65068,32246,33249
11445967,11445964,TXFE7,128,9959,2,65070,32247,33250
11445967,11445965,TXFE7,128,9959,1,65071,32248,33251
11445967,11445965,TXFE7,128,9959,1,65072,32249,33252
11445967,11445966,TXFE7,128,9959,6,65078,32250,33254
11445979,11445967,TXFE7,128,9959,3,65081,32251,33257
11445979,11445969,TXFE7,128,9958,3,65084,32253,33258
11445979,11445969,TXFE7,128,9960,1,65085,32254,33259
11445979,11445970,TXFE7,128,9959,1,65086,32255,33260
11445979,11445970,TXFE7,128,9960,3,65089,32256,33261
11445979,11445972,TXFE7,128,9960,1,65090,32257,33262
11445979,11445974,TXFE7,128,9960,1,65091,32258,33263
11445979,11445974,TXFE7,128,9960,2,65093,32259,33265
11445979,11445974,TXFE7,128,9960,1,65094,32260,33266
11445979,11445975,TXFE7,128,9960,1,65095,32261,33267
11445979,11445975,TXFE7,128,9960,1,65096,32262,33268
11445979,11445976,TXFE7,128,9960,15,65111,32263,33280
11445979,11445976,TXFE7,128,9960,1,65112,32264,33281
11445979,11445976,TXFE7,128,9960,2,65114,32265,33283
11445979,11445976,TXFE7,128,9960,9,65123,32266,33289
11445979,11445977,TXFE7,128,9960,3,65126,32267,33290
11445979,11445977,TXFE7,128,9960,1,65127,32268,33291
11445992,11445980,TXFE7,128,9959,6,65133,32271,33292
11445992,11445980,TXFE7,128,9959,1,65134,32272,33293
11445992,11445980,TXFE7,128,9960,1,65135,32273,33294
11445992,11445981,TXFE7,128,9960,5,65140,32274,33298
11445992,11445981,TXFE7,128,9960,4,65144,32275,33301
11445992,11445982,TXFE7,128,9959,1,65145,32276,33302
11445992,11445982,TXFE7,128,9960,16,65161,32277,33309
11445992,11445982,TXFE7,128,9960,3,65164,32278,33312
11445992,11445982,TXFE7,128,9959,1,65165,32279,33313
11445992,11445984,TXFE7,128,9960,9,65174,32280,33318
11445992,11445985,TXFE7,128,9960,1,65175,32281,33319
11445992,11445986,TXFE7,128,9960,3,65178,32282,33320
11445992,11445986,TXFE7,128,9960,1,65179,32283,33321
11445992,11445986,TXFE7,128,9960,2,65181,32284,33323
11445992,11445986,TXFE7,128,9960,5,65186,32285,33328
11445992,11445987,TXFE7,128,9960,15,65201,32286,33336
11445992,11445987,TXFE7,128,9960,15,65216,32287,33337
11445992,11445989,TXFE7,128,9960,1,65217,32288,33338
11445992,11445989,TXFE7,128,9960,3,65220,32289,33339
11445992,11445990,TXFE7,128,9960,2,65222,32290,33340
11445992,11445990,TXFE7,128,9960,4,65226,32291,33341
11445992,11445991,TXFE7,128,9960,4,65230,32292,33342
11445992,11445991,TXFE7,128,9960,2,65232,32293,33343
11445992,11445991,TXFE7,128,9960,1,65233,32294,33344
11445992,11445992,TXFE7,128,9960,1,65234,32295,33345
11445992,11445992,TXFE7,128,9960,1,65235,32296,33346
11445992,11445992,TXFE7,128,9960,1,65236,32297,33347
11450004,11445992,TXFE7,128,9960,8,65244,32298,33352
11450004,11445992,TXFE7,128,9960,8,65252,32299,33359
11450004,11445992,TXFE7,128,9960,8,65260,32300,33365
11450004,11445993,TXFE7,128,9960,1,65261,32301,33366
11450004,11445993,TXFE7,128,9960,4,65265,32302,33368
11450004,11445993,TXFE7,128,9960,1,65266,32303,33369
11450004,11445993,TXFE7,128,9960,8,65274,32304,33371
11450004,11445993,TXFE7,128,9960,2,65276,32305,33373
11450004,11445994,TXFE7,128,9960,1,65277,32306,33374
11450004,11445995,TXFE7,128,9960,5,65282,32307,33379
11450004,11445996,TXFE7,128,9960,4,65286,32308,33382
11450004,11445997,TXFE7,128,9959,10,65296,32313,33383
11450004,11445997,TXFE7,128,9960,1,65297,32314,33384
11450004,11445998,TXFE7,128,9960,2,65299,32315,33386
11450004,11445999,TXFE7,128,9960,2,65301,32316,33388
11450004,11450000,TXFE7,128,9960,3,65304,32317,33389
11450004,11450000,TXFE7,128,9960,1,65305,32318,33390
11450004,11450001,TXFE7,128,9959,2,65307,32320,33391
11450004,11450001,TXFE7,128,9959,1,65308,32321,33392
11450004,11450001,TXFE7,128,9960,2,65310,32322,33394
11450004,11450002,TXFE7,128,9960,10,65320,32323,33399
11450004,11450002,TXFE7,128,9960,4,65324,32324,33403
11450004,11450002,TXFE7,128,9960,2,65326,32325,33405
11450004,11450004,TXFE7,128,9959,9,65335,32329,33406
11450004,11450004,TXFE7,128,9960,4,65339,32330,33409
11450017,11450004,TXFE7,128,9960,3,65342,32331,33410
11450017,11450004,TXFE7,128,9960,3,65345,32332,33413
11450017,11450004,TXFE7,128,9960,1,65346,32333,33414
11450017,11450004,TXFE7,128,9960,4,65350,32334,33418
11450017,11450004,TXFE7,128,9960,2,65352,32335,33419
11450017,11450005,TXFE7,128,9961,2,65354,32336,33420
11450017,11450005,TXFE7,128,9961,5,65359,32337,33424
11450017,11450005,TXFE7,128,9961,2,65361,32338,33425
11450017,11450005,TXFE7,128,9960,2,65363,32340,33426
11450017,11450006,TXFE7,129,9960,1,65365,32342,33427
11450017,11450006,TXFE7,129,9959,1,65365,32342,33427
11450017,11450007,TXFE7,128,9961,5,65370,32343,33430
11450017,11450007,TXFE7,128,9961,4,65374,32344,33432
11450017,11450008,TXFE7,128,9961,1,65375,32345,33433
11450017,11450010,TXFE7,128,9961,1,65376,32346,33434
11450017,11450011,TXFE7,128,9961,1,65377,32347,33435
11450017,11450013,TXFE7,128,9961,2,65379,32348,33437
11450017,11450013,TXFE7,128,9961,2,65381,32349,33439
11450017,11450014,TXFE7,128,9961,6,65387,32350,33444
11450017,11450015,TXFE7,128,9961,1,65388,32351,33445
11450029,11450017,TXFE7,128,9961,2,65390,32352,33447
11450029,11450017,TXFE7,128,9961,1,65391,32353,33448
11450029,11450017,TXFE7,128,9961,37,65428,32354,33474
11450029,11450018,TXFE7,128,9962,1,65429,32355,33475
11450029,11450018,TXFE7,128,9962,1,65430,32356,33476
11450029,11450018,TXFE7,128,9962,4,65434,32357,33480
11450029,11450019,TXFE7,128,9962,2,65436,32358,33482
11450029,11450019,TXFE7,128,9962,2,65438,32359,33483
11450029,11450021,TXFE7,128,9962,2,65440,32360,33485
11450029,11450022,TXFE7,128,9962,2,65442,32361,33486
11450029,11450022,TXFE7,128,9962,2,65444,32362,33487
11450029,11450023,TXFE7,128,9962,5,65449,32363,33488
11450029,11450024,TXFE7,128,9962,1,65450,32364,33489
11450029,11450024,TXFE7,128,9962,1,65451,32365,33490
11450029,11450025,TXFE7,128,9962,1,65452,32366,33491
11450029,11450025,TXFE7,128,9962,12,65464,32367,33495
11450029,11450026,TXFE7,128,9962,1,65465,32368,33496
11450029,11450026,TXFE7,128,9962,2,65467,32369,33498
11450029,11450027,TXFE7,128,9960,1,65468,32370,33499
11450029,11450028,TXFE7,128,9962,1,65469,32371,33500
11450029,11450028,TXFE7,128,9962,2,65471,32372,33502
11450029,11450028,TXFE7,128,9962,14,65485,32373,33511
11450029,11450029,TXFE7,128,9962,4,65489,32374,33512
11450042,11450029,TXFE7,128,9961,1,65490,32375,33513
11450042,11450029,TXFE7,128,9961,1,65491,32376,33514
11450042,11450029,TXFE7,128,9962,10,65501,32377,33516
11450042,11450030,TXFE7,128,9962,2,65503,32378,33517
11450042,11450030,TXFE7,128,9962,2,65505,32379,33519
11450042,11450030,TXFE7,128,9962,2,65507,32380,33521
11450042,11450031,TXFE7,128,9962,1,65508,32381,33522
11450042,11450033,TXFE7,128,9962,1,65509,32382,33523
11450042,11450033,TXFE7,128,9962,5,65514,32383,33525
11450042,11450034,TXFE7,128,9961,2,65516,32385,33526
11450042,11450035,TXFE7,128,9962,1,65517,32386,33527
11450042,11450036,TXFE7,128,9962,6,65523,32387,33528
11450042,11450038,TXFE7,128,9962,1,65524,32388,33529
11450042,11450038,TXFE7,128,9962,1,65525,32389,33530
11450042,11450039,TXFE7,128,9962,2,65527,32390,33531
11450042,11450040,TXFE7,128,9962,1,65528,32391,33532
11450042,11450040,TXFE7,128,9962,1,65529,32392,33533
11450042,11450040,TXFE7,128,9962,1,65530,32393,33534
11450042,11450041,TXFE7,128,9961,1,65531,32394,33535
11450042,11450041,TXFE7,128,9961,19,65550,32400,33536
11450054,11450043,TXFE7,128,9962,2,65552,32401,33538
11450054,11450044,TXFE7,128,9962,10,65562,32402,33540
11450054,11450044,TXFE7,128,9962,5,65567,32403,33543
11450054,11450044,TXFE7,129,9962,8,65619,32404,33559
11450054,11450044,TXFE7,129,9963,44,65619,32404,33559
11450054,11450047,TXFE7,128,9962,1,65620,32405,33560
11450054,11450048,TXFE7,128,9962,1,65621,32406,33561
11450054,11450049,TXFE7,128,9962,3,65624,32407,33562
11450054,11450050,TXFE7,128,9962,1,65625,32408,33563
11450054,11450053,TXFE7,128,9962,4,65629,32409,33565
11450067,11450058,TXFE7,128,9962,5,65634,32410,33569
11450067,11450058,TXFE7,128,9962,1,65635,32411,33570
11450067,11450059,TXFE7,129,9962,13,65687,32412,33589
11450067,11450059,TXFE7,129,9963,39,65687,32412,33589
11450067,11450060,TXFE7,128,9963,3,65690,32413,33592
11450067,11450060,TXFE7,128,9962,1,65691,32414,33593
11450067,11450061,TXFE7,128,9962,2,65693,32415,33594
11450067,11450063,TXFE7,128,9962,6,65699,32416,33596
11450067,11450063,TXFE7,129,9962,2,65704,32417,33598
11450067,11450063,TXFE7,129,9963,3,65704,32417,33598
11450067,11450063,TXFE7,128,9963,8,65712,32418,33602
11450067,11450064,TXFE7,128,9963,1,65713,32419,33603
11450067,11450064,TXFE7,128,9963,3,65716,32420,33604
11450067,11450064,TXFE7,128,9962,1,65717,32421,33605
11450067,11450064,TXFE7,128,9962,6,65723,32422,33606
11450067,11450066,TXFE7,128,9962,1,65724,32423,33607
11450079,11450067,TXFE7,128,9962,1,65725,32424,33608
11450079,11450067,TXFE7,128,9962,1,65726,32425,33609
11450079,11450067,TXFE7,128,9962,3,65729,32426,33610
11450079,11450067,TXFE7,128,9963,7,65736,32427,33616
11450079,11450067,TXFE7,128,9963,1,65737,32428,33617
11450079,11450068,TXFE7,128,9962,3,65740,32430,33618
11450079,11450068,TXFE7,128,9963,2,65742,32431,33619
11450079,11450072,TXFE7,128,9963,6,65748,32432,33623
11450079,11450072,TXFE7,128,9962,1,65749,32433,33624
11450079,11450074,TXFE7,129,9962,3,65759,32439,33625
11450079,11450074,TXFE7,129,9961,7,65759,32439,33625
11450079,11450075,TXFE7,128,9961,1,65760,32440,33626
11450079,11450075,TXFE7,130,9962,1,65766,32441,33632
11450079,11450075,TXFE7,130,9963,4,65766,32441,33632
11450079,11450075,TXFE7,130,9964,1,65766,32441,33632
11450079,11450075,TXFE7,128,9964,6,65772,32442,33634
11450079,11450075,TXFE7,128,9962,2,65774,32444,33635
11450079,11450078,TXFE7,130,9962,6,65782,32445,33638
11450079,11450078,TXFE7,130,9963,1,65782,32445,33638
11450079,11450078,TXFE7,130,9964,1,65782,32445,33638
11450079,11450078,TXFE7,128,9962,1,65783,32446,33639
11450092,11450079,TXFE7,128,9962,1,65784,32447,33640
11450092,11450079,TXFE7,128,9962,2,65786,32448,33641
11450092,11450079,TXFE7,128,9962,1,65787,32449,33642
11450092,11450082,TXFE7,128,9963,1,65788,32450,33643
11450092,11450082,TXFE7,128,9962,1,65789,32451,33644
11450092,11450083,TXFE7,128,9963,1,65790,32452,33645
11450092,11450083,TXFE7,129,9963,7,65827,32453,33670
11450092,11450083,TXFE7,129,9964,30,65827,32453,33670
11450092,11450084,TXFE7,128,9964,1,65828,32454,33671
11450092,11450084,TXFE7,129,9963,1,65832,32457,33672
11450092,11450084,TXFE7,129,9962,3,65832,32457,33672
11450092,11450084,TXFE7,128,9963,1,65833,32458,33673
11450092,11450085,TXFE7,128,9964,5,65838,32459,33677
11450092,11450085,TXFE7,128,9964,6,65844,32460,33683
11450092,11450087,TXFE7,128,9964,1,65845,32461,33684
11450092,11450087,TXFE7,128,9964,1,65846,32462,33685
11450092,11450087,TXFE7,128,9962,3,65849,32465,33686
11450092,11450087,TXFE7,128,9962,1,65850,32466,33687
11450092,11450088,TXFE7,129,9962,1,65852,32468,33688
11450092,11450088,TXFE7,129,9961,1,65852,32468,33688
11450092,11450089,TXFE7,128,9963,1,65853,32469,33689
11450092,11450089,TXFE7,128,9964,1,65854,32470,33690
11450092,11450090,TXFE7,128,9962,1,65855,32471,33691
11450092,11450090,TXFE7,128,9961,5,65860,32474,33692
11450092,11450091,TXFE7,128,9963,1,65861,32475,33693
11450104,11450092,TXFE7,128,9964,1,65862,32476,33694
11450104,11450092,TXFE7,128,9962,1,65863,32477,33695
11450104,11450092,TXFE7,128,9962,2,65865,32478,33696
11450104,11450092,TXFE7,128,9963,2,65867,32479,33697
11450104,11450092,TXFE7,128,9963,7,65874,32480,33700
11450104,11450092,TXFE7,129,9963,4,65882,32481,33704
11450104,11450092,TXFE7,129,9964,4,65882,32481,33704
11450104,11450093,TXFE7,128,9963,1,65883,32482,33705
11450104,11450093,TXFE7,128,9963,1,65884,32483,33706
11450104,11450093,TXFE7,128,9962,1,65885,32484,33707
11450104,11450095,TXFE7,128,9963,1,65886,32485,33708
11450104,11450097,TXFE7,128,9962,1,65887,32486,33709
11450104,11450097,TXFE7,129,9963,2,65894,32487,33712
11450104,11450097,TXFE7,129,9964,5,65894,32487,33712
11450104,11450101,TXFE7,128,9964,1,65895,32488,33713
11450104,11450102,TXFE7,129,9963,1,65905,32491,33714
11450104,11450102,TXFE7,129,9962,9,65905,32491,33714
11450104,11450102,TXFE7,128,9964,5,65910,32492,33715
11450117,11450106,TXFE7,128,9962,1,65911,32493,33716
11450117,11450107,TXFE7,128,9963,2,65913,32494,33718
11450117,11450107,TXFE7,128,9963,2,65915,32495,33719
11450117,11450108,TXFE7,128,9963,2,65917,32496,33721
11450117,11450116,TXFE7,128,9964,10,65927,32497,33727
11450117,11450116,TXFE7,129,9964,32,65964,32498,33740
11450117,11450116,TXFE7,129,9965,5,65964,32498,33740
11450129,11450117,TXFE7,129,9963,1,65968,32501,33741
11450129,11450117,TXFE7,129,9962,3,65968,32501,33741
11450129,11450117,TXFE7,128,9962,5,65973,32505,33742
11450129,11450117,TXFE7,128,9963,1,65974,32506,33743
11450129,11450117,TXFE7,128,9963,1,65975,32507,33744
11450129,11450117,TXFE7,128,9963,1,65976,32508,33745
11450129,11450118,TXFE7,128,9963,2,65978,32509,33746
11450129,11450120,TXFE7,128,9963,1,65979,32510,33747
11450129,11450120,TXFE7,128,9963,1,65980,32511,33748
11450129,11450120,TXFE7,128,9963,1,65981,32512,33749
11450129,11450120,TXFE7,128,9962,1,65982,32513,33750
11450129,11450120,TXFE7,128,9963,5,65987,32514,33753
11450129,11450121,TXFE7,128,9963,1,65988,32515,33754
11450129,11450121,TXFE7,128,9963,1,65989,32516,33755
11450129,11450121,TXFE7,128,9964,5,65994,32517,33757
11450129,11450122,TXFE7,128,9964,1,65995,32518,33758
11450129,11450123,TXFE7,128,9964,1,65996,32519,33759
11450129,11450123,TXFE7,128,9964,6,66002,32520,33761
11450129,11450125,TXFE7,129,9964,3,66038,32521,33784
11450129,11450125,TXFE7,129,9965,33,66038,32521,33784
11450129,11450125,TXFE7,128,9965,1,66039,32522,33785
11450129,11450125,TXFE7,128,9965,1,66040,32523,33786
11450129,11450125,TXFE7,128,9963,1,66041,32524,33787
11450129,11450128,TXFE7,129,9963,1,66046,32526,33788
11450129,11450128,TXFE7,129,9962,4,66046,32526,33788
11450129,11450129,TXFE7,130,9963,2,66056,32527,33795
11450129,11450129,TXFE7,130,9964,1,66056,32527,33795
11450129,11450129,TXFE7,130,9965,7,66056,32527,33795
11450129,11450129,TXFE7,128,9965,4,66060,32528,33798
11450129,11450129,TXFE7,128,9965,1,66061,32529,33799
11450142,11450129,TXFE7,128,9963,1,66062,32530,33800
11450142,11450129,TXFE7,128,9962,1,66063,32531,33801
11450142,11450130,TXFE7,128,9963,1,66064,32532,33802
11450142,11450130,TXFE7,128,9964,1,66065,32533,33803
11450142,11450133,TXFE7,129,9964,14,66085,32534,33815
11450142,11450133,TXFE7,129,9965,6,66085,32534,33815
11450142,11450136,TXFE7,128,9963,5,66090,32536,33816
11450142,11450136,TXFE7,128,9963,1,66091,32537,33817
11450142,11450136,TXFE7,128,9963,1,66092,32538,33818
11450142,11450139,TXFE7,128,9965,1,66093,32539,33819
11450154,11450144,TXFE7,128,9964,1,66094,32540,33820
11450154,11450144,TXFE7,128,9964,8,66102,32541,33823
11450154,11450146,TXFE7,128,9964,1,66103,32542,33824
11450154,11450146,TXFE7,128,9964,2,66105,32543,33825
11450154,11450146,TXFE7,128,9964,1,66106,32544,33826
11450154,11450147,TXFE7,128,9963,1,66107,32545,33827
11450154,11450147,TXFE7,128,9964,2,66109,32546,33828
11450154,11450148,TXFE7,128,9963,1,66110,32547,33829
11450154,11450148,TXFE7,128,9964,2,66112,32548,33830
11450154,11450149,TXFE7,128,9964,1,66113,32549,33831
11450154,11450149,TXFE7,128,9964,1,66114,32550,33832
11450154,11450149,TXFE7,128,9963,1,66115,32551,33833
11450154,11450149,TXFE7,128,9964,1,66116,32552,33834
11450154,11450150,TXFE7,128,9964,4,66120,32553,33835
11450154,11450150,TXFE7,128,9964,2,66122,32554,33836
11450154,11450153,TXFE7,128,9964,6,66128,32555,33837
11450167,11450154,TXFE7,128,9963,7,66135,32559,33838
11450167,11450155,TXFE7,128,9962,1,66136,32560,33839
11450167,11450156,TXFE7,128,9963,2,66138,32561,33841
11450167,11450157,TXFE7,128,9963,1,66139,32562,33842
11450167,11450158,TXFE7,128,9963,6,66145,32563,33844
11450167,11450158,TXFE7,128,9963,1,66146,32564,33845
11450167,11450158,TXFE7,128,9963,4,66150,32565,33846
11450167,11450160,TXFE7,128,9963,2,66152,32566,33847
11450167,11450161,TXFE7,128,9962,1,66153,32567,33848
11450167,11450163,TXFE7,129,9963,1,66156,32568,33850
11450167,11450163,TXFE7,129,9964,2,66156,32568,33850
11450167,11450165,TXFE7,128,9963,1,66157,32569,33851
11450167,11450166,TXFE7,128,9962,1,66158,32570,33852
11450179,11450167,TXFE7,128,9963,2,66160,32571,33853
11450179,11450168,TXFE7,128,9963,1,66161,32572,33854
11450179,11450171,TXFE7,128,9963,2,66163,32573,33855
11450179,11450171,TXFE7,128,9963,2,66165,32574,33857
11450179,11450172,TXFE7,128,9963,3,66168,32575,33859
11450179,11450175,TXFE7,128,9962,4,66172,32579,33860
11450179,11450175,TXFE7,128,9963,1,66173,32580,33861
11450179,11450177,TXFE7,128,9963,3,66176,32581,33862
11450179,11450177,TXFE7,128,9962,1,66177,32582,33863
11450179,11450178,TXFE7,129,9963,1,66185,32583,33865
11450179,11450178,TXFE7,129,9964,7,66185,32583,33865
11450192,11450181,TXFE7,128,9962,2,66187,32584,33866
11450192,11450182,TXFE7,128,9963,1,66188,32585,33867
11450192,11450183,TXFE7,128,9963,1,66189,32586,33868
11450192,11450184,TXFE7,128,9964,1,66190,32587,33869
11450192,11450186,TXFE7,128,9964,1,66191,32588,33870
11450192,11450189,TXFE7,128,9963,1,66192,32589,33871
11450192,11450190,TXFE7,128,9963,1,66193,32590,33872
11450192,11450190,TXFE7,128,9963,1,66194,32591,33873
11450192,11450190,TXFE7,129,9963,1,66196,32592,33875
11450192,11450190,TXFE7,129,9964,1,66196,32592,33875
11450204,11450192,TXFE7,128,9963,1,66197,32593,33876
11450204,11450193,TXFE7,129,9963,2,66221,32594,33879
11450204,11450193,TXFE7,129,9964,22,66221,32594,33879
11450204,11450194,TXFE7,128,9962,1,66222,32595,33880
11450204,11450194,TXFE7,128,9963,1,66223,32596,33881
11450204,11450198,TXFE7,128,9962,4,66227,32597,33882
11450204,11450199,TXFE7,128,9962,1,66228,32598,33883
11450204,11450199,TXFE7,128,9964,2,66230,32599,33884
11450204,11450200,TXFE7,128,9963,1,66231,32600,33885
11450204,11450201,TXFE7,128,9962,1,66232,32601,33886
11450204,11450203,TXFE7,128,9963,1,66233,32602,33887
11450204,11450204,TXFE7,128,9963,1,66234,32603,33888
11450217,11450205,TXFE7,128,9963,1,66235,32604,33889
11450217,11450207,TXFE7,128,9962,1,66236,32605,33890
11450217,11450209,TXFE7,128,9962,1,66237,32606,33891
11450217,11450209,TXFE7,128,9962,1,66238,32607,33892
11450217,11450213,TXFE7,128,9963,1,66239,32608,33893
11450217,11450213,TXFE7,128,9963,1,66240,32609,33894
11450217,11450213,TXFE7,128,9963,1,66241,32610,33895
11450217,11450214,TXFE7,128,9964,1,66242,32611,33896
11450217,11450214,TXFE7,128,9964,4,66246,32612,33899
11450217,11450215,TXFE7,128,9963,1,66247,32613,33900
11450229,11450217,TXFE7,128,9963,4,66251,32614,33901
11450229,11450217,TXFE7,128,9962,2,66253,32615,33902
11450229,11450218,TXFE7,129,9963,1,66255,32616,33904
11450229,11450218,TXFE7,129,9964,1,66255,32616,33904
11450229,11450226,TXFE7,128,9962,1,66256,32617,33905
11450229,11450229,TXFE7,128,9962,6,66262,32621,33906
11450242,11450229,TXFE7,128,9963,1,66263,32622,33907
11450242,11450229,TXFE7,128,9963,2,66265,32623,33908
11450242,11450237,TXFE7,128,9963,1,66266,32624,33909
11450242,11450238,TXFE7,128,9962,1,66267,32625,33910
11450254,11450243,TXFE7,128,9963,2,66269,32626,33911
11450254,11450247,TXFE7,128,9962,5,66274,32629,33912
11450254,11450251,TXFE7,128,9962,1,66275,32630,33913
11450254,11450251,TXFE7,128,9962,6,66281,32631,33914
11450254,11450251,TXFE7,128,9963,20,66301,32632,33921
11450267,11450263,TXFE7,128,9963,2,66303,32633,33923
11450279,11450276,TXFE7,128,9963,2,66305,32634,33924
11450292,11450280,TXFE7,128,9963,4,66309,32635,33927
11450292,11450282,TXFE7,128,9963,1,66310,32636,33928
11450292,11450283,TXFE7,128,9963,1,66311,32637,33929
11450292,11450283,TXFE7,128,9963,1,66312,32638,33930
11450292,11450285,TXFE7,128,9963,6,66318,32639,33932
11450292,11450285,TXFE7,128,9962,3,66321,32640,33933
11450292,11450285,TXFE7,128,9963,1,66322,32641,33934
11450292,11450287,TXFE7,128,9962,1,66323,32642,33935
11450292,11450289,TXFE7,129,9963,1,66326,32643,33937
11450292,11450289,TXFE7,129,9964,2,66326,32643,33937
11450292,11450291,TXFE7,128,9964,4,66330,32644,33940
11450292,11450291,TXFE7,128,9962,1,66331,32645,33941
11450292,11450291,TXFE7,128,9964,4,66335,32646,33942
11450304,11450293,TXFE7,128,9962,1,66336,32647,33943
11450304,11450293,TXFE7,128,9962,1,66337,32648,33944
11450304,11450293,TXFE7,128,9964,1,66338,32649,33945
11450304,11450294,TXFE7,128,9964,3,66341,32650,33946
11450304,11450297,TXFE7,128,9964,6,66347,32651,33949
11450304,11450298,TXFE7,128,9964,1,66348,32652,33950
11450304,11450298,TXFE7,129,9963,1,66353,32654,33951
11450304,11450298,TXFE7,129,9962,4,66353,32654,33951
11450304,11450300,TXFE7,128,9962,3,66356,32657,33952
11450304,11450302,TXFE7,128,9963,1,66357,32658,33953
11450304,11450303,TXFE7,128,9963,1,66358,32659,33954
11450304,11450303,TXFE7,128,9962,1,66359,32660,33955
11450304,11450304,TXFE7,128,9962,1,66360,32661,33956
11450304,11450304,TXFE7,128,9963,1,66361,32662,33957
11450317,11450310,TXFE7,128,9963,1,66362,32663,33958
11450317,11450311,TXFE7,128,9963,1,66363,32664,33959
11450317,11450315,TXFE7,128,9962,1,66364,32665,33960
11450317,11450316,TXFE7,128,9963,1,66365,32666,33961
11450329,11450317,TXFE7,128,9963,2,66367,32667,33962
11450329,11450318,TXFE7,128,9963,1,66368,32668,33963
11450329,11450318,TXFE7,128,9963,1,66369,32669,33964
11450329,11450320,TXFE7,128,9963,4,66373,32670,33965
11450329,11450321,TXFE7,128,9963,2,66375,32671,33967
11450329,11450324,TXFE7,128,9962,1,66376,32672,33968
11450329,11450325,TXFE7,128,9963,2,66378,32673,33969
11450329,11450326,TXFE7,128,9963,6,66384,32674,33971
11450329,11450328,TXFE7,128,9963,2,66386,32675,33972
11450342,11450329,TXFE7,130,9963,9,66461,32676,34006
11450342,11450329,TXFE7,130,9964,54,66461,32676,34006
11450342,11450329,TXFE7,130,9965,12,66461,32676,34006
11450342,11450332,TXFE7,128,9963,1,66462,32677,34007
11450342,11450334,TXFE7,128,9964,2,66464,32678,34009
11450342,11450339,TXFE7,128,9963,2,66466,32679,34010
11450342,11450340,TXFE7,128,9964,2,66468,32680,34011
11450342,11450341,TXFE7,129,9963,1,66477,32687,34012
11450342,11450341,TXFE7,129,9962,8,66477,32687,34012
11450342,11450341,TXFE7,128,9963,1,66478,32688,34013
11450342,11450342,TXFE7,128,9964,1,66479,32689,34014
11450354,11450348,TXFE7,128,9964,1,66480,32690,34015
11450354,11450349,TXFE7,128,9963,1,66481,32691,34016
11450354,11450350,TXFE7,128,9964,6,66487,32692,34017
11450354,11450351,TXFE7,128,9964,2,66489,32693,34018
11450354,11450353,TXFE7,128,9963,9,66498,32697,34019
11450354,11450353,TXFE7,128,9963,2,66500,32699,34020
11450367,11450356,TXFE7,128,9963,2,66502,32700,34021
11450367,11450360,TXFE7,128,9964,1,66503,32701,34022
11450367,11450361,TXFE7,128,9963,1,66504,32702,34023
11450367,11450361,TXFE7,128,9963,10,66514,32706,34024
11450367,11450364,TXFE7,128,9962,1,66515,32707,34025
11450367,11450365,TXFE7,128,9963,2,66517,32708,34026
11450379,11450367,TXFE7,128,9963,1,66518,32709,34027
11450379,11450371,TXFE7,128,9962,1,66519,32710,34028
11450379,11450372,TXFE7,128,9963,2,66521,32711,34029
11450379,11450373,TXFE7,128,9963,1,66522,32712,34030
11450379,11450373,TXFE7,128,9962,2,66524,32713,34031
11450392,11450380,TXFE7,128,9962,8,66532,32720,34032
11450392,11450384,TXFE7,128,9963,1,66533,32721,34033
11450392,11450385,TXFE7,128,9963,1,66534,32722,34034
11450392,11450385,TXFE7,128,9963,2,66536,32723,34035
11450392,11450387,TXFE7,128,9963,2,66538,32724,34036
11450404,11450392,TXFE7,128,9962,7,66545,32726,34037
11450404,11450392,TXFE7,128,9963,1,66546,32727,34038
11450404,11450399,TXFE7,128,9963,12,66558,32728,34042
11450404,11450399,TXFE7,128,9963,10,66568,32729,34045
11450404,11450400,TXFE7,128,9963,1,66569,32730,34046
11450404,11450400,TXFE7,128,9963,1,66570,32731,34047
11450404,11450403,TXFE7,128,9963,4,66574,32732,34051
11450417,11450407,TXFE7,128,9963,2,66576,32733,34052
11450417,11450408,TXFE7,128,9963,2,66578,32734,34053
11450417,11450409,TXFE7,128,9963,1,66579,32735,34054
11450417,11450409,TXFE7,128,9963,1,66580,32736,34055
11450417,11450412,TXFE7,128,9962,5,66585,32740,34056
11450417,11450412,TXFE7,128,9963,1,66586,32741,34057
11450429,11450418,TXFE7,128,9963,1,66587,32742,34058
11450429,11450420,TXFE7,128,9963,1,66588,32743,34059
11450429,11450422,TXFE7,128,9963,4,66592,32744,34062
11450442,11450430,TXFE7,128,9962,2,66594,32745,34063
11450442,11450431,TXFE7,128,9963,5,66599,32746,34065
11450442,11450440,TXFE7,128,9964,1,66600,32747,34066
11450454,11450442,TXFE7,128,9963,1,66601,32748,34067
11450467,11450456,TXFE7,128,9962,1,66602,32749,34068
11450467,11450462,TXFE7,128,9963,2,66604,32750,34070
11450467,11450464,TXFE7,128,9964,2,66606,32751,34071
11450467,11450464,TXFE7,128,9964,1,66607,32752,34072
11450479,11450469,TXFE7,128,9963,2,66609,32753,34073
11450479,11450470,TXFE7,128,9962,1,66610,32754,34074
11450479,11450470,TXFE7,128,9963,3,66613,32755,34075
11450492,11450482,TXFE7,128,9962,1,66614,32756,34076
11450492,11450487,TXFE7,128,9963,10,66624,32757,34079
11450492,11450490,TXFE7,128,9963,2,66626,32758,34080
11450492,11450491,TXFE7,128,9963,1,66627,32759,34081
11450504,11450492,TXFE7,128,9964,1,66628,32760,34082
11450504,11450496,TXFE7,128,9964,1,66629,32761,34083
11450504,11450503,TXFE7,128,9964,2,66631,32762,34084
11450517,11450505,TXFE7,128,9962,1,66632,32763,34085
11450517,11450510,TXFE7,128,9963,3,66635,32764,34086
11450517,11450517,TXFE7,128,9963,2,66637,32765,34087
11450529,11450523,TXFE7,128,9962,16,66653,32775,34088
11450529,11450529,TXFE7,128,9963,1,66654,32776,34089
11450529,11450529,TXFE7,128,9962,1,66655,32777,34090
11450542,11450530,TXFE7,128,9963,1,66656,32778,34091
11450554,11450545,TXFE7,128,9962,3,66659,32781,34092
11450554,11450546,TXFE7,128,9962,1,66660,32782,34093
11450554,11450553,TXFE7,128,9963,1,66661,32783,34094
11450567,11450557,TXFE7,128,9963,3,66664,32784,34095
11450579,11450577,TXFE7,128,9962,2,66666,32785,34096
11450579,11450579,TXFE7,128,9962,2,66668,32786,34097
11450592,11450579,TXFE7,128,9962,4,66672,32787,34098
11450592,11450581,TXFE7,128,9963,2,66674,32788,34100
11450592,11450591,TXFE7,128,9962,1,66675,32789,34101
11450604,11450594,TXFE7,128,9962,4,66679,32790,34102
11450604,11450595,TXFE7,128,9963,3,66682,32791,34104
11450604,11450595,TXFE7,128,9962,1,66683,32792,34105
11450604,11450596,TXFE7,128,9962,2,66685,32793,34106
11450617,11450609,TXFE7,128,9962,1,66686,32794,34107
11450617,11450611,TXFE7,128,9962,1,66687,32795,34108
11450617,11450614,TXFE7,128,9961,1,66688,32796,34109
11450629,11450618,TXFE7,128,9961,2,66690,32797,34110
11450629,11450622,TXFE7,128,9961,7,66697,32800,34111
11450629,11450624,TXFE7,128,9962,2,66699,32801,34112
11450654,11450643,TXFE7,128,9961,2,66701,32802,34113
11450654,11450645,TXFE7,128,9961,1,66702,32803,34114
11450654,11450651,TXFE7,128,9961,6,66708,32807,34115
11450654,11450651,TXFE7,128,9961,2,66710,32808,34116
11450654,11450653,TXFE7,128,9960,14,66724,32816,34117
11450667,11450654,TXFE7,128,9961,1,66725,32817,34118
11450667,11450657,TXFE7,128,9961,1,66726,32818,34119
11450679,11450676,TXFE7,128,9961,1,66727,32819,34120
11450679,11450679,TXFE7,128,9961,4,66731,32820,34121
11450717,11450709,TXFE7,128,9961,1,66732,32821,34122
11450717,11450713,TXFE7,128,9961,3,66735,32822,34124
11450717,11450715,TXFE7,128,9961,1,66736,32823,34125
11450729,11450720,TXFE7,128,9960,10,66746,32825,34126
11450729,11450722,TXFE7,128,9960,5,66751,32829,34127
11450729,11450725,TXFE7,128,9961,2,66753,32830,34129
11450742,11450730,TXFE7,128,9960,1,66754,32831,34130
11450742,11450737,TXFE7,128,9961,1,66755,32832,34131
11450742,11450739,TXFE7,128,9960,1,66756,32833,34132
11450742,11450741,TXFE7,128,9960,5,66761,32837,34133
11450754,11450745,TXFE7,128,9961,1,66762,32838,34134
11450767,11450759,TXFE7,128,9960,1,66763,32839,34135
11450767,11450766,TXFE7,128,9961,1,66764,32840,34136
11450779,11450769,TXFE7,128,9960,2,66766,32841,34137
11450779,11450769,TXFE7,128,9960,2,66768,32843,34138
11450792,11450781,TXFE7,128,9960,2,66770,32845,34139
11450792,11450784,TXFE7,128,9960,2,66772,32847,34140
11450792,11450785,TXFE7,128,9960,1,66773,32848,34141
11450804,11450795,TXFE7,128,9961,4,66777,32849,34143
11450804,11450803,TXFE7,128,9961,1,66778,32850,34144
11450817,11450806,TXFE7,128,9961,1,66779,32851,34145
11450817,11450809,TXFE7,128,9960,3,66782,32852,34146
11450829,11450821,TXFE7,128,9961,1,66783,32853,34147
11450842,11450833,TXFE7,128,9961,5,66788,32854,34148
11450842,11450840,TXFE7,128,9960,1,66789,32855,34149
11450854,11450846,TXFE7,128,9960,1,66790,32856,34150
11450854,11450850,TXFE7,128,9961,1,66791,32857,34151
11450867,11450855,TXFE7,128,9960,1,66792,32858,34152
11450879,11450868,TXFE7,128,9961,7,66799,32859,34157
11450879,11450870,TXFE7,128,9961,1,66800,32860,34158
11450879,11450874,TXFE7,128,9960,1,66801,32861,34159
11450892,11450887,TXFE7,128,9961,2,66803,32862,34160
11450904,11450896,TXFE7,128,9961,1,66804,32863,34161
11450904,11450897,TXFE7,128,9960,9,66813,32868,34162
11450917,11450905,TXFE7,128,9960,1,66814,32869,34163
11450917,11450914,TXFE7,128,9960,6,66820,32875,34164
11450917,11450914,TXFE7,128,9961,1,66821,32876,34165
11450917,11450917,TXFE7,128,9960,1,66822,32877,34166
11450929,11450917,TXFE7,130,9960,8,66882,32904,34167
11450929,11450917,TXFE7,130,9959,51,66882,32904,34167
11450929,11450917,TXFE7,130,9958,1,66882,32904,34167
11450929,11450923,TXFE7,128,9960,1,66883,32905,34168
11450942,11450929,TXFE7,128,9959,8,66891,32906,34169
11450942,11450932,TXFE7,128,9958,3,66894,32907,34170
11450942,11450935,TXFE7,128,9960,1,66895,32908,34171
11450942,11450936,TXFE7,128,9960,1,66896,32909,34172
11450942,11450938,TXFE7,128,9960,1,66897,32910,34173
11450942,11450938,TXFE7,128,9959,1,66898,32911,34174
11450942,11450938,TXFE7,128,9959,1,66899,32912,34175
11450942,11450938,TXFE7,128,9958,1,66900,32913,34176
11450942,11450939,TXFE7,128,9958,1,66901,32914,34177
11450942,11450940,TXFE7,128,9958,8,66909,32917,34178
11450942,11450940,TXFE7,128,9958,1,66910,32918,34179
11450942,11450940,TXFE7,128,9958,1,66911,32919,34180
11450942,11450941,TXFE7,128,9958,1,66912,32920,34181
11450942,11450941,TXFE7,128,9958,1,66913,32921,34182
11450942,11450941,TXFE7,128,9958,1,66914,32922,34183
11450954,11450943,TXFE7,128,9958,1,66915,32923,34184
11450954,11450943,TXFE7,128,9958,1,66916,32924,34185
11450954,11450943,TXFE7,128,9958,1,66917,32925,34186
11450954,11450943,TXFE7,128,9958,1,66918,32926,34187
11450954,11450943,TXFE7,128,9959,1,66919,32927,34188
11450954,11450944,TXFE7,128,9959,1,66920,32928,34189
11450954,11450945,TXFE7,128,9958,1,66921,32929,34190
11450954,11450945,TXFE7,128,9958,1,66922,32930,34191
11450954,11450945,TXFE7,128,9958,10,66932,32935,34192
11450967,11450954,TXFE7,128,9958,16,66948,32941,34193
11450967,11450956,TXFE7,128,9959,2,66950,32942,34194
11450967,11450957,TXFE7,128,9958,2,66952,32943,34195
11450967,11450957,TXFE7,128,9958,1,66953,32944,34196
11450967,11450959,TXFE7,128,9959,5,66958,32945,34197
11450967,11450960,TXFE7,128,9959,1,66959,32946,34198
11450979,11450967,TXFE7,128,9958,1,66960,32947,34199
11450979,11450967,TXFE7,128,9958,4,66964,32948,34200
11450979,11450967,TXFE7,128,9958,6,66970,32949,34201
11450979,11450968,TXFE7,128,9959,19,66989,32950,34206
11450979,11450970,TXFE7,128,9959,2,66991,32951,34208
11450979,11450974,TXFE7,128,9958,1,66992,32952,34209
11450979,11450976,TXFE7,128,9959,2,66994,32953,34211
11450992,11450985,TXFE7,128,9959,1,66995,32954,34212
11451017,11451006,TXFE7,128,9959,1,66996,32955,34213
11451017,11451006,TXFE7,128,9959,1,66997,32956,34214
11451017,11451015,TXFE7,128,9958,1,66998,32957,34215
11451029,11451025,TXFE7,128,9959,1,66999,32958,34216
11451042,11451030,TXFE7,128,9958,1,67000,32959,34217
11451054,11451046,TXFE7,128,9958,1,67001,32960,34218
11451054,11451050,TXFE7,128,9959,1,67002,32961,34219
11451054,11451051,TXFE7,128,9959,1,67003,32962,34220
11451092,11451084,TXFE7,128,9958,1,67004,32963,34221
11451092,11451085,TXFE7,128,9959,1,67005,32964,34222
11451092,11451089,TXFE7,128,9959,2,67007,32965,34224
11451104,11451092,TXFE7,128,9958,8,67015,32970,34225
11451117,11451111,TXFE7,128,9958,1,67016,32971,34226
11451117,11451117,TXFE7,128,9959,1,67017,32972,34227
11451142,11451133,TXFE7,128,9959,1,67018,32973,34228
11451154,11451148,TXFE7,128,9959,5,67023,32974,34231
11451179,11451176,TXFE7,128,9959,1,67024,32975,34232
11451179,11451177,TXFE7,128,9959,1,67025,32976,34233
11451217,11451213,TXFE7,128,9958,1,67026,32977,34234
11451217,11451217,TXFE7,128,9959,1,67027,32978,34235
11451229,11451221,TXFE7,128,9959,3,67030,32979,34236
11451242,11451233,TXFE7,128,9959,1,67031,32980,34237
11451267,11451256,TXFE7,128,9959,1,67032,32981,34238
11451279,11451267,TXFE7,128,9959,2,67034,32982,34240
11451279,11451279,TXFE7,128,9958,1,67035,32983,34241
11451292,11451279,TXFE7,128,9959,4,67039,32984,34243
11451292,11451279,TXFE7,128,9959,6,67045,32985,34247
11451304,11451292,TXFE7,128,9959,4,67049,32986,34250
11451304,11451296,TXFE7,128,9959,1,67050,32987,34251
11451304,11451296,TXFE7,128,9960,1,67051,32988,34252
11451317,11451308,TXFE7,128,9959,2,67053,32990,34253
11451317,11451315,TXFE7,128,9959,1,67054,32991,34254
11451329,11451318,TXFE7,128,9960,1,67055,32992,34255
11451342,11451335,TXFE7,128,9959,1,67056,32993,34256
11451417,11451409,TXFE7,128,9959,9,67065,32996,34257
11451442,11451431,TXFE7,128,9960,1,67066,32997,34258
11451442,11451434,TXFE7,128,9960,9,67075,32998,34259
11451454,11451450,TXFE7,128,9960,4,67079,32999,34261
11451467,11451456,TXFE7,128,9959,1,67080,33000,34262
11451467,11451456,TXFE7,128,9960,2,67082,33001,34264
11451467,11451460,TXFE7,128,9960,1,67083,33002,34265
11451467,11451462,TXFE7,128,9960,1,67084,33003,34266
11451479,11451470,TXFE7,128,9960,5,67089,33004,34269
11451479,11451472,TXFE7,128,9959,1,67090,33005,34270
11451479,11451477,TXFE7,128,9959,9,67099,33010,34271
11451492,11451483,TXFE7,128,9959,6,67105,33014,34272
11451492,11451484,TXFE7,128,9960,1,67106,33015,34273
11451517,11451506,TXFE7,128,9959,3,67109,33017,34274
11451542,11451538,TXFE7,128,9959,9,67118,33021,34275
11451554,11451543,TXFE7,128,9960,1,67119,33022,34276
11451554,11451545,TXFE7,128,9959,4,67123,33026,34277
11451567,11451559,TXFE7,128,9959,1,67124,33027,34278
11451579,11451574,TXFE7,128,9960,1,67125,33028,34279
11451592,11451581,TXFE7,128,9959,1,67126,33029,34280
11451592,11451583,TXFE7,128,9960,3,67129,33030,34281
11451642,11451638,TXFE7,128,9959,1,67130,33031,34282
11451654,11451642,TXFE7,128,9960,1,67131,33032,34283
11451679,11451679,TXFE7,128,9959,1,67132,33033,34284
11451692,11451689,TXFE7,128,9959,2,67134,33034,34285
11451692,11451690,TXFE7,128,9960,1,67135,33035,34286
11451754,11451752,TXFE7,128,9960,10,67145,33036,34291
11451767,11451760,TXFE7,128,9960,4,67149,33037,34294
11451779,11451767,TXFE7,128,9960,4,67153,33038,34296
11451779,11451772,TXFE7,128,9959,5,67158,33041,34297
11451779,11451778,TXFE7,128,9959,1,67159,33042,34298
11451842,11451833,TXFE7,128,9960,3,67162,33043,34301
11451854,11451850,TXFE7,128,9960,6,67168,33044,34305
11451854,11451851,TXFE7,128,9959,2,67170,33045,34306
11451867,11451857,TXFE7,128,9960,1,67171,33046,34307
11451879,11451879,TXFE7,128,9960,2,67173,33047,34308
11451892,11451887,TXFE7,129,9960,8,67183,33048,34317
11451892,11451887,TXFE7,129,9961,2,67183,33048,34317
11451942,11451933,TXFE7,128,9960,1,67184,33049,34318
11451954,11451942,TXFE7,128,9960,1,67185,33050,34319
11451967,11451962,TXFE7,128,9960,1,67186,33051,34320
11452004,11451995,TXFE7,128,9960,1,67187,33052,34321
11452029,11452022,TXFE7,128,9961,1,67188,33053,34322
11452042,11452039,TXFE7,128,9961,1,67189,33054,34323
11452067,11452055,TXFE7,128,9960,2,67191,33055,34324
11452067,11452062,TXFE7,128,9960,5,67196,33058,34325
11452104,11452094,TXFE7,128,9961,1,67197,33059,34326
11452117,11452113,TXFE7,128,9960,1,67198,33060,34327
11452154,11452147,TXFE7,128,9960,2,67200,33062,34328
11452154,11452149,TXFE7,128,9959,2,67202,33063,34329
11452179,11452169,TXFE7,128,9960,2,67204,33064,34330
11452179,11452171,TXFE7,128,9960,1,67205,33065,34331
11452204,11452203,TXFE7,128,9959,1,67206,33066,34332
11452229,11452217,TXFE7,128,9960,1,67207,33067,34333
11452242,11452231,TXFE7,128,9959,2,67209,33068,34334
11452254,11452242,TXFE7,128,9960,1,67210,33069,34335
11452317,11452309,TXFE7,128,9959,1,67211,33070,34336
11452317,11452316,TXFE7,128,9959,1,67212,33071,34337
11452367,11452357,TXFE7,128,9960,1,67213,33072,34338
11452367,11452361,TXFE7,128,9959,1,67214,33073,34339
11452429,11452419,TXFE7,128,9960,2,67216,33074,34340
11452479,11452467,TXFE7,128,9960,1,67217,33075,34341
11452479,11452474,TXFE7,128,9960,2,67219,33076,34343
11452479,11452478,TXFE7,128,9960,1,67220,33077,34344
11452517,11452513,TXFE7,128,9960,1,67221,33078,34345
11452517,11452516,TXFE7,128,9959,1,67222,33079,34346
11452567,11452562,TXFE7,128,9959,1,67223,33080,34347
11452617,11452613,TXFE7,128,9959,9,67232,33085,34348
11452654,11452645,TXFE7,128,9959,1,67233,33086,34349
11452667,11452660,TXFE7,128,9960,2,67235,33087,34351
11452692,11452691,TXFE7,128,9959,9,67244,33089,34352
11452704,11452696,TXFE7,128,9960,5,67249,33090,34354
11452754,11452743,TXFE7,128,9959,2,67251,33092,34355
11452767,11452757,TXFE7,128,9959,1,67252,33093,34356
11452767,11452763,TXFE7,128,9959,1,67253,33094,34357
11452779,11452768,TXFE7,128,9959,1,67254,33095,34358
11452792,11452790,TXFE7,128,9959,1,67255,33096,34359
11452804,11452793,TXFE7,128,9960,1,67256,33097,34360
11452854,11452845,TXFE7,128,9959,9,67265,33100,34361
11452854,11452845,TXFE7,128,9959,1,67266,33101,34362
11452867,11452854,TXFE7,128,9959,4,67270,33102,34363
11452867,11452856,TXFE7,128,9959,1,67271,33103,34364
11452879,11452876,TXFE7,128,9959,2,67273,33105,34365
11452892,11452881,TXFE7,128,9959,1,67274,33106,34366
11452892,11452888,TXFE7,128,9959,1,67275,33107,34367
11452904,11452893,TXFE7,128,9959,3,67278,33108,34368
11452904,11452898,TXFE7,128,9959,9,67287,33109,34369
11452904,11452904,TXFE7,128,9960,1,67288,33110,34370
11452917,11452904,TXFE7,128,9959,3,67291,33111,34371
11452917,11452904,TXFE7,128,9959,15,67306,33120,34372
11452917,11452907,TXFE7,128,9959,1,67307,33121,34373
11452917,11452908,TXFE7,128,9959,1,67308,33122,34374
11453004,11452995,TXFE7,128,9959,1,67309,33123,34375
11453017,11453012,TXFE7,128,9959,2,67311,33124,34376
11453067,11453058,TXFE7,128,9959,1,67312,33125,34377
11453104,11453093,TXFE7,128,9959,2,67314,33126,34378
11453167,11453157,TXFE7,128,9958,3,67317,33127,34379
11453204,11453192,TXFE7,128,9958,9,67326,33133,34380
11453217,11453209,TXFE7,128,9958,1,67327,33134,34381
11453229,11453227,TXFE7,128,9959,1,67328,33135,34382
11453279,11453267,TXFE7,128,9959,1,67329,33136,34383
11453279,11453273,TXFE7,128,9958,1,67330,33137,34384
11453379,11453376,TXFE7,128,9958,10,67340,33140,34385
11453392,11453381,TXFE7,128,9959,15,67355,33141,34392
11453392,11453384,TXFE7,128,9959,1,67356,33142,34393
11453517,11453513,TXFE7,128,9959,2,67358,33143,34395
11453529,11453519,TXFE7,128,9959,2,67360,33144,34397
11453554,11453552,TXFE7,128,9959,1,67361,33145,34398
11453567,11453560,TXFE7,128,9958,2,67363,33147,34399
11453579,11453573,TXFE7,128,9959,3,67366,33148,34402
11453604,11453592,TXFE7,128,9959,3,67369,33149,34405
11453617,11453607,TXFE7,128,9959,3,67372,33150,34406
11453629,11453618,TXFE7,128,9958,1,67373,33151,34407
11453629,11453621,TXFE7,128,9959,3,67376,33152,34410
11453642,11453635,TXFE7,128,9959,3,67379,33153,34413
11453654,11453643,TXFE7,128,9959,12,67391,33154,34420
11453654,11453648,TXFE7,128,9959,1,67392,33155,34421
11453667,11453657,TXFE7,128,9960,1,67393,33156,34422
11453742,11453733,TXFE7,128,9959,1,67394,33157,34423
11453792,11453781,TXFE7,128,9959,1,67395,33158,34424
11453804,11453799,TXFE7,128,9960,5,67400,33159,34426
11453829,11453818,TXFE7,128,9960,1,67401,33160,34427
11453842,11453830,TXFE7,128,9959,1,67402,33161,34428
11453854,11453843,TXFE7,128,9960,2,67404,33162,34430
11453867,11453863,TXFE7,128,9960,2,67406,33163,34432
11453867,11453864,TXFE7,129,9959,5,67416,33168,34433
11453867,11453864,TXFE7,129,9958,5,67416,33168,34433
11453904,11453895,TXFE7,128,9958,1,67417,33169,34434
11453942,11453930,TXFE7,128,9959,1,67418,33170,34435
11453942,11453937,TXFE7,128,9960,3,67421,33171,34438
11453992,11453984,TXFE7,129,9959,3,67426,33174,34439
11453992,11453984,TXFE7,129,9958,2,67426,33174,34439
11454029,11454027,TXFE7,128,9959,1,67427,33175,34440
11454042,11454035,TXFE7,129,9959,1,67429,33177,34441
11454042,11454035,TXFE7,129,9958,1,67429,33177,34441
11454054,11454050,TXFE7,128,9960,1,67430,33178,34442
11454079,11454069,TXFE7,128,9959,1,67431,33179,34443
11454104,11454092,TXFE7,128,9959,2,67433,33181,34444
11454142,11454132,TXFE7,128,9958,2,67435,33183,34445
11454167,11454165,TXFE7,128,9959,1,67436,33184,34446
11454179,11454179,TXFE7,128,9958,4,67440,33187,34447
11454179,11454179,TXFE7,128,9958,6,67446,33190,34448
11454179,11454179,TXFE7,128,9958,4,67450,33192,34449
11454192,11454179,TXFE7,128,9958,4,67454,33195,34450
11454192,11454179,TXFE7,128,9958,2,67456,33196,34451
11454192,11454179,TXFE7,128,9958,4,67460,33197,34452
11454192,11454179,TXFE7,128,9958,2,67462,33199,34453
11454192,11454179,TXFE7,128,9958,4,67466,33203,34454
11454217,11454213,TXFE7,128,9958,1,67467,33204,34455
11454242,11454235,TXFE7,128,9957,1,67468,33205,34456
11454254,11454248,TXFE7,128,9958,1,67469,33206,34457
11454267,11454264,TXFE7,128,9958,7,67476,33207,34460
11454279,11454278,TXFE7,128,9957,1,67477,33208,34461
11454292,11454281,TXFE7,128,9957,1,67478,33209,34462
11454342,11454339,TXFE7,128,9958,3,67481,33210,34465
11454367,11454366,TXFE7,128,9957,1,67482,33211,34466
11454392,11454390,TXFE7,128,9957,1,67483,33212,34467
11454429,11454429,TXFE7,128,9958,1,67484,33213,34468
11454442,11454432,TXFE7,128,9958,1,67485,33214,34469
11454479,11454478,TXFE7,128,9957,8,67493,33220,34470
11454504,11454499,TXFE7,128,9958,2,67495,33221,34471
11454542,11454535,TXFE7,128,9958,1,67496,33222,34472
11454554,11454546,TXFE7,128,9957,1,67497,33223,34473
11454567,11454560,TXFE7,128,9957,1,67498,33224,34474
11454567,11454565,TXFE7,128,9958,14,67512,33225,34478
11454592,11454580,TXFE7,128,9958,1,67513,33226,34479
11454592,11454580,TXFE7,128,9958,3,67516,33227,34481
11454604,11454594,TXFE7,128,9958,1,67517,33228,34482
11454629,11454618,TXFE7,128,9958,2,67519,33229,34483
11454667,11454659,TXFE7,128,9958,10,67529,33230,34484
11454692,11454680,TXFE7,128,9958,8,67537,33231,34485
11454692,11454686,TXFE7,128,9957,1,67538,33232,34486
11454692,11454690,TXFE7,128,9959,1,67539,33233,34487
11454704,11454692,TXFE7,128,9958,1,67540,33234,34488
11454704,11454696,TXFE7,128,9958,7,67547,33235,34489
11454717,11454711,TXFE7,128,9958,1,67548,33236,34490
11454742,11454734,TXFE7,128,9957,1,67549,33237,34491
11454842,11454831,TXFE7,128,9957,1,67550,33238,34492
11454842,11454834,TXFE7,128,9958,14,67564,33239,34499
11454854,11454852,TXFE7,128,9957,1,67565,33240,34500
11454854,11454854,TXFE7,128,9958,1,67566,33241,34501
11454879,11454867,TXFE7,128,9958,1,67567,33242,34502
11454942,11454938,TXFE7,128,9957,1,67568,33243,34503
11454954,11454946,TXFE7,128,9958,14,67582,33244,34506
11455067,11455061,TXFE7,128,9957,6,67588,33247,34507
11455092,11455087,TXFE7,128,9958,3,67591,33248,34510
11455217,11455208,TXFE7,128,9958,5,67596,33249,34515
11455229,11455227,TXFE7,128,9958,2,67598,33250,34516
11455267,11455263,TXFE7,128,9958,1,67599,33251,34517
11455354,11455350,TXFE7,128,9959,1,67600,33252,34518
11455354,11455354,TXFE7,128,9958,5,67605,33253,34519
11455367,11455355,TXFE7,128,9958,7,67612,33256,34520
11455379,11455367,TXFE7,128,9958,1,67613,33257,34521
11455392,11455388,TXFE7,128,9958,1,67614,33258,34522
11455404,11455403,TXFE7,128,9958,2,67616,33259,34523
11455429,11455422,TXFE7,128,9958,1,67617,33260,34524
11455429,11455424,TXFE7,128,9958,1,67618,33261,34525
11455504,11455498,TXFE7,128,9958,1,67619,33262,34526
11455542,11455534,TXFE7,128,9957,1,67620,33263,34527
11455554,11455543,TXFE7,128,9958,1,67621,33264,34528
11455642,11455641,TXFE7,128,9958,5,67626,33265,34530
11455679,11455673,TXFE7,128,9958,1,67627,33266,34531
11455679,11455674,TXFE7,128,9959,2,67629,33267,34532
11455692,11455682,TXFE7,128,9958,1,67630,33268,34533
11455742,11455734,TXFE7,128,9958,1,67631,33269,34534
11455829,11455823,TXFE7,128,9958,2,67633,33270,34535
11455842,11455838,TXFE7,128,9958,1,67634,33271,34536
11455867,11455857,TXFE7,128,9958,5,67639,33275,34537
11455954,11455946,TXFE7,128,9958,4,67643,33278,34538
11455967,11455967,TXFE7,128,9959,5,67648,33279,34541
11455979,11455970,TXFE7,128,9959,1,67649,33280,34542
11455992,11455982,TXFE7,128,9958,1,67650,33281,34543
11460004,11455993,TXFE7,128,9958,2,67652,33282,34544
11460017,11460012,TXFE7,128,9959,1,67653,33283,34545
11460029,11460021,TXFE7,128,9959,1,67654,33284,34546
11460079,11460078,TXFE7,128,9959,1,67655,33285,34547
11460117,11460111,TXFE7,128,9958,9,67664,33290,34548
11460154,11460150,TXFE7,128,9959,1,67665,33291,34549
11460179,11460173,TXFE7,129,9958,37,67725,33325,34550
11460179,11460173,TXFE7,129,9957,23,67725,33325,34550
11460204,11460193,TXFE7,128,9957,1,67726,33326,34551
11460204,11460193,TXFE7,128,9957,1,67727,33327,34552
11460204,11460194,TXFE7,128,9957,1,67728,33328,34553
11460204,11460195,TXFE7,128,9957,1,67729,33329,34554
11460204,11460198,TXFE7,128,9957,1,67730,33330,34555
11460204,11460198,TXFE7,128,9957,1,67731,33331,34556
11460204,11460199,TXFE7,128,9957,1,67732,33332,34557
11460204,11460199,TXFE7,128,9957,1,67733,33333,34558
11460204,11460200,TXFE7,128,9957,1,67734,33334,34559
11460204,11460201,TXFE7,128,9957,1,67735,33335,34560
11460204,11460201,TXFE7,128,9957,1,67736,33336,34561
11460204,11460201,TXFE7,128,9957,1,67737,33337,34562
11460204,11460203,TXFE7,128,9957,1,67738,33338,34563
11460204,11460203,TXFE7,128,9957,1,67739,33339,34564
11460204,11460203,TXFE7,128,9958,1,67740,33340,34565
11460204,11460203,TXFE7,128,9958,1,67741,33341,34566
11460242,11460229,TXFE7,128,9958,1,67742,33342,34567
11460292,11460286,TXFE7,128,9958,1,67743,33343,34568
11460417,11460406,TXFE7,128,9958,2,67745,33345,34569
11460417,11460413,TXFE7,128,9958,9,67754,33352,34570
11460429,11460428,TXFE7,128,9958,1,67755,33353,34571
11460467,11460464,TXFE7,128,9959,1,67756,33354,34572
11460479,11460469,TXFE7,128,9958,2,67758,33356,34573
11460492,11460483,TXFE7,128,9958,3,67761,33357,34574
11460517,11460513,TXFE7,128,9959,1,67762,33358,34575
11460529,11460521,TXFE7,128,9958,1,67763,33359,34576
11460579,11460567,TXFE7,128,9959,1,67764,33360,34577
11460579,11460578,TXFE7,128,9958,2,67766,33362,34578
11460629,11460620,TXFE7,128,9959,24,67790,33363,34594
11460642,11460629,TXFE7,128,9959,2,67792,33364,34595
11460642,11460629,TXFE7,128,9959,2,67794,33365,34597
11460642,11460638,TXFE7,128,9959,1,67795,33366,34598
11460654,11460644,TXFE7,128,9959,4,67799,33367,34602
11460667,11460654,TXFE7,128,9959,4,67803,33368,34606
11460667,11460654,TXFE7,128,9959,2,67805,33369,34607
11460679,11460667,TXFE7,128,9959,7,67812,33370,34610
11460717,11460705,TXFE7,128,9959,2,67814,33372,34611
11460742,11460736,TXFE7,128,9959,1,67815,33373,34612
11460779,11460768,TXFE7,128,9960,4,67819,33374,34616
11460779,11460772,TXFE7,128,9960,10,67829,33375,34622
11460792,11460782,TXFE7,128,9960,5,67834,33376,34626
11460804,11460797,TXFE7,128,9960,1,67835,33377,34627
11460829,11460820,TXFE7,128,9960,1,67836,33378,34628
11460829,11460822,TXFE7,128,9960,1,67837,33379,34629
11460842,11460834,TXFE7,128,9959,1,67838,33380,34630
11460842,11460842,TXFE7,128,9960,1,67839,33381,34631
11460867,11460855,TXFE7,128,9959,1,67840,33382,34632
11460879,11460869,TXFE7,128,9960,5,67845,33383,34636
11460879,11460878,TXFE7,128,9960,1,67846,33384,34637
11460879,11460878,TXFE7,128,9960,1,67847,33385,34638
11460917,11460916,TXFE7,128,9959,1,67848,33386,34639
11460929,11460924,TXFE7,128,9960,1,67849,33387,34640
11460942,11460935,TXFE7,128,9960,1,67850,33388,34641
11460942,11460941,TXFE7,128,9960,4,67854,33389,34645
11460992,11460983,TXFE7,128,9960,1,67855,33390,34646
11461092,11461091,TXFE7,128,9959,1,67856,33391,34647
11461104,11461098,TXFE7,128,9960,1,67857,33392,34648
11461129,11461119,TXFE7,128,9959,1,67858,33393,34649
11461179,11461167,TXFE7,128,9959,1,67859,33394,34650
11461267,11461256,TXFE7,128,9959,1,67860,33395,34651
11461267,11461260,TXFE7,128,9960,1,67861,33396,34652
11461329,11461322,TXFE7,128,9960,1,67862,33397,34653
11461329,11461324,TXFE7,128,9959,1,67863,33398,34654
11461379,11461368,TXFE7,128,9960,1,67864,33399,34655
11461404,11461398,TXFE7,128,9960,2,67866,33400,34657
11461417,11461414,TXFE7,128,9960,1,67867,33401,34658
11461442,11461433,TXFE7,128,9959,1,67868,33402,34659
11461467,11461462,TXFE7,128,9959,1,67869,33403,34660
11461492,11461486,TXFE7,128,9960,1,67870,33404,34661
11461579,11461570,TXFE7,128,9960,2,67872,33405,34663
11461592,11461590,TXFE7,128,9959,1,67873,33406,34664
11461729,11461719,TXFE7,128,9959,1,67874,33407,34665
11461767,11461756,TXFE7,128,9960,1,67875,33408,34666
11461779,11461777,TXFE7,128,9959,2,67877,33409,34667
11461817,11461808,TXFE7,128,9959,1,67878,33410,34668
11461829,11461829,TXFE7,128,9959,1,67879,33411,34669
11461842,11461841,TXFE7,128,9960,1,67880,33412,34670
11461867,11461855,TXFE7,128,9960,1,67881,33413,34671
11461879,11461867,TXFE7,128,9959,2,67883,33415,34672
11461892,11461881,TXFE7,128,9959,1,67884,33416,34673
11462029,11462020,TXFE7,128,9959,1,67885,33417,34674
11462054,11462044,TXFE7,128,9960,1,67886,33418,34675
11462054,11462051,TXFE7,128,9959,1,67887,33419,34676
11462167,11462166,TXFE7,128,9959,1,67888,33420,34677
11462192,11462190,TXFE7,128,9960,1,67889,33421,34678
11462192,11462191,TXFE7,128,9960,40,67929,33422,34699
11462204,11462201,TXFE7,128,9960,1,67930,33423,34700
11462204,11462203,TXFE7,128,9959,1,67931,33424,34701
11462204,11462203,TXFE7,128,9959,1,67932,33425,34702
11462304,11462302,TXFE7,128,9959,1,67933,33426,34703
11462354,11462342,TXFE7,128,9960,1,67934,33427,34704
11462354,11462348,TXFE7,128,9960,9,67943,33428,34711
11462404,11462398,TXFE7,128,9960,1,67944,33429,34712
11462479,11462476,TXFE7,128,9960,1,67945,33430,34713
11462492,11462491,TXFE7,128,9959,1,67946,33431,34714
11462517,11462509,TXFE7,128,9960,1,67947,33432,34715
11462692,11462688,TXFE7,128,9960,1,67948,33433,34716
11462704,11462696,TXFE7,128,9959,5,67953,33436,34717
11462729,11462719,TXFE7,128,9959,4,67957,33437,34718
11462742,11462737,TXFE7,128,9959,2,67959,33438,34719
11462804,11462800,TXFE7,128,9960,2,67961,33439,34720
11462854,11462846,TXFE7,128,9959,1,67962,33440,34721
11463004,11462992,TXFE7,128,9959,6,67968,33442,34722
11463067,11463057,TXFE7,128,9959,1,67969,33443,34723
11463079,11463076,TXFE7,128,9959,1,67970,33444,34724
11463092,11463084,TXFE7,128,9960,1,67971,33445,34725
11463154,11463152,TXFE7,128,9960,2,67973,33446,34727
11463167,11463166,TXFE7,128,9960,1,67974,33447,34728
11463242,11463233,TXFE7,128,9960,1,67975,33448,34729
11463367,11463357,TXFE7,128,9960,1,67976,33449,34730
11463404,11463399,TXFE7,128,9959,1,67977,33450,34731
11463429,11463425,TXFE7,128,9959,2,67979,33451,34732
11463454,11463445,TXFE7,128,9960,1,67980,33452,34733
11463479,11463473,TXFE7,128,9960,1,67981,33453,34734
11463492,11463491,TXFE7,128,9959,1,67982,33454,34735
11463629,11463625,TXFE7,128,9959,10,67992,33460,34736
11463629,11463628,TXFE7,128,9960,1,67993,33461,34737
11463754,11463742,TXFE7,128,9960,1,67994,33462,34738
11463817,11463806,TXFE7,128,9959,2,67996,33464,34739
11463829,11463817,TXFE7,128,9960,1,67997,33465,34740
11463904,11463897,TXFE7,128,9959,1,67998,33466,34741
11463917,11463909,TXFE7,128,9960,1,67999,33467,34742
11463992,11463989,TXFE7,128,9959,1,68000,33468,34743
11464004,11463995,TXFE7,128,9960,1,68001,33469,34744
11464104,11464103,TXFE7,128,9959,24,68025,33481,34745
11464117,11464104,TXFE7,128,9959,2,68027,33483,34746
11464117,11464104,TXFE7,128,9959,2,68029,33485,34747
11464117,11464104,TXFE7,128,9959,2,68031,33486,34748
11464117,11464104,TXFE7,128,9959,13,68044,33490,34749
11464117,11464104,TXFE7,128,9959,1,68045,33491,34750
11464117,11464104,TXFE7,128,9959,1,68046,33492,34751
11464117,11464104,TXFE7,128,9959,2,68048,33494,34752
11464117,11464104,TXFE7,128,9959,4,68052,33496,34753
11464117,11464109,TXFE7,128,9959,5,68057,33498,34754
11464117,11464109,TXFE7,128,9959,2,68059,33499,34755
11464117,11464109,TXFE7,128,9959,1,68060,33500,34756
11464129,11464121,TXFE7,128,9958,1,68061,33501,34757
11464142,11464129,TXFE7,128,9958,2,68063,33502,34758
11464142,11464129,TXFE7,128,9958,1,68064,33503,34759
11464142,11464129,TXFE7,128,9958,1,68065,33504,34760
11464142,11464129,TXFE7,128,9958,1,68066,33505,34761
11464142,11464129,TXFE7,128,9958,1,68067,33506,34762
11464167,11464155,TXFE7,128,9958,14,68081,33512,34763
11464167,11464161,TXFE7,128,9959,1,68082,33513,34764
11464179,11464171,TXFE7,128,9959,2,68084,33514,34765
11464179,11464174,TXFE7,128,9958,1,68085,33515,34766
11464192,11464179,TXFE7,128,9958,6,68091,33517,34767
11464192,11464179,TXFE7,128,9958,4,68095,33521,34768
11464192,11464180,TXFE7,128,9958,6,68101,33527,34769
11464192,11464180,TXFE7,128,9958,30,68131,33541,34770
11464192,11464185,TXFE7,128,9959,3,68134,33542,34773
11464204,11464196,TXFE7,128,9958,1,68135,33543,34774
11464204,11464202,TXFE7,128,9958,3,68138,33544,34775
11464217,11464214,TXFE7,128,9957,1,68139,33545,34776
11464229,11464225,TXFE7,128,9957,1,68140,33546,34777
11464254,11464245,TXFE7,128,9958,2,68142,33547,34778
11464279,11464275,TXFE7,128,9957,5,68147,33548,34779
11464292,11464289,TXFE7,128,9957,3,68150,33551,34780
11464292,11464291,TXFE7,128,9957,1,68151,33552,34781
11464404,11464397,TXFE7,128,9957,3,68154,33553,34782
11464504,11464502,TXFE7,128,9957,1,68155,33554,34783
11464554,11464546,TXFE7,128,9957,5,68160,33555,34784
11464579,11464574,TXFE7,128,9957,5,68165,33556,34785
11464604,11464600,TXFE7,128,9957,5,68170,33560,34786
11464629,11464626,TXFE7,128,9957,5,68175,33563,34787
11464642,11464634,TXFE7,128,9958,2,68177,33564,34788
11464679,11464675,TXFE7,128,9958,1,68178,33565,34789
11464704,11464704,TXFE7,128,9957,1,68179,33566,34790
11464717,11464715,TXFE7,128,9957,1,68180,33567,34791
11464942,11464934,TXFE7,128,9957,1,68181,33568,34792
11465117,11465107,TXFE7,128,9957,1,68182,33569,34793
11465167,11465156,TXFE7,128,9958,1,68183,33570,34794
11465167,11465157,TXFE7,128,9957,4,68187,33573,34795
11465179,11465167,TXFE7,128,9957,31,68218,33594,34796
11465217,11465208,TXFE7,128,9958,1,68219,33595,34797
11465254,11465242,TXFE7,128,9957,1,68220,33596,34798
11465254,11465242,TXFE7,128,9957,1,68221,33597,34799
11465254,11465247,TXFE7,128,9957,1,68222,33598,34800
11465317,11465305,TXFE7,128,9957,4,68226,33601,34801
11465317,11465306,TXFE7,128,9957,4,68230,33602,34802
11465417,11465405,TXFE7,128,9957,1,68231,33603,34803
11465417,11465407,TXFE7,128,9957,1,68232,33604,34804
11465517,11465505,TXFE7,128,9957,10,68242,33605,34805
11465529,11465521,TXFE7,128,9958,1,68243,33606,34806
11465654,11465649,TXFE7,128,9957,1,68244,33607,34807
11465729,11465721,TXFE7,128,9956,3,68247,33609,34808
11465754,11465748,TXFE7,128,9956,1,68248,33610,34809
11465754,11465752,TXFE7,128,9956,1,68249,33611,34810
11465767,11465758,TXFE7,128,9957,1,68250,33612,34811
11465879,11465874,TXFE7,128,9956,2,68252,33613,34812
11465892,11465886,TXFE7,128,9957,1,68253,33614,34813
11470042,11470033,TXFE7,128,9956,2,68255,33616,34814
11470079,11470067,TXFE7,128,9957,3,68258,33617,34815
11470079,11470070,TXFE7,128,9957,9,68267,33618,34817
11470092,11470081,TXFE7,128,9957,1,68268,33619,34818
11470092,11470088,TXFE7,128,9957,1,68269,33620,34819
11470104,11470100,TXFE7,128,9957,3,68272,33621,34821
11470117,11470104,TXFE7,128,9956,1,68273,33622,34822
11470117,11470105,TXFE7,128,9957,1,68274,33623,34823
11470167,11470159,TXFE7,128,9957,2,68276,33624,34825
11470167,11470166,TXFE7,128,9957,1,68277,33625,34826
11470179,11470169,TXFE7,128,9956,1,68278,33626,34827
11470179,11470171,TXFE7,128,9956,1,68279,33627,34828
11470179,11470172,TXFE7,128,9956,1,68280,33628,34829
11470179,11470172,TXFE7,128,9956,1,68281,33629,34830
11470179,11470173,TXFE7,128,9956,1,68282,33630,34831
11470179,11470174,TXFE7,128,9956,1,68283,33631,34832
11470179,11470174,TXFE7,128,9956,1,68284,33632,34833
11470179,11470174,TXFE7,128,9956,1,68285,33633,34834
11470179,11470175,TXFE7,128,9956,1,68286,33634,34835
11470179,11470176,TXFE7,128,9956,1,68287,33635,34836
11470179,11470176,TXFE7,128,9956,1,68288,33636,34837
11470179,11470176,TXFE7,128,9956,1,68289,33637,34838
11470179,11470178,TXFE7,128,9956,1,68290,33638,34839
11470179,11470178,TXFE7,128,9956,1,68291,33639,34840
11470192,11470182,TXFE7,129,9956,33,68327,33663,34841
11470192,11470182,TXFE7,129,9955,3,68327,33663,34841
11470204,11470192,TXFE7,128,9956,1,68328,33664,34842
11470204,11470193,TXFE7,128,9956,2,68330,33665,34844
11470217,11470213,TXFE7,128,9955,1,68331,33666,34845
11470254,11470242,TXFE7,128,9955,1,68332,33667,34846
11470254,11470250,TXFE7,128,9955,6,68338,33673,34847
11470267,11470261,TXFE7,128,9956,7,68345,33674,34850
11470279,11470275,TXFE7,128,9955,5,68350,33676,34851
11470292,11470284,TXFE7,128,9956,1,68351,33677,34852
11470342,11470332,TXFE7,128,9955,1,68352,33678,34853
11470342,11470338,TXFE7,128,9956,1,68353,33679,34854
11470379,11470376,TXFE7,128,9956,1,68354,33680,34855
11470417,11470405,TXFE7,128,9956,6,68360,33681,34857
11470429,11470428,TXFE7,128,9956,1,68361,33682,34858
11470442,11470432,TXFE7,128,9956,1,68362,33683,34859
11470492,11470480,TXFE7,128,9956,5,68367,33684,34860
11470504,11470494,TXFE7,128,9955,2,68369,33686,34861
11470542,11470538,TXFE7,128,9955,1,68370,33687,34862
11470629,11470627,TXFE7,128,9956,1,68371,33688,34863
11470704,11470703,TXFE7,128,9955,1,68372,33689,34864
11470742,11470735,TXFE7,128,9956,1,68373,33690,34865
11470754,11470753,TXFE7,128,9955,3,68376,33692,34866
11470767,11470765,TXFE7,128,9955,1,68377,33693,34867
11470942,11470940,TXFE7,128,9955,1,68378,33694,34868
11470979,11470979,TXFE7,128,9955,2,68380,33696,34869
11471104,11471096,TXFE7,128,9956,1,68381,33697,34870
11471142,11471136,TXFE7,128,9955,3,68384,33699,34871
11471192,11471189,TXFE7,128,9956,2,68386,33700,34873
11471254,11471243,TXFE7,128,9956,2,68388,33701,34875
11471417,11471406,TXFE7,128,9955,5,68393,33705,34876
11471417,11471407,TXFE7,128,9956,2,68395,33706,34877
11471504,11471498,TXFE7,128,9956,1,68396,33707,34878
11471504,11471504,TXFE7,128,9956,1,68397,33708,34879
11471529,11471524,TXFE7,128,9956,1,68398,33709,34880
11471542,11471532,TXFE7,128,9956,3,68401,33710,34881
11471542,11471533,TXFE7,128,9955,1,68402,33711,34882
11471554,11471544,TXFE7,128,9956,1,68403,33712,34883
11471567,11471558,TXFE7,128,9956,1,68404,33713,34884
11471579,11471574,TXFE7,128,9955,1,68405,33714,34885
11471617,11471615,TXFE7,128,9955,2,68407,33716,34886
11471629,11471626,TXFE7,128,9956,1,68408,33717,34887
11471654,11471645,TXFE7,128,9955,10,68418,33725,34888
11471654,11471653,TXFE7,128,9956,1,68419,33726,34889
11471829,11471827,TXFE7,128,9956,1,68420,33727,34890
11471842,11471829,TXFE7,128,9956,6,68426,33728,34892
11471842,11471829,TXFE7,128,9956,4,68430,33729,34894
11471854,11471842,TXFE7,128,9956,2,68432,33730,34895
11471854,11471843,TXFE7,128,9955,12,68444,33737,34896
11471904,11471897,TXFE7,128,9956,1,68445,33738,34897
11471967,11471965,TXFE7,128,9956,1,68446,33739,34898
11471979,11471969,TXFE7,128,9956,1,68447,33740,34899
11471979,11471975,TXFE7,128,9955,5,68452,33744,34900
11471992,11471992,TXFE7,128,9955,5,68457,33749,34901
11472017,11472015,TXFE7,128,9956,1,68458,33750,34902
11472067,11472065,TXFE7,128,9956,1,68459,33751,34903
11472079,11472077,TXFE7,128,9956,1,68460,33752,34904
11472104,11472098,TXFE7,128,9956,1,68461,33753,34905
11472254,11472248,TXFE7,128,9956,1,68462,33754,34906
11472267,11472255,TXFE7,128,9956,2,68464,33756,34908
11472279,11472276,TXFE7,128,9956,1,68465,33757,34909
11472329,11472329,TXFE7,128,9955,1,68466,33758,34910
11472417,11472413,TXFE7,128,9956,3,68469,33759,34913
11472492,11472480,TXFE7,128,9955,1,68470,33760,34914
11472492,11472481,TXFE7,128,9956,2,68472,33761,34915
11472717,11472716,TXFE7,128,9955,4,68476,33762,34916
11472829,11472820,TXFE7,128,9955,5,68481,33764,34917
11472829,11472823,TXFE7,128,9956,1,68482,33765,34918
11472854,11472847,TXFE7,128,9956,1,68483,33766,34919
11472942,11472937,TXFE7,128,9955,5,68488,33769,34920
11472979,11472977,TXFE7,128,9955,1,68489,33770,34921
11473067,11473062,TXFE7,128,9956,1,68490,33771,34922
11473104,11473094,TXFE7,128,9956,15,68505,33772,34930
11473104,11473096,TXFE7,128,9956,1,68506,33773,34931
11473154,11473144,TXFE7,128,9956,2,68508,33774,34932
11473179,11473167,TXFE7,128,9956,4,68512,33775,34936
11473192,11473180,TXFE7,128,9956,1,68513,33776,34937
11473192,11473184,TXFE7,128,9956,1,68514,33777,34938
11473192,11473191,TXFE7,128,9956,1,68515,33778,34939
11473204,11473200,TXFE7,128,9955,5,68520,33780,34940
11473217,11473212,TXFE7,128,9956,1,68521,33781,34941
11473292,11473280,TXFE7,129,9956,3,68526,33784,34942
11473292,11473280,TXFE7,129,9955,2,68526,33784,34942
11473292,11473288,TXFE7,128,9955,5,68531,33787,34943
11473304,11473292,TXFE7,128,9956,1,68532,33788,34944
11473304,11473292,TXFE7,128,9956,4,68536,33789,34945
11473304,11473294,TXFE7,128,9956,1,68537,33790,34946
11473304,11473295,TXFE7,128,9956,1,68538,33791,34947
11473304,11473297,TXFE7,128,9956,1,68539,33792,34948
11473317,11473305,TXFE7,128,9956,5,68544,33793,34950
11473342,11473333,TXFE7,128,9956,1,68545,33794,34951
11473354,11473351,TXFE7,128,9956,1,68546,33795,34952
11473417,11473412,TXFE7,128,9956,1,68547,33796,34953
11473454,11473442,TXFE7,128,9956,1,68548,33797,34954
11473454,11473452,TXFE7,128,9956,3,68551,33798,34955
11473492,11473480,TXFE7,128,9956,3,68554,33799,34956
11473517,11473517,TXFE7,128,9955,1,68555,33800,34957
11473529,11473519,TXFE7,128,9956,1,68556,33801,34958
11473542,11473541,TXFE7,128,9956,1,68557,33802,34959
11473554,11473553,TXFE7,128,9956,1,68558,33803,34960
11473579,11473575,TXFE7,128,9956,1,68559,33804,34961
11473767,11473765,TXFE7,128,9956,1,68560,33805,34962
11473792,11473786,TXFE7,128,9956,1,68561,33806,34963
11473917,11473906,TXFE7,128,9956,1,68562,33807,34964
11474067,11474060,TXFE7,128,9956,2,68564,33808,34965
11474079,11474074,TXFE7,128,9956,1,68565,33809,34966
11474242,11474239,TXFE7,128,9956,1,68566,33810,34967
11474329,11474318,TXFE7,128,9956,9,68575,33811,34973
11474704,11474699,TXFE7,128,9956,5,68580,33812,34974
11474879,11474875,TXFE7,128,9956,1,68581,33813,34975
11474942,11474937,TXFE7,128,9956,1,68582,33814,34976
11474954,11474945,TXFE7,128,9956,7,68589,33815,34977
11475067,11475055,TXFE7,128,9957,2,68591,33816,34979
11475117,11475113,TXFE7,128,9957,33,68624,33817,34995
11475129,11475117,TXFE7,128,9957,1,68625,33818,34996
11475129,11475117,TXFE7,128,9957,1,68626,33819,34997
11475129,11475117,TXFE7,128,9957,1,68627,33820,34998
11475129,11475121,TXFE7,128,9957,2,68629,33821,34999
11475142,11475129,TXFE7,128,9957,2,68631,33822,35000
11475142,11475134,TXFE7,128,9957,1,68632,33823,35001
11475192,11475181,TXFE7,128,9956,1,68633,33824,35002
11475317,11475312,TXFE7,128,9957,11,68644,33825,35006
11475329,11475320,TXFE7,128,9957,22,68666,33826,35007
11475329,11475321,TXFE7,128,9957,6,68672,33829,35008
11475442,11475434,TXFE7,128,9957,1,68673,33830,35009
11475679,11475678,TXFE7,128,9957,5,68678,33831,35013
11480017,11480006,TXFE7,128,9956,5,68683,33832,35014
11480017,11480009,TXFE7,128,9957,1,68684,33833,35015
11480029,11480020,TXFE7,128,9957,1,68685,33834,35016
11480029,11480029,TXFE7,128,9956,1,68686,33835,35017
11480042,11480039,TXFE7,128,9957,2,68688,33836,35018
11480079,11480068,TXFE7,128,9957,1,68689,33837,35019
11480079,11480074,TXFE7,128,9957,1,68690,33838,35020
11480092,11480085,TXFE7,128,9957,1,68691,33839,35021
11480117,11480105,TXFE7,128,9957,1,68692,33840,35022
11480167,11480156,TXFE7,128,9957,1,68693,33841,35023
11480179,11480176,TXFE7,129,9957,4,68698,33842,35026
11480179,11480176,TXFE7,129,9958,1,68698,33842,35026
11480179,11480178,TXFE7,128,9958,2,68700,33843,35027
11480192,11480181,TXFE7,128,9957,1,68701,33844,35028
11480192,11480185,TXFE7,128,9956,1,68702,33845,35029
11480192,11480185,TXFE7,128,9956,1,68703,33846,35030
11480192,11480186,TXFE7,128,9956,1,68704,33847,35031
11480192,11480186,TXFE7,128,9956,1,68705,33848,35032
11480192,11480187,TXFE7,128,9958,1,68706,33849,35033
11480192,11480187,TXFE7,128,9956,1,68707,33850,35034
11480229,11480217,TXFE7,128,9957,2,68709,33851,35035
11480254,11480251,TXFE7,128,9957,1,68710,33852,35036
11480317,11480305,TXFE7,128,9957,4,68714,33854,35037
11480379,11480375,TXFE7,128,9956,5,68719,33857,35038
11480454,11480450,TXFE7,129,9957,2,68725,33858,35043
11480454,11480450,TXFE7,129,9958,4,68725,33858,35043
11480467,11480455,TXFE7,128,9957,1,68726,33859,35044
11480467,11480456,TXFE7,128,9957,1,68727,33860,35045
11480467,11480457,TXFE7,128,9957,1,68728,33861,35046
11480467,11480463,TXFE7,128,9958,1,68729,33862,35047
11480529,11480520,TXFE7,128,9957,1,68730,33863,35048
11480529,11480524,TXFE7,128,9957,1,68731,33864,35049
11480542,11480530,TXFE7,128,9957,1,68732,33865,35050
11480667,11480660,TXFE7,128,9957,2,68734,33866,35051
11480679,11480671,TXFE7,128,9957,2,68736,33867,35052
11480692,11480683,TXFE7,128,9957,1,68737,33868,35053
11480754,11480754,TXFE7,128,9957,1,68738,33869,35054
11480829,11480819,TXFE7,128,9957,1,68739,33870,35055
11480892,11480880,TXFE7,128,9957,1,68740,33871,35056
11480992,11480991,TXFE7,128,9956,4,68744,33874,35057
11481017,11481005,TXFE7,128,9957,3,68747,33875,35060
11481054,11481045,TXFE7,128,9957,1,68748,33876,35061
11481154,11481142,TXFE7,128,9956,4,68752,33877,35062
11481167,11481159,TXFE7,128,9956,20,68772,33892,35063
11481167,11481159,TXFE7,128,9956,23,68795,33909,35064
11481179,11481179,TXFE7,128,9956,2,68797,33910,35066
11481204,11481193,TXFE7,128,9955,1,68798,33911,35067
11481254,11481245,TXFE7,128,9956,5,68803,33912,35072
11481279,11481271,TXFE7,128,9956,1,68804,33913,35073
11481354,11481352,TXFE7,128,9956,2,68806,33914,35074
11481479,11481478,TXFE7,128,9955,1,68807,33915,35075
11481567,11481555,TXFE7,128,9956,1,68808,33916,35076
11481642,11481630,TXFE7,128,9955,2,68810,33917,35077
11481704,11481702,TXFE7,128,9956,2,68812,33918,35079
11481729,11481720,TXFE7,128,9956,1,68813,33919,35080
11481817,11481806,TXFE7,128,9956,1,68814,33920,35081
11481817,11481806,TXFE7,128,9956,1,68815,33921,35082
11481829,11481817,TXFE7,128,9956,4,68819,33922,35084
11481842,11481841,TXFE7,128,9956,1,68820,33923,35085
11481854,11481843,TXFE7,128,9955,1,68821,33924,35086
11481892,11481879,TXFE7,129,9956,3,68825,33925,35090
11481892,11481879,TXFE7,129,9957,1,68825,33925,35090
11481904,11481894,TXFE7,128,9956,2,68827,33926,35091
11481904,11481895,TXFE7,128,9956,1,68828,33927,35092
11481929,11481918,TXFE7,128,9955,4,68832,33928,35093
11481929,11481920,TXFE7,128,9956,5,68837,33929,35094
11481942,11481932,TXFE7,128,9956,2,68839,33930,35095
11481942,11481942,TXFE7,128,9956,1,68840,33931,35096
11481954,11481946,TXFE7,128,9957,1,68841,33932,35097
11482517,11482513,TXFE7,128,9956,1,68842,33933,35098
11482617,11482608,TXFE7,128,9957,1,68843,33934,35099
11482617,11482609,TXFE7,128,9957,2,68845,33935,35100
11482679,11482674,TXFE7,128,9956,2,68847,33936,35101
11482892,11482886,TXFE7,128,9956,1,68848,33937,35102
11483604,11483602,TXFE7,128,9957,1,68849,33938,35103
11483642,11483630,TXFE7,128,9957,6,68855,33939,35107
11483892,11483886,TXFE7,128,9956,1,68856,33940,35108
11483942,11483931,TXFE7,128,9956,1,68857,33941,35109
11484029,11484025,TXFE7,128,9956,5,68862,33946,35110
11484042,11484034,TXFE7,128,9956,3,68865,33947,35111
11484054,11484042,TXFE7,128,9956,2,68867,33949,35112
11484054,11484048,TXFE7,128,9956,1,68868,33950,35113
11484079,11484071,TXFE7,128,9956,5,68873,33951,35114
11484092,11484086,TXFE7,128,9956,5,68878,33952,35115
11484104,11484098,TXFE7,128,9956,1,68879,33953,35116
11484154,11484148,TXFE7,128,9956,2,68881,33955,35117
11484167,11484163,TXFE7,128,9956,7,68888,33962,35118
11484179,11484167,TXFE7,128,9956,11,68899,33969,35119
11484217,11484207,TXFE7,128,9956,1,68900,33970,35120
11484329,11484323,TXFE7,128,9956,3,68903,33971,35122
11484379,11484371,TXFE7,128,9956,2,68905,33972,35124
11484429,11484424,TXFE7,128,9955,1,68906,33973,35125
11484542,11484534,TXFE7,128,9956,2,68908,33974,35127
11484542,11484540,TXFE7,128,9956,5,68913,33975,35132
11484617,11484606,TXFE7,128,9956,1,68914,33976,35133
11484654,11484651,TXFE7,128,9955,1,68915,33977,35134
11484817,11484815,TXFE7,128,9956,2,68917,33978,35136
11484829,11484823,TXFE7,128,9955,1,68918,33979,35137
11484867,11484856,TXFE7,128,9956,8,68926,33980,35141
11484879,11484873,TXFE7,128,9956,1,68927,33981,35142
11484917,11484913,TXFE7,128,9956,1,68928,33982,35143
11485129,11485119,TXFE7,128,9956,1,68929,33983,35144
11485217,11485204,TXFE7,128,9956,1,68930,33984,35145
11485217,11485215,TXFE7,128,9956,1,68931,33985,35146
11485267,11485265,TXFE7,128,9956,2,68933,33987,35147
11485417,11485410,TXFE7,128,9956,1,68934,33988,35148
11485429,11485424,TXFE7,128,9956,1,68935,33989,35149
11485454,11485445,TXFE7,128,9956,1,68936,33990,35150
11485467,11485461,TXFE7,128,9956,5,68941,33993,35151
11485479,11485470,TXFE7,128,9955,1,68942,33994,35152
11485529,11485527,TXFE7,128,9955,1,68943,33995,35153
11485554,11485546,TXFE7,128,9955,4,68947,33997,35154
11485567,11485561,TXFE7,128,9956,1,68948,33998,35155
11485717,11485710,TXFE7,128,9956,3,68951,33999,35157
11485854,11485851,TXFE7,128,9956,1,68952,34000,35158
11485929,11485927,TXFE7,128,9956,1,68953,34001,35159
11485992,11485991,TXFE7,128,9956,1,68954,34002,35160
11490004,11490003,TXFE7,128,9957,1,68955,34003,35161
11490029,11490027,TXFE7,128,9956,3,68958,34005,35162
11490054,11490045,TXFE7,128,9957,2,68960,34006,35163
11490067,11490062,TXFE7,128,9957,1,68961,34007,35164
11490079,11490077,TXFE7,128,9957,1,68962,34008,35165
11490079,11490078,TXFE7,128,9957,1,68963,34009,35166
11490379,11490369,TXFE7,128,9957,5,68968,34010,35168
11490392,11490380,TXFE7,128,9957,1,68969,34011,35169
11490429,11490421,TXFE7,128,9956,1,68970,34012,35170
11490442,11490441,TXFE7,128,9957,1,68971,34013,35171
11490467,11490454,TXFE7,128,9956,1,68972,34014,35172
11490492,11490480,TXFE7,128,9956,1,68973,34015,35173
11490529,11490525,TXFE7,128,9956,1,68974,34016,35174
11490529,11490528,TXFE7,128,9956,2,68976,34017,35175
11490979,11490969,TXFE7,128,9956,1,68977,34018,35176
11491042,11491034,TXFE7,128,9956,5,68982,34023,35177
11491054,11491046,TXFE7,128,9956,1,68983,34024,35178
11491067,11491056,TXFE7,128,9956,1,68984,34025,35179
11491329,11491328,TXFE7,128,9956,1,68985,34026,35180
11491392,11491382,TXFE7,128,9956,1,68986,34027,35181
11491579,11491576,TXFE7,128,9956,6,68992,34031,35182
11491604,11491600,TXFE7,128,9956,1,68993,34032,35183
11491629,11491629,TXFE7,128,9955,1,68994,34033,35184
11491717,11491714,TXFE7,128,9955,1,68995,34034,35185
11491779,11491768,TXFE7,128,9955,1,68996,34035,35186
11491804,11491794,TXFE7,128,9955,5,69001,34037,35187
11491804,11491804,TXFE7,128,9955,1,69002,34038,35188
11491829,11491823,TXFE7,128,9955,5,69007,34043,35189
11491867,11491859,TXFE7,128,9955,1,69008,34044,35190
11491879,11491868,TXFE7,128,9955,5,69013,34046,35191
11491879,11491875,TXFE7,128,9955,3,69016,34047,35192
11491929,11491919,TXFE7,128,9955,1,69017,34048,35193
11491942,11491930,TXFE7,128,9956,1,69018,34049,35194
11491954,11491953,TXFE7,128,9955,1,69019,34050,35195
11491967,11491959,TXFE7,128,9956,1,69020,34051,35196
11491992,11491982,TXFE7,128,9955,3,69023,34052,35197
11491992,11491982,TXFE7,128,9955,5,69028,34056,35198
11492004,11491996,TXFE7,128,9956,1,69029,34057,35199
11492042,11492036,TXFE7,128,9955,1,69030,34058,35200
11492042,11492041,TXFE7,128,9956,1,69031,34059,35201
11492054,11492053,TXFE7,128,9956,4,69035,34060,35203
11492067,11492064,TXFE7,128,9955,1,69036,34061,35204
11492067,11492066,TXFE7,128,9955,3,69039,34063,35205
11492179,11492170,TXFE7,128,9955,1,69040,34064,35206
11492429,11492426,TXFE7,128,9956,1,69041,34065,35207
11492479,11492474,TXFE7,128,9956,1,69042,34066,35208
11492567,11492566,TXFE7,128,9955,1,69043,34067,35209
11492604,11492595,TXFE7,128,9955,1,69044,34068,35210
11492817,11492810,TXFE7,128,9955,2,69046,34069,35211
11492967,11492963,TXFE7,128,9955,6,69052,34072,35212
11493154,11493143,TXFE7,128,9956,5,69057,34073,35217
11493242,11493237,TXFE7,128,9956,1,69058,34074,35218
11493254,11493242,TXFE7,128,9956,1,69059,34075,35219
11493254,11493242,TXFE7,128,9956,4,69063,34076,35221
11493267,11493254,TXFE7,128,9956,5,69068,34077,35222
11493267,11493254,TXFE7,128,9956,1,69069,34078,35223
11493267,11493254,TXFE7,128,9956,1,69070,34079,35224
11493267,11493254,TXFE7,128,9956,8,69078,34080,35230
11493267,11493254,TXFE7,128,9956,1,69079,34081,35231
11493267,11493255,TXFE7,128,9956,1,69080,34082,35232
11493279,11493267,TXFE7,128,9956,1,69081,34083,35233
11493279,11493267,TXFE7,128,9956,1,69082,34084,35234
11493279,11493267,TXFE7,128,9956,2,69084,34085,35235
11493279,11493271,TXFE7,128,9957,1,69085,34086,35236
11493279,11493275,TXFE7,128,9956,1,69086,34087,35237
11493354,11493344,TXFE7,128,9957,5,69091,34088,35242
11493517,11493514,TXFE7,128,9957,1,69092,34089,35243
11493529,11493526,TXFE7,128,9956,1,69093,34090,35244
11493579,11493575,TXFE7,128,9956,1,69094,34091,35245
11493579,11493576,TXFE7,128,9957,1,69095,34092,35246
11493854,11493850,TXFE7,128,9957,5,69100,34093,35250
11493904,11493893,TXFE7,128,9956,2,69102,34094,35251
11493904,11493895,TXFE7,128,9956,1,69103,34095,35252
11494004,11493998,TXFE7,128,9957,2,69105,34096,35254
11494142,11494141,TXFE7,128,9957,5,69110,34097,35257
11494179,11494173,TXFE7,128,9957,1,69111,34098,35258
11494354,11494352,TXFE7,128,9956,1,69112,34099,35259
11494379,11494368,TXFE7,128,9957,1,69113,34100,35260
11494454,11494443,TXFE7,128,9957,2,69115,34101,35262
11494517,11494509,TXFE7,128,9957,1,69116,34102,35263
11494554,11494548,TXFE7,128,9957,34,69150,34103,35284
11494667,11494664,TXFE7,128,9958,1,69151,34104,35285
11494742,11494741,TXFE7,128,9958,5,69156,34105,35290
11494942,11494930,TXFE7,128,9958,1,69157,34106,35291
11494992,11494986,TXFE7,128,9958,1,69158,34107,35292
11495067,11495058,TXFE7,128,9957,1,69159,34108,35293
11495092,11495086,TXFE7,128,9957,2,69161,34109,35294
11495229,11495221,TXFE7,128,9958,1,69162,34110,35295
11495342,11495329,TXFE7,128,9957,1,69163,34111,35296
11495442,11495435,TXFE7,128,9958,1,69164,34112,35297
11495579,11495571,TXFE7,128,9957,1,69165,34113,35298
11495667,11495656,TXFE7,128,9958,1,69166,34114,35299
11495792,11495782,TXFE7,128,9957,1,69167,34115,35300
11500129,11500120,TXFE7,128,9957,20,69187,34128,35301
11500142,11500129,TXFE7,128,9957,2,69189,34130,35302
11500154,11500147,TXFE7,128,9956,4,69193,34131,35303
11500154,11500153,TXFE7,128,9957,1,69194,34132,35304
11500179,11500173,TXFE7,128,9956,1,69195,34133,35305
11500179,11500173,TXFE7,128,9956,2,69197,34134,35306
11500179,11500179,TXFE7,128,9957,10,69207,34135,35311
11500192,11500181,TXFE7,128,9956,6,69213,34137,35312
11500192,11500183,TXFE7,128,9957,1,69214,34138,35313
11500192,11500191,TXFE7,128,9956,20,69234,34146,35314
11500204,11500202,TXFE7,128,9956,1,69235,34147,35315
11500217,11500206,TXFE7,128,9956,2,69237,34149,35316
11500229,11500226,TXFE7,128,9956,1,69238,34150,35317
11500392,11500386,TXFE7,128,9956,2,69240,34152,35318
11500454,11500443,TXFE7,128,9957,1,69241,34153,35319
11500454,11500444,TXFE7,128,9957,1,69242,34154,35320
11500692,11500690,TXFE7,128,9957,10,69252,34155,35325
11500742,11500737,TXFE7,128,9957,1,69253,34156,35326
11500804,11500804,TXFE7,128,9956,1,69254,34157,35327
11501129,11501124,TXFE7,128,9956,1,69255,34158,35328
11501254,11501249,TXFE7,128,9956,2,69257,34159,35329
11501292,11501287,TXFE7,128,9956,4,69261,34163,35330
11501317,11501316,TXFE7,128,9956,5,69266,34168,35331
11501342,11501332,TXFE7,128,9956,5,69271,34171,35332
11501354,11501342,TXFE7,128,9956,1,69272,34172,35333
11501379,11501373,TXFE7,128,9956,1,69273,34173,35334
11501667,11501659,TXFE7,128,9956,1,69274,34174,35335
11501692,11501689,TXFE7,128,9956,2,69276,34176,35336
11501792,11501791,TXFE7,128,9956,1,69277,34177,35337
11501817,11501805,TXFE7,128,9956,1,69278,34178,35338
11501842,11501840,TXFE7,128,9956,1,69279,34179,35339
11501867,11501862,TXFE7,128,9956,1,69280,34180,35340
11501879,11501875,TXFE7,128,9956,1,69281,34181,35341
11501904,11501903,TXFE7,128,9956,1,69282,34182,35342
11501929,11501925,TXFE7,128,9956,1,69283,34183,35343
11501942,11501941,TXFE7,128,9956,1,69284,34184,35344
11502017,11502007,TXFE7,128,9956,1,69285,34185,35345
11502054,11502054,TXFE7,128,9956,1,69286,34186,35346
11502367,11502357,TXFE7,128,9957,2,69288,34187,35347
11502792,11502788,TXFE7,128,9956,1,69289,34188,35348
11503142,11503140,TXFE7,128,9956,1,69290,34189,35349
11503392,11503390,TXFE7,128,9956,1,69291,34190,35350
11503904,11503900,TXFE7,128,9956,1,69292,34191,35351
11504842,11504832,TXFE7,128,9957,2,69294,34192,35352
11504879,11504870,TXFE7,128,9957,10,69304,34193,35359
11504892,11504889,TXFE7,128,9957,1,69305,34194,35360
11505092,11505083,TXFE7,128,9957,1,69306,34195,35361
11505367,11505355,TXFE7,128,9956,1,69307,34196,35362
11505379,11505373,TXFE7,128,9957,3,69310,34197,35363
11505529,11505518,TXFE7,128,9957,2,69312,34198,35364
11505854,11505852,TXFE7,128,9956,2,69314,34200,35365
11510104,11510100,TXFE7,128,9956,5,69319,34202,35366
11510154,11510150,TXFE7,128,9957,2,69321,34203,35367
11510179,11510173,TXFE7,128,9957,1,69322,34204,35368
11510204,11510193,TXFE7,128,9957,1,69323,34205,35369
11510229,11510224,TXFE7,128,9957,3,69326,34206,35370
11510229,11510228,TXFE7,128,9956,12,69338,34213,35371
11510367,11510357,TXFE7,128,9956,1,69339,34214,35372
11510467,11510467,TXFE7,128,9957,1,69340,34215,35373
11510692,11510688,TXFE7,128,9956,1,69341,34216,35374
11510917,11510911,TXFE7,128,9956,1,69342,34217,35375
11511379,11511375,TXFE7,128,9956,3,69345,34220,35376
11511404,11511404,TXFE7,128,9956,1,69346,34221,35377
11511767,11511755,TXFE7,128,9956,10,69356,34225,35378
11511817,11511810,TXFE7,128,9957,4,69360,34226,35380
11511817,11511811,TXFE7,128,9956,5,69365,34228,35381
11511854,11511848,TXFE7,128,9956,1,69366,34229,35382
11511904,11511901,TXFE7,128,9956,5,69371,34230,35383
11511904,11511903,TXFE7,128,9956,5,69376,34235,35384
11511929,11511917,TXFE7,128,9956,1,69377,34236,35385
11511979,11511975,TXFE7,128,9956,5,69382,34237,35386
11511979,11511976,TXFE7,128,9956,3,69385,34238,35387
11511992,11511979,TXFE7,128,9956,4,69389,34239,35388
11511992,11511980,TXFE7,128,9956,1,69390,34240,35389
11512004,11511992,TXFE7,128,9956,3,69393,34243,35390
11512004,11511992,TXFE7,128,9956,3,69396,34245,35391
11512004,11511996,TXFE7,128,9956,1,69397,34246,35392
11512029,11512023,TXFE7,128,9956,4,69401,34247,35394
11512029,11512027,TXFE7,128,9955,1,69402,34248,35395
11512042,11512039,TXFE7,128,9956,1,69403,34249,35396
11512054,11512043,TXFE7,128,9955,1,69404,34250,35397
11512067,11512057,TXFE7,128,9955,3,69407,34251,35398
11512092,11512080,TXFE7,128,9956,1,69408,34252,35399
11512117,11512106,TXFE7,128,9956,1,69409,34253,35400
11512329,11512323,TXFE7,128,9955,2,69411,34254,35401
11512354,11512347,TXFE7,128,9956,1,69412,34255,35402
11512517,11512509,TXFE7,128,9956,1,69413,34256,35403
11512667,11512662,TXFE7,128,9955,1,69414,34257,35404
11512717,11512709,TXFE7,128,9956,15,69429,34258,35409
11512754,11512750,TXFE7,128,9956,1,69430,34259,35410
11512967,11512958,TXFE7,128,9955,1,69431,34260,35411
11513004,11513003,TXFE7,128,9955,1,69432,34261,35412
11513117,11513117,TXFE7,128,9955,1,69433,34262,35413
11513217,11513216,TXFE7,128,9956,1,69434,34263,35414
11513392,11513389,TXFE7,128,9955,2,69436,34264,35415
11513467,11513455,TXFE7,128,9956,2,69438,34265,35416
11513479,11513470,TXFE7,128,9956,5,69443,34266,35420
11513679,11513678,TXFE7,128,9955,1,69444,34267,35421
11513717,11513708,TXFE7,128,9955,1,69445,34268,35422
11513729,11513722,TXFE7,128,9955,1,69446,34269,35423
11513729,11513727,TXFE7,128,9955,1,69447,34270,35424
11513754,11513750,TXFE7,128,9955,1,69448,34271,35425
11513779,11513770,TXFE7,128,9955,1,69449,34272,35426
11513792,11513792,TXFE7,128,9955,1,69450,34273,35427
11513817,11513811,TXFE7,128,9955,1,69451,34274,35428
11513817,11513815,TXFE7,128,9955,3,69454,34275,35429
11513867,11513857,TXFE7,128,9955,1,69455,34276,35430
11513867,11513863,TXFE7,128,9955,1,69456,34277,35431
11513904,11513899,TXFE7,128,9955,1,69457,34278,35432
11513929,11513921,TXFE7,128,9955,1,69458,34279,35433
11514267,11514258,TXFE7,128,9955,1,69459,34280,35434
11514292,11514281,TXFE7,128,9955,1,69460,34281,35435
11514317,11514304,TXFE7,128,9955,1,69461,34282,35436
11514354,11514346,TXFE7,128,9955,1,69462,34283,35437
11514379,11514370,TXFE7,128,9955,1,69463,34284,35438
11514404,11514397,TXFE7,128,9955,1,69464,34285,35439
11514479,11514468,TXFE7,128,9955,2,69466,34286,35440
11514504,11514492,TXFE7,128,9955,2,69468,34287,35441
11514517,11514515,TXFE7,128,9955,2,69470,34288,35442
11514542,11514536,TXFE7,128,9955,2,69472,34290,35443
11514567,11514563,TXFE7,128,9955,2,69474,34291,35444
11514592,11514585,TXFE7,128,9955,2,69476,34292,35445
11514604,11514601,TXFE7,128,9955,2,69478,34294,35446
11514617,11514609,TXFE7,128,9956,4,69482,34295,35447
11514629,11514618,TXFE7,128,9955,2,69484,34296,35448
11514642,11514632,TXFE7,128,9955,2,69486,34298,35449
11514654,11514643,TXFE7,128,9955,1,69487,34299,35450
11514654,11514648,TXFE7,128,9955,2,69489,34301,35451
11514654,11514652,TXFE7,128,9955,1,69490,34302,35452
11514667,11514664,TXFE7,128,9955,2,69492,34303,35453
11514692,11514680,TXFE7,128,9955,2,69494,34304,35454
11514704,11514696,TXFE7,128,9955,3,69497,34305,35455
11514704,11514697,TXFE7,128,9955,2,69499,34306,35456
11514704,11514699,TXFE7,128,9955,2,69501,34307,35457
11514717,11514712,TXFE7,128,9955,2,69503,34308,35458
11514717,11514714,TXFE7,128,9955,3,69506,34309,35459
11514729,11514727,TXFE7,128,9955,2,69508,34310,35460
11514729,11514728,TXFE7,128,9955,2,69510,34311,35461
11514742,11514735,TXFE7,128,9955,3,69513,34314,35462
11514754,11514746,TXFE7,128,9955,2,69515,34315,35463
11514767,11514759,TXFE7,128,9955,1,69516,34316,35464
11514767,11514760,TXFE7,128,9955,2,69518,34318,35465
11514779,11514771,TXFE7,128,9955,20,69538,34328,35466
11514779,11514771,TXFE7,128,9955,6,69544,34332,35467
11514779,11514776,TXFE7,128,9955,3,69547,34333,35468
11514779,11514779,TXFE7,128,9955,2,69549,34334,35469
11514792,11514779,TXFE7,128,9955,10,69559,34339,35470
11514792,11514779,TXFE7,128,9955,4,69563,34341,35471
11514792,11514779,TXFE7,128,9955,2,69565,34343,35472
11514792,11514779,TXFE7,128,9955,6,69571,34348,35473
11514792,11514784,TXFE7,128,9955,4,69575,34349,35474
11514792,11514784,TXFE7,128,9955,2,69577,34350,35475
11514792,11514784,TXFE7,128,9955,13,69590,34356,35476
11514792,11514786,TXFE7,128,9955,1,69591,34357,35477
11514829,11514819,TXFE7,128,9954,3,69594,34358,35478
11514842,11514833,TXFE7,128,9954,1,69595,34359,35479
11514842,11514834,TXFE7,128,9954,2,69597,34360,35480
11514842,11514837,TXFE7,128,9954,1,69598,34361,35481
11514842,11514840,TXFE7,128,9954,3,69601,34364,35482
11514854,11514843,TXFE7,128,9954,1,69602,34365,35483
11514854,11514844,TXFE7,128,9955,3,69605,34366,35486
11514867,11514857,TXFE7,128,9954,1,69606,34367,35487
11514879,11514878,TXFE7,128,9955,1,69607,34368,35488
11514892,11514891,TXFE7,128,9954,1,69608,34369,35489
11514904,11514894,TXFE7,128,9954,2,69610,34371,35490
11514929,11514919,TXFE7,128,9954,1,69611,34372,35491
11514979,11514973,TXFE7,128,9955,1,69612,34373,35492
11515004,11514994,TXFE7,128,9955,1,69613,34374,35493
11515017,11515010,TXFE7,128,9954,1,69614,34375,35494
11515092,11515087,TXFE7,128,9954,4,69618,34378,35495
11515092,11515089,TXFE7,128,9954,1,69619,34379,35496
11515117,11515111,TXFE7,128,9954,1,69620,34380,35497
11515142,11515129,TXFE7,128,9954,1,69621,34381,35498
11515154,11515151,TXFE7,128,9954,1,69622,34382,35499
11515179,11515169,TXFE7,128,9954,1,69623,34383,35500
11515192,11515180,TXFE7,128,9954,2,69625,34385,35501
11515192,11515187,TXFE7,128,9954,1,69626,34386,35502
11515204,11515201,TXFE7,128,9954,1,69627,34387,35503
11515217,11515205,TXFE7,128,9954,1,69628,34388,35504
11515229,11515219,TXFE7,128,9954,1,69629,34389,35505
11515242,11515234,TXFE7,128,9954,2,69631,34391,35506
11515254,11515244,TXFE7,128,9955,3,69634,34392,35507
11515254,11515248,TXFE7,128,9954,2,69636,34394,35508
11515267,11515266,TXFE7,128,9954,2,69638,34395,35509
11515292,11515279,TXFE7,128,9954,2,69640,34396,35510
11515304,11515297,TXFE7,128,9954,2,69642,34398,35511
11515317,11515309,TXFE7,128,9954,2,69644,34400,35512
11515329,11515325,TXFE7,128,9954,2,69646,34401,35513
11515329,11515327,TXFE7,128,9954,2,69648,34403,35514
11515354,11515344,TXFE7,128,9954,2,69650,34405,35515
11515367,11515363,TXFE7,128,9954,2,69652,34406,35516
11515404,11515395,TXFE7,128,9954,2,69654,34407,35517
11515429,11515422,TXFE7,128,9954,2,69656,34409,35518
11515442,11515442,TXFE7,128,9954,2,69658,34411,35519
11515467,11515459,TXFE7,128,9954,2,69660,34412,35520
11515479,11515473,TXFE7,128,9954,2,69662,34413,35521
11515567,11515565,TXFE7,128,9954,10,69672,34420,35522
11515592,11515582,TXFE7,128,9954,10,69682,34426,35523
11515592,11515591,TXFE7,128,9955,1,69683,34427,35524
11515629,11515621,TXFE7,128,9954,10,69693,34432,35525
11515667,11515666,TXFE7,128,9954,7,69700,34434,35526
11515679,11515668,TXFE7,128,9954,3,69703,34435,35527
11515692,11515684,TXFE7,128,9954,1,69704,34436,35528
11515717,11515705,TXFE7,128,9954,1,69705,34437,35529
11515729,11515717,TXFE7,128,9954,1,69706,34438,35530
11515729,11515723,TXFE7,128,9954,1,69707,34439,35531
11515804,11515798,TXFE7,128,9953,10,69717,34444,35532
11515817,11515807,TXFE7,128,9953,10,69727,34452,35533
11515817,11515807,TXFE7,128,9954,3,69730,34453,35535
11515817,11515808,TXFE7,128,9953,3,69733,34456,35536
11515829,11515818,TXFE7,128,9953,1,69734,34457,35537
11515842,11515840,TXFE7,128,9953,1,69735,34458,35538
11515867,11515862,TXFE7,128,9953,1,69736,34459,35539
11515892,11515886,TXFE7,128,9953,1,69737,34460,35540
11515917,11515912,TXFE7,128,9954,2,69739,34461,35541
11515929,11515918,TXFE7,128,9954,1,69740,34462,35542
11515929,11515923,TXFE7,128,9953,1,69741,34463,35543
11515954,11515951,TXFE7,128,9953,2,69743,34464,35544
11515967,11515959,TXFE7,128,9953,1,69744,34465,35545
11515992,11515990,TXFE7,128,9953,1,69745,34466,35546
11520029,11520021,TXFE7,128,9953,1,69746,34467,35547
11520042,11520041,TXFE7,128,9953,1,69747,34468,35548
11520067,11520064,TXFE7,128,9953,1,69748,34469,35549
11520079,11520067,TXFE7,128,9953,1,69749,34470,35550
11520079,11520072,TXFE7,128,9953,1,69750,34471,35551
11520092,11520081,TXFE7,128,9953,1,69751,34472,35552
11520117,11520107,TXFE7,128,9953,2,69753,34474,35553
11520129,11520119,TXFE7,128,9953,1,69754,34475,35554
11520142,11520133,TXFE7,128,9953,1,69755,34476,35555
11520154,11520146,TXFE7,128,9954,1,69756,34477,35556
11520167,11520154,TXFE7,128,9953,1,69757,34478,35557
11520167,11520166,TXFE7,128,9954,7,69764,34479,35559
11520204,11520192,TXFE7,128,9953,1,69765,34480,35560
11520229,11520222,TXFE7,128,9953,1,69766,34481,35561
11520254,11520253,TXFE7,128,9953,1,69767,34482,35562
11520292,11520288,TXFE7,128,9953,1,69768,34483,35563
11520317,11520316,TXFE7,128,9953,1,69769,34484,35564
11520354,11520354,TXFE7,128,9953,1,69770,34485,35565
11520367,11520362,TXFE7,128,9953,1,69771,34486,35566
11520404,11520400,TXFE7,128,9953,1,69772,34487,35567
11520429,11520425,TXFE7,128,9953,2,69774,34488,35568
11520442,11520430,TXFE7,128,9953,1,69775,34489,35569
11520442,11520440,TXFE7,128,9953,1,69776,34490,35570
11520479,11520479,TXFE7,128,9953,1,69777,34491,35571
11520554,11520544,TXFE7,128,9953,1,69778,34492,35572
11520592,11520592,TXFE7,128,9953,1,69779,34493,35573
11520642,11520632,TXFE7,128,9953,1,69780,34494,35574
11520667,11520665,TXFE7,128,9953,1,69781,34495,35575
11520754,11520742,TXFE7,128,9953,1,69782,34496,35576
11520779,11520770,TXFE7,128,9954,1,69783,34497,35577
11520779,11520772,TXFE7,128,9953,1,69784,34498,35578
11520792,11520781,TXFE7,128,9954,1,69785,34499,35579
11520829,11520828,TXFE7,128,9954,1,69786,34500,35580
11520842,11520832,TXFE7,128,9953,1,69787,34501,35581
11520867,11520859,TXFE7,128,9953,9,69796,34506,35582
11521042,11521039,TXFE7,128,9953,1,69797,34507,35583
11521067,11521061,TXFE7,128,9953,1,69798,34508,35584
11521104,11521099,TXFE7,128,9953,1,69799,34509,35585
11521129,11521125,TXFE7,128,9953,1,69800,34510,35586
11521129,11521129,TXFE7,128,9954,1,69801,34511,35587
11521192,11521188,TXFE7,128,9953,1,69802,34512,35588
11521292,11521286,TXFE7,128,9953,1,69803,34513,35589
11521354,11521351,TXFE7,128,9953,1,69804,34514,35590
11521392,11521385,TXFE7,128,9953,1,69805,34515,35591
11521417,11521410,TXFE7,128,9953,1,69806,34516,35592
11521417,11521415,TXFE7,128,9954,1,69807,34517,35593
11521417,11521416,TXFE7,128,9953,1,69808,34518,35594
11521442,11521434,TXFE7,128,9953,4,69812,34520,35595
11521467,11521459,TXFE7,128,9954,1,69813,34521,35596
11521479,11521472,TXFE7,128,9954,39,69852,34522,35620
11521504,11521494,TXFE7,128,9955,1,69853,34523,35621
11521517,11521505,TXFE7,128,9954,1,69854,34524,35622
11521517,11521506,TXFE7,128,9955,1,69855,34525,35623
11521667,11521664,TXFE7,128,9955,17,69872,34526,35634
11521679,11521672,TXFE7,128,9955,35,69907,34527,35637
11521679,11521672,TXFE7,128,9955,1,69908,34528,35638
11521679,11521673,TXFE7,128,9954,1,69909,34529,35639
11521692,11521679,TXFE7,128,9955,2,69911,34530,35640
11521692,11521679,TXFE7,128,9955,2,69913,34531,35641
11521692,11521679,TXFE7,128,9955,3,69916,34532,35642
11521692,11521679,TXFE7,128,9955,2,69918,34533,35643
11521692,11521679,TXFE7,128,9955,4,69922,34534,35644
11521692,11521679,TXFE7,128,9955,2,69924,34535,35645
11521692,11521679,TXFE7,128,9955,1,69925,34536,35646
11521692,11521679,TXFE7,128,9955,6,69931,34537,35648
11521717,11521704,TXFE7,128,9956,1,69932,34538,35649
11521729,11521720,TXFE7,128,9956,1,69933,34539,35650
11521754,11521754,TXFE7,128,9955,2,69935,34541,35651
11521779,11521768,TXFE7,128,9955,2,69937,34542,35652
11521779,11521775,TXFE7,128,9956,1,69938,34543,35653
11521792,11521790,TXFE7,128,9955,1,69939,34544,35654
11521892,11521881,TXFE7,128,9955,1,69940,34545,35655
11521892,11521889,TXFE7,128,9956,1,69941,34546,35656
11521917,11521913,TXFE7,128,9955,1,69942,34547,35657
11521967,11521959,TXFE7,128,9955,4,69946,34548,35658
11522192,11522184,TXFE7,128,9955,1,69947,34549,35659
11522229,11522221,TXFE7,128,9956,10,69957,34550,35666
11522279,11522272,TXFE7,128,9955,1,69958,34551,35667
11522367,11522364,TXFE7,128,9956,1,69959,34552,35668
11523092,11523086,TXFE7,128,9956,3,69962,34553,35671
11523317,11523306,TXFE7,128,9956,1,69963,34554,35672
11523367,11523366,TXFE7,128,9956,6,69969,34555,35677
11523417,11523410,TXFE7,128,9956,5,69974,34556,35678
11523479,11523470,TXFE7,128,9956,1,69975,34557,35679
11523517,11523509,TXFE7,128,9956,2,69977,34558,35680
11523592,11523580,TXFE7,128,9956,3,69980,34559,35682
11523617,11523604,TXFE7,128,9956,4,69984,34560,35683
11523629,11523618,TXFE7,128,9956,2,69986,34561,35684
11523679,11523676,TXFE7,128,9956,5,69991,34562,35686
11523692,11523680,TXFE7,128,9956,1,69992,34563,35687
11523742,11523730,TXFE7,128,9956,1,69993,34564,35688
11523754,11523746,TXFE7,128,9955,1,69994,34565,35689
11523754,11523750,TXFE7,128,9956,1,69995,34566,35690
11524067,11524058,TXFE7,128,9955,1,69996,34567,35691
11524117,11524107,TXFE7,128,9955,5,70001,34568,35692
11524179,11524167,TXFE7,128,9956,1,70002,34569,35693
11524217,11524211,TXFE7,128,9956,1,70003,34570,35694
11524504,11524499,TXFE7,128,9956,1,70004,34571,35695
11524567,11524565,TXFE7,128,9956,10,70014,34572,35697
11524579,11524567,TXFE7,128,9956,1,70015,34573,35698
11524642,11524640,TXFE7,128,9955,2,70017,34575,35699
11524654,11524649,TXFE7,128,9956,1,70018,34576,35700
11524667,11524656,TXFE7,128,9956,1,70019,34577,35701
11524704,11524693,TXFE7,128,9956,1,70020,34578,35702
11524854,11524842,TXFE7,128,9955,1,70021,34579,35703
11524904,11524896,TXFE7,128,9956,1,70022,34580,35704
11525067,11525060,TXFE7,128,9955,1,70023,34581,35705
11525579,11525574,TXFE7,128,9955,1,70024,34582,35706
11525592,11525582,TXFE7,128,9955,1,70025,34583,35707
11525917,11525917,TXFE7,128,9955,1,70026,34584,35708
11530092,11530083,TXFE7,128,9956,1,70027,34585,35709
11530692,11530680,TXFE7,128,9955,1,70028,34586,35710
11530842,11530834,TXFE7,128,9955,1,70029,34587,35711
11530842,11530837,TXFE7,128,9956,2,70031,34588,35712
11530942,11530939,TXFE7,128,9956,1,70032,34589,35713
11530954,11530944,TXFE7,128,9956,10,70042,34590,35716
11531267,11531259,TXFE7,128,9956,1,70043,34591,35717
11531417,11531408,TXFE7,128,9956,3,70046,34592,35720
11532104,11532098,TXFE7,128,9955,1,70047,34593,35721
11532129,11532117,TXFE7,128,9956,3,70050,34594,35722
11532142,11532136,TXFE7,128,9956,2,70052,34595,35723
11532242,11532236,TXFE7,128,9955,1,70053,34596,35724
11532517,11532508,TXFE7,128,9955,1,70054,34597,35725
11532554,11532548,TXFE7,128,9955,4,70058,34600,35726
11532579,11532571,TXFE7,128,9955,4,70062,34602,35727
11532942,11532941,TXFE7,128,9955,1,70063,34603,35728
11532967,11532966,TXFE7,128,9955,2,70065,34604,35729
11532992,11532991,TXFE7,128,9955,1,70066,34605,35730
11533142,11533138,TXFE7,128,9955,1,70067,34606,35731
11533404,11533398,TXFE7,128,9955,2,70069,34607,35732
11533417,11533410,TXFE7,128,9955,1,70070,34608,35733
11533629,11533617,TXFE7,128,9955,4,70074,34609,35734
11533717,11533704,TXFE7,128,9956,8,70082,34610,35735
11533767,11533755,TXFE7,128,9956,1,70083,34611,35736
11533792,11533780,TXFE7,128,9955,1,70084,34612,35737
11533954,11533953,TXFE7,128,9955,5,70089,34617,35738
11534192,11534190,TXFE7,128,9955,3,70092,34620,35739
11534304,11534304,TXFE7,128,9955,14,70106,34623,35740
11534404,11534394,TXFE7,128,9955,1,70107,34624,35741
11534479,11534479,TXFE7,128,9955,10,70117,34625,35742
11534717,11534712,TXFE7,128,9955,2,70119,34626,35743
11535117,11535111,TXFE7,128,9954,1,70120,34627,35744
11535929,11535925,TXFE7,128,9955,1,70121,34628,35745
11540479,11540472,TXFE7,128,9954,2,70123,34630,35746
11540504,11540498,TXFE7,128,9955,1,70124,34631,35747
11540542,11540536,TXFE7,128,9954,1,70125,34632,35748
11540592,11540589,TXFE7,128,9954,3,70128,34635,35749
11540817,11540813,TXFE7,128,9954,2,70130,34637,35750
11540979,11540978,TXFE7,128,9954,1,70131,34638,35751
11541054,11541050,TXFE7,128,9954,1,70132,34639,35752
11541092,11541090,TXFE7,128,9954,5,70137,34644,35753
11541142,11541134,TXFE7,128,9955,1,70138,34645,35754
11541579,11541575,TXFE7,128,9954,5,70143,34649,35755
11542017,11542007,TXFE7,128,9955,1,70144,34650,35756
11542429,11542419,TXFE7,128,9955,3,70147,34651,35757
11543129,11543118,TXFE7,128,9955,1,70148,34652,35758
11544092,11544081,TXFE7,128,9954,6,70154,34653,35759
11544154,11544146,TXFE7,128,9954,5,70159,34656,35760
11544229,11544217,TXFE7,128,9954,5,70164,34661,35761
11544354,11544353,TXFE7,128,9954,3,70167,34663,35762
11544479,11544470,TXFE7,128,9954,1,70168,34664,35763
11544567,11544562,TXFE7,128,9954,1,70169,34665,35764
11544729,11544723,TXFE7,128,9954,1,70170,34666,35765
11544767,11544764,TXFE7,128,9954,2,70172,34667,35766
11544792,11544788,TXFE7,128,9954,10,70182,34669,35767
11544804,11544792,TXFE7,128,9954,1,70183,34670,35768
11544804,11544803,TXFE7,128,9954,3,70186,34673,35769
11544842,11544830,TXFE7,128,9954,3,70189,34674,35770
11544917,11544905,TXFE7,128,9953,2,70191,34675,35771
11545254,11545254,TXFE7,128,9954,1,70192,34676,35772
11545629,11545618,TXFE7,128,9953,2,70194,34678,35773
11545717,11545712,TXFE7,128,9954,1,70195,34679,35774
11545904,11545901,TXFE7,128,9953,1,70196,34680,35775
11545967,11545967,TXFE7,128,9954,1,70197,34681,35776
11550029,11550025,TXFE7,128,9954,1,70198,34682,35777
11550067,11550056,TXFE7,128,9953,2,70200,34683,35778
11550129,11550120,TXFE7,128,9953,1,70201,34684,35779
11550192,11550184,TXFE7,128,9953,1,70202,34685,35780
11550404,11550401,TXFE7,128,9953,1,70203,34686,35781
11550467,11550455,TXFE7,128,9953,1,70204,34687,35782
11551029,11551020,TXFE7,128,9954,1,70205,34688,35783
11551179,11551178,TXFE7,128,9954,1,70206,34689,35784
11551192,11551187,TXFE7,128,9954,1,70207,34690,35785
11551404,11551404,TXFE7,128,9953,1,70208,34691,35786
11551417,11551406,TXFE7,128,9954,1,70209,34692,35787
11551629,11551626,TXFE7,128,9954,33,70242,34693,35797
11551642,11551629,TXFE7,128,9954,6,70248,34694,35798
11551642,11551629,TXFE7,128,9954,1,70249,34695,35799
11551642,11551629,TXFE7,128,9954,2,70251,34696,35800
11551642,11551629,TXFE7,128,9954,4,70255,34697,35802
11551642,11551631,TXFE7,128,9954,2,70257,34698,35804
11551642,11551634,TXFE7,128,9954,1,70258,34699,35805
11551642,11551634,TXFE7,128,9954,1,70259,34700,35806
11551642,11551634,TXFE7,128,9954,1,70260,34701,35807
11551654,11551642,TXFE7,128,9954,4,70264,34702,35808
11551654,11551642,TXFE7,128,9954,2,70266,34703,35809
11551654,11551642,TXFE7,128,9954,2,70268,34704,35810
11551654,11551642,TXFE7,128,9954,1,70269,34705,35811
11551654,11551642,TXFE7,128,9954,1,70270,34706,35812
11551654,11551642,TXFE7,128,9954,8,70278,34707,35817
11551654,11551642,TXFE7,128,9954,3,70281,34708,35819
11551654,11551642,TXFE7,128,9954,2,70283,34709,35821
11551792,11551788,TXFE7,128,9954,1,70284,34710,35822
11552167,11552157,TXFE7,128,9954,2,70286,34711,35823
11552192,11552183,TXFE7,128,9955,1,70287,34712,35824
11552204,11552196,TXFE7,128,9955,2,70289,34713,35826
11552379,11552370,TXFE7,128,9955,5,70294,34714,35828
11552429,11552417,TXFE7,128,9954,2,70296,34715,35829
11552429,11552424,TXFE7,128,9955,5,70301,34716,35833
11552492,11552481,TXFE7,128,9955,1,70302,34717,35834
11552517,11552512,TXFE7,128,9955,3,70305,34718,35837
11552529,11552517,TXFE7,128,9955,2,70307,34719,35839
11552617,11552617,TXFE7,128,9955,1,70308,34720,35840
11552629,11552623,TXFE7,128,9955,1,70309,34721,35841
11552779,11552778,TXFE7,128,9955,1,70310,34722,35842
11552804,11552802,TXFE7,128,9955,1,70311,34723,35843
11552929,11552917,TXFE7,128,9955,1,70312,34724,35844
11553104,11553099,TXFE7,128,9954,1,70313,34725,35845
11553217,11553205,TXFE7,128,9955,1,70314,34726,35846
11553217,11553213,TXFE7,128,9955,1,70315,34727,35847
11553342,11553340,TXFE7,128,9955,1,70316,34728,35848
11553467,11553463,TXFE7,128,9955,1,70317,34729,35849
11553592,11553590,TXFE7,128,9955,1,70318,34730,35850
11553642,11553633,TXFE7,128,9955,1,70319,34731,35851
11553642,11553633,TXFE7,128,9955,2,70321,34732,35852
11553654,11553652,TXFE7,128,9955,1,70322,34733,35853
11553667,11553655,TXFE7,128,9955,4,70326,34734,35856
11553667,11553665,TXFE7,128,9955,1,70327,34735,35857
11553679,11553667,TXFE7,128,9955,8,70335,34736,35859
11553679,11553667,TXFE7,128,9955,2,70337,34737,35861
11553767,11553755,TXFE7,128,9956,1,70338,34738,35862
11553792,11553783,TXFE7,128,9956,4,70342,34739,35863
11553904,11553902,TXFE7,128,9955,1,70343,34740,35864
11554267,11554255,TXFE7,128,9955,1,70344,34741,35865
11554892,11554887,TXFE7,128,9956,1,70345,34742,35866
11554967,11554965,TXFE7,128,9956,1,70346,34743,35867
11555017,11555008,TXFE7,128,9955,1,70347,34744,35868
11560142,11560141,TXFE7,128,9955,2,70349,34745,35869
11560529,11560521,TXFE7,128,9956,1,70350,34746,35870
11560579,11560572,TXFE7,128,9956,1,70351,34747,35871
11560579,11560573,TXFE7,128,9956,1,70352,34748,35872
11560579,11560575,TXFE7,128,9956,1,70353,34749,35873
11560592,11560581,TXFE7,128,9956,3,70356,34750,35874
11560792,11560789,TXFE7,128,9956,1,70357,34751,35875
11561217,11561214,TXFE7,128,9955,1,70358,34752,35876
11562542,11562530,TXFE7,128,9955,1,70359,34753,35877
11562717,11562712,TXFE7,128,9955,1,70360,34754,35878
11562954,11562950,TXFE7,128,9956,1,70361,34755,35879
11562967,11562964,TXFE7,128,9955,1,70362,34756,35880
11563117,11563104,TXFE7,128,9955,4,70366,34759,35881
11563542,11563535,TXFE7,128,9956,1,70367,34760,35882
11563679,11563679,TXFE7,128,9955,1,70368,34761,35883
11563854,11563848,TXFE7,128,9955,1,70369,34762,35884
11563917,11563910,TXFE7,128,9955,1,70370,34763,35885
11564079,11564072,TXFE7,128,9955,1,70371,34764,35886
11564117,11564114,TXFE7,128,9955,3,70374,34767,35887
11564379,11564371,TXFE7,128,9956,1,70375,34768,35888
11564617,11564611,TXFE7,128,9955,2,70377,34770,35889
11565067,11565057,TXFE7,128,9955,1,70378,34771,35890
11565179,11565173,TXFE7,128,9955,2,70380,34773,35891
11565729,11565728,TXFE7,128,9955,1,70381,34774,35892
11565842,11565833,TXFE7,128,9955,1,70382,34775,35893
11570067,11570059,TXFE7,128,9955,1,70383,34776,35894
11570117,11570109,TXFE7,128,9955,3,70386,34779,35895
11570192,11570187,TXFE7,128,9955,1,70387,34780,35896
11570229,11570218,TXFE7,128,9955,1,70388,34781,35897
11570754,11570754,TXFE7,128,9956,2,70390,34782,35898
11570804,11570802,TXFE7,128,9955,1,70391,34783,35899
11570829,11570824,TXFE7,128,9955,1,70392,34784,35900
11570842,11570840,TXFE7,128,9955,1,70393,34785,35901
11570867,11570864,TXFE7,128,9955,1,70394,34786,35902
11570892,11570885,TXFE7,128,9955,1,70395,34787,35903
11570904,11570901,TXFE7,128,9955,1,70396,34788,35904
11571004,11570994,TXFE7,128,9955,1,70397,34789,35905
11571017,11571014,TXFE7,128,9955,1,70398,34790,35906
11571017,11571017,TXFE7,128,9955,1,70399,34791,35907
11571042,11571037,TXFE7,128,9955,1,70400,34792,35908
11571079,11571073,TXFE7,128,9955,1,70401,34793,35909
11571104,11571098,TXFE7,128,9955,1,70402,34794,35910
11571179,11571169,TXFE7,128,9955,10,70412,34803,35911
11571192,11571192,TXFE7,128,9955,4,70416,34807,35912
11571204,11571192,TXFE7,128,9955,6,70422,34808,35913
11571217,11571213,TXFE7,128,9955,4,70426,34810,35914
11571229,11571218,TXFE7,128,9954,1,70427,34811,35915
11571229,11571218,TXFE7,128,9955,1,70428,34812,35916
11571242,11571233,TXFE7,128,9954,1,70429,34813,35917
11571279,11571277,TXFE7,128,9955,1,70430,34814,35918
11571354,11571346,TXFE7,128,9955,1,70431,34815,35919
11571417,11571415,TXFE7,128,9954,1,70432,34816,35920
11571442,11571440,TXFE7,128,9954,1,70433,34817,35921
11571517,11571507,TXFE7,128,9955,1,70434,34818,35922
11571517,11571515,TXFE7,128,9954,1,70435,34819,35923
11571579,11571569,TXFE7,128,9954,1,70436,34820,35924
11571617,11571614,TXFE7,128,9954,1,70437,34821,35925
11571667,11571659,TXFE7,128,9954,1,70438,34822,35926
11571742,11571735,TXFE7,128,9954,1,70439,34823,35927
11571829,11571826,TXFE7,128,9954,1,70440,34824,35928
11571954,11571949,TXFE7,128,9954,1,70441,34825,35929
11572004,11571993,TXFE7,128,9955,3,70444,34826,35931
11572017,11572010,TXFE7,128,9954,3,70447,34827,35932
11572054,11572047,TXFE7,128,9954,1,70448,34828,35933
11572129,11572119,TXFE7,128,9955,1,70449,34829,35934
11572167,11572155,TXFE7,128,9955,1,70450,34830,35935
11572179,11572178,TXFE7,128,9954,1,70451,34831,35936
11572304,11572298,TXFE7,128,9954,1,70452,34832,35937
11572417,11572411,TXFE7,128,9954,1,70453,34833,35938
11572567,11572558,TXFE7,128,9955,1,70454,34834,35939
11572592,11572583,TXFE7,128,9954,2,70456,34835,35940
11572629,11572617,TXFE7,128,9954,1,70457,34836,35941
11572717,11572712,TXFE7,128,9955,1,70458,34837,35942
11572729,11572717,TXFE7,128,9954,1,70459,34838,35943
11572804,11572798,TXFE7,128,9954,1,70460,34839,35944
11572879,11572876,TXFE7,128,9954,1,70461,34840,35945
11572929,11572924,TXFE7,128,9955,1,70462,34841,35946
11573054,11573048,TXFE7,128,9955,1,70463,34842,35947
11573154,11573147,TXFE7,128,9954,1,70464,34843,35948
11573179,11573167,TXFE7,128,9955,1,70465,34844,35949
11573179,11573167,TXFE7,128,9955,1,70466,34845,35950
11573229,11573222,TXFE7,128,9955,1,70467,34846,35951
11573242,11573233,TXFE7,128,9955,2,70469,34847,35953
11573304,11573294,TXFE7,128,9955,1,70470,34848,35954
11573304,11573294,TXFE7,128,9955,2,70472,34849,35955
11573342,11573337,TXFE7,128,9955,1,70473,34850,35956
11573542,11573534,TXFE7,128,9954,1,70474,34851,35957
11573817,11573811,TXFE7,128,9955,2,70476,34852,35958
11573967,11573966,TXFE7,128,9954,1,70477,34853,35959
11574029,11574029,TXFE7,128,9955,2,70479,34854,35960
11574192,11574185,TXFE7,128,9955,1,70480,34855,35961
11574254,11574252,TXFE7,128,9955,2,70482,34856,35962
11574367,11574356,TXFE7,128,9955,1,70483,34857,35963
11574467,11574457,TXFE7,128,9955,4,70487,34858,35966
11574479,11574467,TXFE7,128,9955,9,70496,34859,35975
11574942,11574936,TXFE7,128,9955,1,70497,34860,35976
11575604,11575595,TXFE7,128,9955,1,70498,34861,35977
11575767,11575756,TXFE7,128,9955,1,70499,34862,35978
11575767,11575759,TXFE7,128,9955,1,70500,34863,35979
11575767,11575759,TXFE7,128,9955,1,70501,34864,35980
11575767,11575759,TXFE7,128,9955,1,70502,34865,35981
11575767,11575759,TXFE7,128,9955,1,70503,34866,35982
11575767,11575760,TXFE7,128,9955,1,70504,34867,35983
11575767,11575760,TXFE7,128,9955,1,70505,34868,35984
11575767,11575764,TXFE7,128,9955,1,70506,34869,35985
11575792,11575788,TXFE7,128,9956,1,70507,34870,35986
11575804,11575797,TXFE7,128,9955,1,70508,34871,35987
11575829,11575825,TXFE7,128,9955,4,70512,34874,35988
11580004,11575996,TXFE7,128,9955,1,70513,34875,35989
11580092,11580087,TXFE7,128,9956,1,70514,34876,35990
11581592,11581590,TXFE7,128,9955,1,70515,34877,35991
11581692,11581680,TXFE7,128,9956,2,70517,34878,35992
11581817,11581807,TXFE7,128,9956,1,70518,34879,35993
11582417,11582407,TXFE7,128,9955,1,70519,34880,35994
11582567,11582557,TXFE7,128,9956,2,70521,34881,35996
11582654,11582653,TXFE7,128,9956,10,70531,34882,36005
11582792,11582782,TXFE7,128,9956,2,70533,34883,36006
11583529,11583525,TXFE7,128,9956,57,70590,34884,36045
11583542,11583535,TXFE7,128,9956,1,70591,34885,36046
11583917,11583912,TXFE7,128,9956,3,70594,34886,36047
11584004,11583999,TXFE7,128,9956,2,70596,34887,36048
11584092,11584091,TXFE7,128,9956,2,70598,34888,36049
11584129,11584128,TXFE7,128,9956,1,70599,34889,36050
11584142,11584131,TXFE7,128,9956,1,70600,34890,36051
11584154,11584142,TXFE7,128,9956,3,70603,34891,36054
11584292,11584284,TXFE7,128,9956,1,70604,34892,36055
11584467,11584456,TXFE7,128,9956,1,70605,34893,36056
11584592,11584579,TXFE7,128,9956,2,70607,34895,36057
11584704,11584699,TXFE7,128,9956,1,70608,34896,36058
11584717,11584709,TXFE7,128,9956,2,70610,34897,36059
11584742,11584737,TXFE7,128,9955,1,70611,34898,36060
11584854,11584844,TXFE7,128,9956,2,70613,34899,36061
11585029,11585021,TXFE7,128,9956,1,70614,34900,36062
11585042,11585037,TXFE7,128,9955,3,70617,34901,36063
11585054,11585051,TXFE7,128,9956,1,70618,34902,36064
11585342,11585340,TXFE7,128,9956,1,70619,34903,36065
11585692,11585687,TXFE7,128,9955,1,70620,34904,36066
11585742,11585741,TXFE7,128,9955,1,70621,34905,36067
11585804,11585793,TXFE7,128,9955,1,70622,34906,36068
11585817,11585814,TXFE7,128,9955,1,70623,34907,36069
11585879,11585868,TXFE7,128,9955,1,70624,34908,36070
11585917,11585913,TXFE7,128,9955,1,70625,34909,36071
11585942,11585938,TXFE7,128,9955,1,70626,34910,36072
11585942,11585940,TXFE7,128,9955,1,70627,34911,36073
11585979,11585970,TXFE7,128,9955,1,70628,34912,36074
11590004,11585993,TXFE7,128,9955,1,70629,34913,36075
11590029,11590024,TXFE7,128,9955,1,70630,34914,36076
11590042,11590040,TXFE7,128,9955,1,70631,34915,36077
11590054,11590043,TXFE7,128,9956,1,70632,34916,36078
11590067,11590055,TXFE7,128,9955,1,70633,34917,36079
11590092,11590092,TXFE7,128,9955,1,70634,34918,36080
11590554,11590552,TXFE7,128,9956,1,70635,34919,36081
11590592,11590580,TXFE7,128,9956,2,70637,34920,36082
11591054,11591047,TXFE7,128,9956,6,70643,34921,36086
11591167,11591157,TXFE7,128,9956,1,70644,34922,36087
11591304,11591297,TXFE7,128,9956,1,70645,34923,36088
11591329,11591327,TXFE7,128,9956,1,70646,34924,36089
11591629,11591625,TXFE7,128,9956,1,70647,34925,36090
11591679,11591671,TXFE7,128,9955,1,70648,34926,36091
11591704,11591697,TXFE7,128,9956,1,70649,34927,36092
11591729,11591721,TXFE7,128,9956,1,70650,34928,36093
11591754,11591748,TXFE7,128,9956,1,70651,34929,36094
11591767,11591765,TXFE7,128,9956,1,70652,34930,36095
11591879,11591876,TXFE7,128,9956,1,70653,34931,36096
11592054,11592051,TXFE7,128,9956,3,70656,34932,36099
11592129,11592121,TXFE7,128,9956,1,70657,34933,36100
11592479,11592477,TXFE7,128,9956,2,70659,34934,36101
11592642,11592633,TXFE7,128,9955,1,70660,34935,36102
11592879,11592876,TXFE7,128,9956,2,70662,34936,36104
11593004,11592998,TXFE7,128,9956,1,70663,34937,36105
11594129,11594117,TXFE7,128,9956,1,70664,34938,36106
11595304,11595297,TXFE7,128,9956,1,70665,34939,36107
11595517,11595513,TXFE7,128,9956,1,70666,34940,36108
11595692,11595683,TXFE7,128,9956,1,70667,34941,36109
11595742,11595738,TXFE7,128,9956,1,70668,34942,36110
11595767,11595764,TXFE7,128,9956,1,70669,34943,36111
11595904,11595903,TXFE7,128,9956,1,70670,34944,36112
12000029,12000022,TXFE7,128,9956,18,70688,34945,36125
12000067,12000067,TXFE7,128,9956,4,70692,34946,36126
12000079,12000075,TXFE7,128,9956,4,70696,34947,36127
12000104,12000099,TXFE7,128,9957,1,70697,34948,36128
12000117,12000105,TXFE7,128,9957,1,70698,34949,36129
12000129,12000128,TXFE7,128,9957,2,70700,34950,36130
12000142,12000133,TXFE7,128,9957,6,70706,34951,36136
12000204,12000193,TXFE7,128,9956,4,70710,34952,36137
12000204,12000198,TXFE7,128,9957,1,70711,34953,36138
12000204,12000199,TXFE7,128,9957,1,70712,34954,36139
12000317,12000312,TXFE7,128,9956,2,70714,34955,36140
12000467,12000460,TXFE7,128,9957,7,70721,34956,36145
12000504,12000494,TXFE7,128,9957,2,70723,34957,36147
12000617,12000612,TXFE7,128,9957,10,70733,34958,36151
12000704,12000700,TXFE7,128,9956,1,70734,34959,36152
12000779,12000773,TXFE7,128,9956,3,70737,34961,36153
12000892,12000890,TXFE7,128,9957,1,70738,34962,36154
12000992,12000987,TXFE7,128,9956,3,70741,34965,36155
12001042,12001035,TXFE7,128,9956,1,70742,34966,36156
12001042,12001039,TXFE7,128,9956,2,70744,34967,36157
12001217,12001209,TXFE7,128,9956,1,70745,34968,36158
12001242,12001231,TXFE7,128,9956,1,70746,34969,36159
12001654,12001650,TXFE7,128,9956,1,70747,34970,36160
12001904,12001898,TXFE7,128,9956,1,70748,34971,36161
12002104,12002094,TXFE7,128,9956,2,70750,34972,36162
12002129,12002129,TXFE7,128,9956,1,70751,34973,36163
12002229,12002226,TXFE7,128,9956,1,70752,34974,36164
12002917,12002908,TXFE7,128,9955,3,70755,34977,36165
12002979,12002974,TXFE7,128,9956,2,70757,34978,36167
12003104,12003096,TXFE7,128,9955,1,70758,34979,36168
12003117,12003115,TXFE7,128,9956,1,70759,34980,36169
12004367,12004366,TXFE7,128,9956,1,70760,34981,36170
12004579,12004579,TXFE7,128,9955,1,70761,34982,36171
12004979,12004969,TXFE7,128,9955,1,70762,34983,36172
12005492,12005489,TXFE7,128,9956,15,70777,34984,36183
12005504,12005498,TXFE7,128,9955,5,70782,34986,36184
12005804,12005795,TXFE7,128,9955,1,70783,34987,36185
12005804,12005798,TXFE7,128,9955,1,70784,34988,36186
12010004,12005998,TXFE7,128,9956,2,70786,34989,36188
12010154,12010151,TXFE7,128,9956,1,70787,34990,36189
12010179,12010169,TXFE7,128,9956,3,70790,34991,36192
12010367,12010358,TXFE7,128,9956,5,70795,34992,36194
12010492,12010491,TXFE7,128,9955,1,70796,34993,36195
12010504,12010500,TXFE7,128,9956,5,70801,34994,36198
12010579,12010576,TXFE7,128,9956,2,70803,34995,36199
12010704,12010698,TXFE7,128,9956,1,70804,34996,36200
12010704,12010698,TXFE7,128,9956,4,70808,34997,36202
12010729,12010722,TXFE7,128,9956,2,70810,34998,36203
12010742,12010738,TXFE7,128,9956,2,70812,34999,36204
12010779,12010775,TXFE7,129,9956,1,70815,35000,36207
12010779,12010775,TXFE7,129,9957,2,70815,35000,36207
12010867,12010856,TXFE7,128,9956,1,70816,35001,36208
12011329,12011317,TXFE7,128,9956,1,70817,35002,36209
12011542,12011535,TXFE7,128,9956,3,70820,35003,36210
12012017,12012009,TXFE7,128,9956,1,70821,35004,36211
12012217,12012208,TXFE7,128,9956,1,70822,35005,36212
12012329,12012326,TXFE7,128,9956,1,70823,35006,36213
12012542,12012538,TXFE7,128,9956,1,70824,35007,36214
12012554,12012552,TXFE7,128,9956,1,70825,35008,36215
12012579,12012575,TXFE7,128,9956,1,70826,35009,36216
12012979,12012972,TXFE7,128,9955,1,70827,35010,36217
12013029,12013019,TXFE7,128,9956,1,70828,35011,36218
12013704,12013697,TXFE7,128,9955,1,70829,35012,36219
12013892,12013884,TXFE7,128,9955,1,70830,35013,36220
12013929,12013920,TXFE7,128,9956,3,70833,35014,36221
12014079,12014068,TXFE7,128,9955,1,70834,35015,36222
12014117,12014104,TXFE7,128,9956,1,70835,35016,36223
12014479,12014476,TXFE7,128,9956,1,70836,35017,36224
12015267,12015265,TXFE7,128,9955,1,70837,35018,36225
12015454,12015449,TXFE7,128,9955,1,70838,35019,36226
12015504,12015495,TXFE7,128,9956,1,70839,35020,36227
12015967,12015960,TXFE7,128,9955,4,70843,35021,36228
12020417,12020413,TXFE7,128,9955,1,70844,35022,36229
12020554,12020554,TXFE7,128,9955,1,70845,35023,36230
12020854,12020851,TXFE7,128,9955,1,70846,35024,36231
12022054,12022044,TXFE7,128,9956,3,70849,35025,36232
12022154,12022142,TXFE7,128,9955,57,70906,35056,36233
12022167,12022154,TXFE7,128,9955,3,70909,35057,36234
12022167,12022154,TXFE7,128,9955,1,70910,35058,36235
12022167,12022154,TXFE7,128,9955,1,70911,35059,36236
12022167,12022154,TXFE7,128,9955,7,70918,35065,36237
12022167,12022154,TXFE7,128,9955,11,70929,35074,36238
12022267,12022255,TXFE7,128,9954,1,70930,35075,36239
12022267,12022261,TXFE7,128,9954,1,70931,35076,36240
12022629,12022625,TXFE7,128,9955,1,70932,35077,36241
12022842,12022832,TXFE7,128,9955,1,70933,35078,36242
12023104,12023101,TXFE7,128,9955,2,70935,35079,36243
12023192,12023184,TXFE7,128,9955,1,70936,35080,36244
12023267,12023262,TXFE7,128,9955,1,70937,35081,36245
12023429,12023423,TXFE7,128,9954,2,70939,35082,36246
12023729,12023720,TXFE7,128,9954,1,70940,35083,36247
12023942,12023937,TXFE7,128,9954,1,70941,35084,36248
12023954,12023944,TXFE7,128,9954,1,70942,35085,36249
12024242,12024232,TXFE7,128,9954,2,70944,35086,36250
12024442,12024441,TXFE7,128,9954,1,70945,35087,36251
12024567,12024563,TXFE7,128,9955,1,70946,35088,36252
12025104,12025095,TXFE7,128,9955,16,70962,35089,36262
12025254,12025250,TXFE7,128,9954,5,70967,35090,36263
12025292,12025280,TXFE7,128,9954,36,71003,35103,36264
12025304,12025292,TXFE7,128,9954,4,71007,35107,36265
12025304,12025296,TXFE7,128,9954,2,71009,35109,36266
12025304,12025296,TXFE7,128,9954,2,71011,35110,36267
12025304,12025296,TXFE7,128,9954,5,71016,35111,36268
12025304,12025296,TXFE7,128,9954,10,71026,35115,36269
12025304,12025296,TXFE7,128,9954,11,71037,35121,36270
12025304,12025296,TXFE7,128,9954,1,71038,35122,36271
12025304,12025296,TXFE7,128,9954,7,71045,35124,36272
12025304,12025296,TXFE7,128,9954,2,71047,35125,36273
12025304,12025296,TXFE7,128,9954,10,71057,35130,36274
12025304,12025296,TXFE7,128,9954,1,71058,35131,36275
12025304,12025297,TXFE7,128,9954,6,71064,35135,36276
12025304,12025297,TXFE7,128,9954,1,71065,35136,36277
12025304,12025297,TXFE7,128,9954,4,71069,35139,36278
12025304,12025297,TXFE7,128,9954,1,71070,35140,36279
12025304,12025297,TXFE7,128,9954,2,71072,35142,36280
12025317,12025305,TXFE7,128,9953,2,71074,35144,36281
12025329,12025320,TXFE7,128,9953,1,71075,35145,36282
12025367,12025356,TXFE7,128,9954,4,71079,35146,36284
12025392,12025385,TXFE7,128,9954,5,71084,35147,36287
12025404,12025392,TXFE7,128,9954,3,71087,35148,36289
12025429,12025428,TXFE7,128,9955,1,71088,35149,36290
12025704,12025699,TXFE7,128,9954,1,71089,35150,36291
12025842,12025835,TXFE7,128,9955,5,71094,35151,36296
12025929,12025922,TXFE7,128,9955,5,71099,35152,36299
12025979,12025971,TXFE7,128,9954,1,71100,35153,36300
12030704,12030702,TXFE7,128,9954,1,71101,35154,36301
12030792,12030785,TXFE7,128,9954,1,71102,35155,36302
12031004,12031000,TXFE7,128,9954,5,71107,35156,36303
12031079,12031070,TXFE7,129,9954,9,71117,35166,36304
12031079,12031070,TXFE7,129,9953,1,71117,35166,36304
12031079,12031073,TXFE7,128,9953,10,71127,35174,36305
12031079,12031075,TXFE7,128,9953,10,71137,35181,36306
12031229,12031224,TXFE7,128,9954,2,71139,35182,36308
12031329,12031318,TXFE7,128,9954,2,71141,35183,36309
12031742,12031737,TXFE7,128,9954,1,71142,35184,36310
12031792,12031785,TXFE7,128,9954,1,71143,35185,36311
12031867,12031862,TXFE7,128,9954,1,71144,35186,36312
12031954,12031948,TXFE7,128,9954,2,71146,35187,36314
12032054,12032047,TXFE7,128,9954,1,71147,35188,36315
12032079,12032079,TXFE7,128,9953,4,71151,35190,36316
12032329,12032319,TXFE7,128,9954,1,71152,35191,36317
12032442,12032440,TXFE7,128,9954,2,71154,35192,36319
12032729,12032725,TXFE7,128,9953,1,71155,35193,36320
12033242,12033231,TXFE7,128,9953,1,71156,35194,36321
12033404,12033397,TXFE7,128,9954,2,71158,35195,36323
12033504,12033500,TXFE7,128,9954,1,71159,35196,36324
12033604,12033592,TXFE7,128,9954,2,71161,35197,36326
12033779,12033773,TXFE7,128,9953,1,71162,35198,36327
12034167,12034155,TXFE7,128,9954,2,71164,35199,36328
12034342,12034335,TXFE7,128,9954,1,71165,35200,36329
12034654,12034645,TXFE7,128,9953,5,71170,35204,36330
12035154,12035151,TXFE7,128,9954,9,71179,35205,36333
12035167,12035154,TXFE7,128,9954,6,71185,35206,36338
12035167,12035159,TXFE7,128,9954,1,71186,35207,36339
12035179,12035167,TXFE7,128,9954,1,71187,35208,36340
12035179,12035167,TXFE7,128,9954,1,71188,35209,36341
12035179,12035167,TXFE7,128,9954,3,71191,35210,36343
12035179,12035171,TXFE7,128,9954,1,71192,35211,36344
12035179,12035171,TXFE7,128,9954,1,71193,35212,36345
12035192,12035179,TXFE7,128,9954,1,71194,35213,36346
12035192,12035179,TXFE7,128,9954,1,71195,35214,36347
12035204,12035192,TXFE7,128,9954,1,71196,35215,36348
12035204,12035198,TXFE7,128,9954,1,71197,35216,36349
12035279,12035273,TXFE7,128,9954,1,71198,35217,36350
12035379,12035369,TXFE7,128,9954,1,71199,35218,36351
12035454,12035444,TXFE7,128,9954,1,71200,35219,36352
12035492,12035479,TXFE7,128,9954,1,71201,35220,36353
12035617,12035616,TXFE7,128,9954,2,71203,35221,36354
12035629,12035619,TXFE7,128,9954,1,71204,35222,36355
12035654,12035652,TXFE7,128,9955,1,71205,35223,36356
12035692,12035690,TXFE7,128,9955,1,71206,35224,36357
12035792,12035781,TXFE7,128,9954,1,71207,35225,36358
12040004,12035999,TXFE7,128,9955,5,71212,35226,36362
12040317,12040306,TXFE7,128,9954,5,71217,35227,36363
12040317,12040309,TXFE7,128,9955,1,71218,35228,36364
12040354,12040343,TXFE7,128,9954,1,71219,35229,36365
12040592,12040586,TXFE7,128,9954,1,71220,35230,36366
12040792,12040786,TXFE7,128,9955,5,71225,35231,36368
12040992,12040981,TXFE7,128,9954,2,71227,35233,36369
12041267,12041259,TXFE7,128,9954,1,71228,35234,36370
12041492,12041480,TXFE7,128,9954,1,71229,35235,36371
12041879,12041875,TXFE7,128,9955,6,71235,35236,36373
12041892,12041881,TXFE7,128,9954,3,71238,35237,36374
12042217,12042208,TXFE7,128,9954,2,71240,35239,36375
12042242,12042241,TXFE7,128,9954,1,71241,35240,36376
12042504,12042494,TXFE7,128,9954,1,71242,35241,36377
12042942,12042939,TXFE7,128,9954,1,71243,35242,36378
12043129,12043128,TXFE7,128,9954,1,71244,35243,36379
12043167,12043161,TXFE7,128,9954,1,71245,35244,36380
12043629,12043618,TXFE7,128,9955,2,71247,35245,36382
12043642,12043632,TXFE7,128,9954,1,71248,35246,36383
12043817,12043811,TXFE7,128,9954,2,71250,35248,36384
12044792,12044782,TXFE7,128,9954,3,71263,35251,36388
12044879,12044871,TXFE7,128,9954,1,71264,35252,36389
12044879,12044873,TXFE7,128,9954,2,71266,35253,36390
12044942,12044930,TXFE7,128,9954,1,71267,35254,36391
12044967,12044955,TXFE7,128,9954,1,71268,35255,36392
12045417,12045405,TXFE7,128,9954,1,71269,35256,36393
12045429,12045423,TXFE7,128,9953,1,71270,35257,36394
12045479,12045467,TXFE7,128,9954,8,71278,35258,36397
12045717,12045704,TXFE7,128,9954,1,71279,35259,36398
12050079,12050076,TXFE7,128,9954,1,71280,35260,36399
12050104,12050103,TXFE7,128,9953,12,71292,35266,36400
12050117,12050109,TXFE7,128,9953,7,71299,35271,36401
12050117,12050112,TXFE7,128,9953,1,71300,35272,36402
12050642,12050638,TXFE7,128,9953,25,71325,35291,36403
12050742,12050735,TXFE7,128,9953,14,71339,35304,36404
12050754,12050746,TXFE7,128,9953,3,71342,35306,36405
12050792,12050780,TXFE7,128,9953,2,71344,35307,36406
12050804,12050794,TXFE7,128,9953,5,71349,35311,36407
12050804,12050798,TXFE7,128,9953,1,71350,35312,36408
12050817,12050808,TXFE7,128,9952,1,71351,35313,36409
12050829,12050819,TXFE7,128,9952,1,71352,35314,36410
12050829,12050819,TXFE7,128,9952,1,71353,35315,36411
12050829,12050823,TXFE7,128,9952,1,71354,35316,36412
12050829,12050823,TXFE7,128,9952,1,71355,35317,36413
12050829,12050827,TXFE7,128,9952,1,71356,35318,36414
12050829,12050829,TXFE7,128,9952,1,71357,35319,36415
12050842,12050831,TXFE7,128,9952,1,71358,35320,36416
12050842,12050833,TXFE7,128,9952,1,71359,35321,36417
12050842,12050833,TXFE7,128,9952,1,71360,35322,36418
12050842,12050835,TXFE7,128,9952,1,71361,35323,36419
12050842,12050835,TXFE7,128,9952,1,71362,35324,36420
12050842,12050839,TXFE7,128,9952,1,71363,35325,36421
12050842,12050839,TXFE7,128,9952,1,71364,35326,36422
12050842,12050841,TXFE7,128,9952,1,71365,35327,36423
12050854,12050853,TXFE7,128,9953,1,71366,35328,36424
12050867,12050859,TXFE7,128,9952,2,71368,35329,36425
12050892,12050890,TXFE7,128,9953,2,71370,35330,36426
12050904,12050896,TXFE7,128,9952,2,71372,35331,36427
12050904,12050897,TXFE7,128,9953,6,71378,35332,36429
12050917,12050909,TXFE7,128,9953,1,71379,35333,36430
12050954,12050944,TXFE7,128,9953,1,71380,35334,36431
12050967,12050960,TXFE7,128,9953,1,71381,35335,36432
12050967,12050966,TXFE7,128,9952,9,71390,35337,36433
12051017,12051012,TXFE7,128,9952,1,71391,35338,36434
12051079,12051071,TXFE7,128,9953,1,71392,35339,36435
12051079,12051077,TXFE7,128,9953,2,71394,35340,36437
12051317,12051305,TXFE7,128,9953,1,71395,35341,36438
12051492,12051480,TXFE7,128,9952,1,71396,35342,36439
12051779,12051767,TXFE7,128,9952,40,71436,35376,36440
12051879,12051874,TXFE7,128,9952,2,71438,35378,36441
12051892,12051883,TXFE7,128,9953,1,71439,35379,36442
12051929,12051927,TXFE7,128,9952,1,71440,35380,36443
12051967,12051961,TXFE7,128,9952,1,71441,35381,36444
12052042,12052039,TXFE7,128,9952,5,71446,35386,36445
12052067,12052065,TXFE7,128,9952,5,71451,35391,36446
12052092,12052084,TXFE7,128,9952,4,71455,35394,36447
12052117,12052106,TXFE7,128,9952,5,71460,35399,36448
12052129,12052127,TXFE7,128,9952,1,71461,35400,36449
12052142,12052129,TXFE7,128,9952,4,71465,35401,36450
12052179,12052171,TXFE7,128,9951,1,71466,35402,36451
12052192,12052181,TXFE7,128,9951,10,71476,35409,36452
12052204,12052192,TXFE7,128,9952,1,71477,35410,36453
12052204,12052196,TXFE7,128,9951,3,71480,35413,36454
12052204,12052197,TXFE7,128,9951,3,71483,35416,36455
12052204,12052200,TXFE7,128,9951,4,71487,35419,36456
12052204,12052200,TXFE7,128,9951,1,71488,35420,36457
12052204,12052202,TXFE7,128,9951,1,71489,35421,36458
12052217,12052206,TXFE7,128,9951,1,71490,35422,36459
12052217,12052211,TXFE7,128,9952,1,71491,35423,36460
12052229,12052220,TXFE7,128,9952,2,71493,35424,36462
12052254,12052249,TXFE7,128,9951,1,71494,35425,36463
12052279,12052272,TXFE7,128,9952,1,71495,35426,36464
12052304,12052301,TXFE7,128,9951,2,71497,35427,36465
12052317,12052315,TXFE7,128,9952,1,71498,35428,36466
12052329,12052318,TXFE7,128,9952,5,71503,35429,36470
12052329,12052318,TXFE7,128,9951,5,71508,35432,36471
12052329,12052319,TXFE7,128,9951,1,71509,35433,36472
12052329,12052328,TXFE7,128,9951,1,71510,35434,36473
12052354,12052348,TXFE7,128,9951,1,71511,35435,36474
12052467,12052455,TXFE7,128,9951,1,71512,35436,36475
12052467,12052455,TXFE7,128,9951,1,71513,35437,36476
12052479,12052467,TXFE7,128,9952,1,71514,35438,36477
12052579,12052572,TXFE7,128,9952,2,71516,35439,36479
12052579,12052579,TXFE7,128,9952,1,71517,35440,36480
12052629,12052622,TXFE7,128,9951,1,71518,35441,36481
12052704,12052704,TXFE7,128,9952,1,71519,35442,36482
12052817,12052806,TXFE7,128,9952,2,71521,35443,36483
12052867,12052867,TXFE7,128,9952,1,71522,35444,36484
12052967,12052963,TXFE7,128,9952,10,71532,35445,36492
12053104,12053097,TXFE7,128,9952,1,71533,35446,36493
12053104,12053100,TXFE7,128,9953,2,71535,35447,36495
12053117,12053112,TXFE7,128,9952,1,71536,35448,36496
12053142,12053137,TXFE7,128,9952,1,71537,35449,36497
12053204,12053192,TXFE7,128,9953,1,71538,35450,36498
12053404,12053392,TXFE7,128,9952,2,71540,35451,36499
12053754,12053750,TXFE7,128,9952,1,71541,35452,36500
12053967,12053966,TXFE7,128,9952,5,71546,35454,36501
12054092,12054086,TXFE7,128,9952,1,71547,35455,36502
12054104,12054098,TXFE7,128,9953,1,71548,35456,36503
12054117,12054115,TXFE7,128,9953,1,71549,35457,36504
12054242,12054237,TXFE7,128,9952,2,71551,35459,36505
12054417,12054415,TXFE7,128,9953,5,71556,35460,36507
12054717,12054704,TXFE7,128,9953,4,71560,35461,36509
12054717,12054709,TXFE7,128,9953,24,71584,35462,36524
12054892,12054879,TXFE7,128,9953,1,71585,35463,36525
12054992,12054984,TXFE7,128,9953,1,71586,35464,36526
12055092,12055081,TXFE7,128,9953,4,71590,35468,36527
12055154,12055151,TXFE7,128,9953,5,71595,35469,36529
12055742,12055734,TXFE7,128,9953,1,71596,35470,36530
12055854,12055848,TXFE7,128,9952,10,71606,35471,36531
12060317,12060308,TXFE7,128,9953,1,71607,35472,36532
12060629,12060626,TXFE7,128,9952,1,71608,35473,36533
12060754,12060743,TXFE7,128,9952,2,71610,35475,36534
12060967,12060957,TXFE7,128,9953,1,71611,35476,36535
12061117,12061114,TXFE7,128,9953,2,71613,35477,36536
12061129,12061117,TXFE7,128,9953,1,71614,35478,36537
12061129,12061118,TXFE7,128,9953,2,71616,35479,36538
12061179,12061175,TXFE7,128,9953,1,71617,35480,36539
12061317,12061309,TXFE7,128,9953,1,71618,35481,36540
12061492,12061480,TXFE7,128,9952,1,71619,35482,36541
12061892,12061886,TXFE7,128,9952,1,71620,35483,36542
12062204,12062195,TXFE7,128,9953,1,71621,35484,36543
12062404,12062395,TXFE7,128,9953,2,71623,35485,36545
12062554,12062543,TXFE7,128,9953,1,71624,35486,36546
12062917,12062906,TXFE7,128,9953,5,71629,35487,36549
12062967,12062960,TXFE7,128,9953,2,71631,35488,36551
12062979,12062972,TXFE7,128,9953,1,71632,35489,36552
12063267,12063255,TXFE7,128,9953,2,71634,35490,36554
12063817,12063810,TXFE7,128,9952,5,71639,35495,36555
12063854,12063851,TXFE7,128,9952,5,71644,35498,36556
12063904,12063897,TXFE7,128,9952,5,71649,35500,36557
12064429,12064421,TXFE7,128,9952,5,71654,35505,36558
12064442,12064440,TXFE7,128,9952,5,71659,35509,36559
12064454,12064443,TXFE7,128,9952,5,71664,35512,36560
12064467,12064456,TXFE7,128,9952,5,71669,35515,36561
12064804,12064793,TXFE7,128,9952,5,71674,35520,36562
12064967,12064965,TXFE7,128,9952,3,71677,35523,36563
12065292,12065286,TXFE7,128,9953,1,71678,35524,36564
12065329,12065318,TXFE7,128,9953,3,71681,35525,36565
12065404,12065397,TXFE7,128,9953,1,71682,35526,36566
12065679,12065672,TXFE7,128,9953,10,71692,35527,36573
12065692,12065686,TXFE7,128,9953,1,71693,35528,36574
12065979,12065972,TXFE7,128,9953,1,71694,35529,36575
12070042,12070041,TXFE7,128,9953,1,71695,35530,36576
12070267,12070265,TXFE7,128,9953,4,71699,35531,36579
12070279,12070267,TXFE7,128,9953,12,71711,35532,36583
12070304,12070294,TXFE7,128,9953,1,71712,35533,36584
12070342,12070331,TXFE7,128,9953,1,71713,35534,36585
12070542,12070540,TXFE7,128,9954,1,71714,35535,36586
12070679,12070677,TXFE7,128,9953,2,71716,35537,36587
12071317,12071306,TXFE7,128,9953,4,71720,35541,36588
12071429,12071421,TXFE7,128,9954,1,71721,35542,36589
12071442,12071430,TXFE7,128,9953,1,71722,35543,36590
12071729,12071717,TXFE7,128,9953,7,71729,35549,36591
12071729,12071726,TXFE7,128,9953,2,71731,35550,36592
12072817,12072809,TXFE7,128,9953,1,71732,35551,36593
12073304,12073292,TXFE7,128,9953,1,71733,35552,36594
12073317,12073304,TXFE7,128,9953,2,71735,35553,36596
12073317,12073304,TXFE7,128,9953,2,71737,35554,36597
12073317,12073305,TXFE7,128,9953,1,71738,35555,36598
12074242,12074240,TXFE7,128,9953,3,71741,35557,36599
12074304,12074301,TXFE7,128,9953,1,71742,35558,36600
12074317,12074314,TXFE7,128,9953,11,71753,35566,36601
12074442,12074434,TXFE7,128,9953,6,71759,35567,36602
12074442,12074439,TXFE7,128,9953,3,71762,35568,36603
12074517,12074505,TXFE7,128,9953,1,71763,35569,36604
12074567,12074555,TXFE7,128,9953,3,71766,35570,36605
12074679,12074675,TXFE7,128,9953,1,71767,35571,36606
12074817,12074813,TXFE7,128,9953,3,71770,35572,36607
12075167,12075159,TXFE7,128,9953,1,71771,35573,36608
12075529,12075521,TXFE7,128,9953,1,71772,35574,36609
12075567,12075557,TXFE7,128,9953,1,71773,35575,36610
12075592,12075581,TXFE7,128,9953,1,71774,35576,36611
12075617,12075607,TXFE7,128,9953,1,71775,35577,36612
12075629,12075629,TXFE7,128,9953,1,71776,35578,36613
12075667,12075666,TXFE7,128,9953,1,71777,35579,36614
12075704,12075700,TXFE7,128,9953,1,71778,35580,36615
12075729,12075727,TXFE7,128,9953,1,71779,35581,36616
12075754,12075744,TXFE7,128,9954,50,71829,35582,36644
12075767,12075755,TXFE7,128,9955,7,71836,35583,36647
12075779,12075768,TXFE7,128,9954,1,71837,35584,36648
12080417,12080412,TXFE7,128,9954,1,71838,35585,36649
12081229,12081228,TXFE7,128,9955,2,71840,35586,36650
12081492,12081480,TXFE7,128,9954,1,71841,35587,36651
12081567,12081556,TXFE7,128,9955,1,71842,35588,36652
12082454,12082442,TXFE7,128,9954,1,71843,35589,36653
12082529,12082517,TXFE7,128,9954,1,71844,35590,36654
12082604,12082602,TXFE7,128,9954,1,71845,35591,36655
12082829,12082817,TXFE7,128,9954,1,71846,35592,36656
12083104,12083094,TXFE7,128,9955,1,71847,35593,36657
12083979,12083975,TXFE7,128,9955,1,71848,35594,36658
12084404,12084393,TXFE7,128,9955,5,71853,35595,36663
12084542,12084539,TXFE7,128,9955,5,71858,35596,36666
12084629,12084619,TXFE7,128,9955,5,71863,35597,36670
12084654,12084644,TXFE7,128,9955,1,71864,35598,36671
12084729,12084725,TXFE7,128,9955,5,71869,35599,36676
12084817,12084813,TXFE7,128,9955,5,71874,35600,36677
12084892,12084892,TXFE7,128,9955,1,71875,35601,36678
12084929,12084922,TXFE7,128,9954,1,71876,35602,36679
12085354,12085346,TXFE7,128,9955,1,71877,35603,36680
12090242,12090241,TXFE7,128,9955,1,71878,35604,36681
12090267,12090260,TXFE7,128,9955,3,71881,35605,36682
12090304,12090296,TXFE7,128,9955,3,71884,35606,36684
12090542,12090532,TXFE7,128,9955,1,71885,35607,36685
12090929,12090924,TXFE7,128,9955,1,71886,35608,36686
12091254,12091251,TXFE7,128,9954,1,71887,35609,36687
12091379,12091375,TXFE7,128,9955,1,71888,35610,36688
12091492,12091480,TXFE7,128,9954,1,71889,35611,36689
12091804,12091798,TXFE7,128,9955,1,71890,35612,36690
12092717,12092707,TXFE7,128,9955,1,71891,35613,36691
12092717,12092709,TXFE7,128,9955,4,71895,35614,36693
12092967,12092957,TXFE7,128,9954,1,71896,35615,36694
12093242,12093237,TXFE7,128,9955,1,71897,35616,36695
12093304,12093298,TXFE7,128,9954,2,71899,35617,36696
12094342,12094339,TXFE7,128,9954,1,71900,35618,36697
12095042,12095035,TXFE7,128,9955,5,71905,35619,36701
12100042,12100039,TXFE7,128,9955,1,71906,35620,36702
12101592,12101590,TXFE7,128,9955,1,71907,35621,36703
12101917,12101916,TXFE7,128,9955,1,71908,35622,36704
12101967,12101964,TXFE7,128,9955,1,71909,35623,36705
12102004,12101998,TXFE7,128,9954,1,71910,35624,36706
12102079,12102076,TXFE7,128,9955,17,71927,35625,36719
12102567,12102559,TXFE7,128,9954,4,71931,35628,36720
12102567,12102559,TXFE7,128,9954,6,71937,35632,36721
12102567,12102559,TXFE7,128,9954,2,71939,35633,36722
12102567,12102559,TXFE7,128,9954,1,71940,35634,36723
12102567,12102559,TXFE7,128,9954,1,71941,35635,36724
12102567,12102559,TXFE7,128,9954,2,71943,35636,36725
12102567,12102559,TXFE7,128,9954,1,71944,35637,36726
12102567,12102559,TXFE7,128,9954,1,71945,35638,36727
12102567,12102559,TXFE7,128,9954,1,71946,35639,36728
12102567,12102559,TXFE7,128,9954,1,71947,35640,36729
12102579,12102567,TXFE7,128,9954,4,71951,35641,36730
12102579,12102567,TXFE7,128,9954,5,71956,35644,36731
12102579,12102567,TXFE7,128,9954,1,71957,35645,36732
12102579,12102567,TXFE7,128,9954,1,71958,35646,36733
12102579,12102567,TXFE7,128,9954,1,71959,35647,36734
12102579,12102567,TXFE7,128,9954,1,71960,35648,36735
12102579,12102567,TXFE7,128,9954,1,71961,35649,36736
12102579,12102567,TXFE7,128,9954,4,71965,35650,36737
12102579,12102567,TXFE7,128,9954,9,71974,35653,36738
12102579,12102568,TXFE7,128,9954,6,71980,35654,36739
12102579,12102568,TXFE7,128,9954,1,71981,35655,36740
12102579,12102570,TXFE7,128,9954,17,71998,35667,36741
12102592,12102591,TXFE7,128,9954,1,71999,35668,36742
12102754,12102750,TXFE7,128,9953,1,72000,35669,36743
12103004,12102994,TXFE7,128,9954,1,72001,35670,36744
12103142,12103141,TXFE7,128,9954,2,72003,35671,36746
12103267,12103264,TXFE7,128,9954,1,72004,35672,36747
12103454,12103448,TXFE7,128,9954,1,72005,35673,36748
12103479,12103469,TXFE7,128,9953,1,72006,35674,36749
12103529,12103519,TXFE7,128,9953,2,72008,35675,36750
12103529,12103523,TXFE7,128,9954,1,72009,35676,36751
12103542,12103537,TXFE7,128,9953,1,72010,35677,36752
12103704,12103693,TXFE7,128,9954,5,72015,35678,36756
12103754,12103744,TXFE7,128,9954,1,72016,35679,36757
12104017,12104014,TXFE7,128,9954,1,72017,35680,36758
12104054,12104049,TXFE7,128,9954,1,72018,35681,36759
12104104,12104095,TXFE7,128,9954,1,72019,35682,36760
12104854,12104843,TXFE7,128,9954,1,72020,35683,36761
12105179,12105171,TXFE7,128,9954,1,72021,35684,36762
12105179,12105178,TXFE7,128,9954,1,72022,35685,36763
12105354,12105345,TXFE7,128,9954,1,72023,35686,36764
12105717,12105711,TXFE7,128,9955,1,72024,35687,36765
12105729,12105728,TXFE7,128,9954,1,72025,35688,36766
12110442,12110440,TXFE7,128,9954,1,72026,35689,36767
12110617,12110606,TXFE7,128,9954,2,72028,35691,36768
12111467,12111455,TXFE7,128,9954,1,72029,35692,36769
12111867,12111860,TXFE7,128,9954,1,72030,35693,36770
12111929,12111922,TXFE7,128,9954,1,72031,35694,36771
12112004,12111997,TXFE7,128,9954,1,72032,35695,36772
12112067,12112058,TXFE7,128,9954,2,72034,35696,36773
12112079,12112074,TXFE7,128,9954,2,72036,35698,36774
12113254,12113252,TXFE7,128,9953,1,72037,35699,36775
12113604,12113594,TXFE7,128,9953,2,72039,35700,36776
12114579,12114569,TXFE7,128,9954,1,72040,35701,36777
12114804,12114793,TXFE7,128,9954,2,72042,35702,36778
12114817,12114804,TXFE7,128,9954,1,72043,35703,36779
12114829,12114817,TXFE7,128,9954,1,72044,35704,36780
12114842,12114829,TXFE7,128,9954,1,72045,35705,36781
12114842,12114834,TXFE7,128,9954,3,72048,35706,36783
12114842,12114834,TXFE7,128,9954,1,72049,35707,36784
12114854,12114842,TXFE7,128,9954,2,72051,35708,36785
12114854,12114842,TXFE7,128,9954,1,72052,35709,36786
12115117,12115110,TXFE7,128,9954,6,72058,35711,36787
12115154,12115152,TXFE7,128,9954,1,72059,35712,36788
12115179,12115178,TXFE7,128,9954,1,72060,35713,36789
12115517,12115508,TXFE7,128,9954,1,72061,35714,36790
12115942,12115935,TXFE7,128,9954,1,72062,35715,36791
12120154,12120150,TXFE7,128,9954,1,72063,35716,36792
12120229,12120224,TXFE7,128,9953,4,72067,35717,36793
12120867,12120863,TXFE7,128,9953,3,72070,35718,36794
12121042,12121041,TXFE7,128,9954,1,72071,35719,36795
12121492,12121490,TXFE7,128,9954,1,72072,35720,36796
12123092,12123082,TXFE7,128,9954,1,72073,35721,36797
12123467,12123466,TXFE7,128,9954,1,72074,35722,36798
12123604,12123595,TXFE7,128,9954,1,72075,35723,36799
12123767,12123765,TXFE7,128,9954,1,72076,35724,36800
12123867,12123855,TXFE7,128,9954,1,72077,35725,36801
12125454,12125443,TXFE7,128,9954,1,72078,35726,36802
12130642,12130634,TXFE7,128,9953,1,72079,35727,36803
12130754,12130742,TXFE7,128,9953,1,72080,35728,36804
12131079,12131067,TXFE7,128,9953,1,72081,35729,36805
12131167,12131160,TXFE7,128,9953,3,72084,35730,36806
12131204,12131202,TXFE7,128,9953,1,72085,35731,36807
12131417,12131406,TXFE7,128,9953,1,72086,35732,36808
12131692,12131679,TXFE7,128,9953,1,72087,35733,36809
12131692,12131680,TXFE7,128,9953,3,72090,35734,36810
12131692,12131680,TXFE7,128,9953,1,72091,35735,36811
12131692,12131680,TXFE7,128,9953,40,72131,35739,36812
12131692,12131680,TXFE7,128,9953,2,72133,35741,36813
12131704,12131692,TXFE7,128,9953,8,72141,35749,36814
12131704,12131692,TXFE7,128,9953,1,72142,35750,36815
12131704,12131692,TXFE7,128,9953,2,72144,35752,36816
12131704,12131692,TXFE7,128,9953,4,72148,35756,36817
12131704,12131692,TXFE7,128,9953,1,72149,35757,36818
12131767,12131755,TXFE7,128,9953,1,72150,35758,36819
12132804,12132796,TXFE7,128,9952,1,72151,35759,36820
12133017,12133007,TXFE7,128,9952,1,72152,35760,36821
12133154,12133145,TXFE7,128,9953,4,72156,35761,36825
12133154,12133150,TXFE7,128,9953,1,72157,35762,36826
12133154,12133150,TXFE7,128,9953,2,72159,35763,36828
12133167,12133154,TXFE7,128,9953,1,72160,35764,36829
12133167,12133154,TXFE7,128,9953,4,72164,35765,36830
12133454,12133448,TXFE7,128,9953,1,72165,35766,36831
12133467,12133456,TXFE7,128,9953,1,72166,35767,36832
12133479,12133469,TXFE7,128,9953,1,72167,35768,36833
12134829,12134818,TXFE7,128,9952,3,72170,35771,36834
12135454,12135447,TXFE7,128,9953,5,72175,35772,36836
12135779,12135771,TXFE7,128,9953,5,72180,35773,36838
12140054,12140046,TXFE7,128,9953,1,72181,35774,36839
12140129,12140125,TXFE7,128,9953,1,72182,35775,36840
12141504,12141502,TXFE7,128,9953,5,72187,35776,36841
12141792,12141782,TXFE7,128,9952,2,72189,35778,36842
12142067,12142059,TXFE7,128,9952,1,72190,35779,36843
12142129,12142119,TXFE7,128,9953,2,72192,35780,36844
12142267,12142255,TXFE7,128,9953,1,72193,35781,36845
12142904,12142898,TXFE7,128,9952,1,72194,35782,36846
12143292,12143281,TXFE7,128,9952,1,72195,35783,36847
12143554,12143554,TXFE7,128,9952,10,72205,35788,36848
12143642,12143636,TXFE7,128,9952,1,72206,35789,36849
12143679,12143678,TXFE7,128,9952,2,72208,35790,36850
12143742,12143730,TXFE7,128,9952,1,72209,35791,36851
12143779,12143775,TXFE7,128,9952,1,72210,35792,36852
12143792,12143784,TXFE7,128,9952,10,72220,35795,36853
12143817,12143817,TXFE7,128,9952,2,72222,35796,36854
12143854,12143852,TXFE7,128,9952,50,72272,35807,36855
12143867,12143854,TXFE7,128,9952,2,72274,35808,36856
12143867,12143854,TXFE7,128,9952,3,72277,35809,36857
12143867,12143854,TXFE7,128,9952,2,72279,35810,36858
12143867,12143854,TXFE7,128,9952,1,72280,35811,36859
12143867,12143854,TXFE7,128,9952,3,72283,35813,36860
12143867,12143854,TXFE7,128,9952,4,72287,35816,36861
12143867,12143854,TXFE7,128,9952,18,72305,35828,36862
12143892,12143881,TXFE7,128,9951,1,72306,35829,36863
12143904,12143898,TXFE7,128,9951,1,72307,35830,36864
12143917,12143906,TXFE7,128,9951,3,72310,35833,36865
12143942,12143934,TXFE7,128,9951,2,72312,35834,36866
12143979,12143969,TXFE7,128,9952,1,72313,35835,36867
12144029,12144019,TXFE7,128,9952,1,72314,35836,36868
12144067,12144058,TXFE7,128,9951,2,72316,35837,36869
12144079,12144070,TXFE7,128,9952,1,72317,35838,36870
12144117,12144110,TXFE7,128,9951,1,72318,35839,36871
12144342,12144333,TXFE7,128,9951,1,72319,35840,36872
12144754,12144752,TXFE7,128,9952,10,72329,35841,36877
12144954,12144943,TXFE7,128,9952,10,72339,35842,36880
12144979,12144969,TXFE7,128,9952,1,72340,35843,36881
12145004,12144997,TXFE7,128,9951,1,72341,35844,36882
12145104,12145097,TXFE7,128,9951,1,72342,35845,36883
12145129,12145120,TXFE7,128,9951,1,72343,35846,36884
12145204,12145193,TXFE7,128,9952,1,72344,35847,36885
12145317,12145315,TXFE7,128,9952,1,72345,35848,36886
12145342,12145335,TXFE7,128,9952,1,72346,35849,36887
12145767,12145760,TXFE7,128,9952,1,72347,35850,36888
12145804,12145800,TXFE7,128,9952,1,72348,35851,36889
12150067,12150058,TXFE7,128,9952,2,72350,35852,36890
12150079,12150073,TXFE7,128,9951,3,72353,35853,36891
12150079,12150079,TXFE7,128,9951,2,72355,35855,36892
12150092,12150083,TXFE7,128,9951,2,72357,35857,36893
12150092,12150083,TXFE7,128,9951,2,72359,35858,36894
12150092,12150089,TXFE7,128,9951,1,72360,35859,36895
12150104,12150095,TXFE7,128,9951,1,72361,35860,36896
12150104,12150097,TXFE7,128,9951,1,72362,35861,36897
12150104,12150101,TXFE7,128,9951,1,72363,35862,36898
12150104,12150103,TXFE7,128,9951,2,72365,35863,36899
12150117,12150113,TXFE7,128,9951,6,72371,35867,36900
12150129,12150119,TXFE7,128,9951,6,72377,35871,36901
12150129,12150120,TXFE7,128,9951,6,72383,35875,36902
12150129,12150123,TXFE7,128,9951,1,72384,35876,36903
12150179,12150171,TXFE7,128,9952,2,72386,35877,36904
12150204,12150193,TXFE7,128,9951,9,72395,35884,36905
12150204,12150200,TXFE7,128,9952,1,72396,35885,36906
12150229,12150222,TXFE7,128,9951,2,72398,35887,36907
12150529,12150521,TXFE7,128,9952,4,72402,35888,36909
12150704,12150702,TXFE7,128,9952,5,72407,35889,36914
12150779,12150769,TXFE7,128,9951,1,72408,35890,36915
12150817,12150810,TXFE7,128,9951,1,72409,35891,36916
12150917,12150915,TXFE7,128,9952,1,72410,35892,36917
12151329,12151319,TXFE7,128,9952,1,72411,35893,36918
12151492,12151487,TXFE7,128,9952,1,72412,35894,36919
12151742,12151735,TXFE7,128,9951,1,72413,35895,36920
12151979,12151968,TXFE7,128,9952,1,72414,35896,36921
12151979,12151973,TXFE7,128,9952,2,72416,35897,36923
12152029,12152028,TXFE7,128,9951,1,72417,35898,36924
12152092,12152080,TXFE7,128,9952,1,72418,35899,36925
12152317,12152306,TXFE7,128,9951,1,72419,35900,36926
12152329,12152328,TXFE7,128,9951,10,72429,35901,36927
12152667,12152658,TXFE7,128,9951,5,72434,35902,36928
12152779,12152775,TXFE7,128,9951,2,72436,35903,36929
12153179,12153168,TXFE7,128,9951,3,72439,35904,36930
12153717,12153706,TXFE7,128,9952,1,72440,35905,36931
12154092,12154088,TXFE7,128,9951,2,72442,35906,36932
12154104,12154095,TXFE7,128,9951,1,72443,35907,36933
12154117,12154115,TXFE7,128,9951,2,72445,35908,36934
12154129,12154127,TXFE7,128,9951,1,72446,35909,36935
12154142,12154132,TXFE7,128,9951,1,72447,35910,36936
12154179,12154167,TXFE7,128,9951,2,72449,35911,36937
12154204,12154196,TXFE7,128,9951,2,72451,35912,36938
12154204,12154204,TXFE7,128,9951,2,72453,35913,36939
12154217,12154204,TXFE7,128,9951,3,72456,35914,36940
12154217,12154204,TXFE7,128,9951,1,72457,35915,36941
12154217,12154204,TXFE7,128,9951,1,72458,35916,36942
12154217,12154205,TXFE7,128,9951,11,72469,35917,36943
12154229,12154217,TXFE7,128,9951,1,72470,35918,36944
12154229,12154217,TXFE7,128,9951,1,72471,35919,36945
12154229,12154217,TXFE7,128,9951,3,72474,35922,36946
12154267,12154254,TXFE7,128,9951,1,72475,35923,36947
12154279,12154274,TXFE7,128,9951,1,72476,35924,36948
12154279,12154279,TXFE7,128,9951,2,72478,35926,36949
12154329,12154329,TXFE7,128,9951,5,72483,35931,36950
12154517,12154506,TXFE7,128,9951,5,72488,35936,36951
12154517,12154510,TXFE7,128,9951,6,72494,35940,36952
12154579,12154577,TXFE7,128,9951,1,72495,35941,36953
12154592,12154585,TXFE7,128,9951,10,72505,35943,36954
12154604,12154592,TXFE7,128,9951,20,72525,35955,36955
12154642,12154635,TXFE7,128,9950,1,72526,35956,36956
12154654,12154648,TXFE7,128,9950,2,72528,35957,36957
12154654,12154648,TXFE7,128,9951,2,72530,35958,36958
12154654,12154650,TXFE7,128,9950,2,72532,35959,36959
12154654,12154651,TXFE7,128,9950,5,72537,35962,36960
12154654,12154653,TXFE7,128,9950,1,72538,35963,36961
12154667,12154662,TXFE7,128,9950,6,72544,35968,36962
12154667,12154663,TXFE7,128,9950,1,72545,35969,36963
12154667,12154666,TXFE7,128,9950,1,72546,35970,36964
12154679,12154670,TXFE7,128,9951,1,72547,35971,36965
12154679,12154672,TXFE7,128,9951,2,72549,35972,36967
12154692,12154679,TXFE7,128,9951,4,72553,35973,36970
12154704,12154703,TXFE7,128,9950,2,72555,35974,36971
12154717,12154704,TXFE7,128,9951,2,72557,35975,36972
12154717,12154705,TXFE7,128,9951,1,72558,35976,36973
12154729,12154723,TXFE7,128,9951,1,72559,35977,36974
12154792,12154785,TXFE7,128,9951,4,72563,35979,36975
12154817,12154812,TXFE7,128,9952,10,72573,35980,36981
12154842,12154837,TXFE7,128,9951,1,72574,35981,36982
12154842,12154839,TXFE7,128,9952,6,72580,35982,36986
12154879,12154870,TXFE7,128,9951,1,72581,35983,36987
12154942,12154929,TXFE7,128,9951,1,72582,35984,36988
12155042,12155040,TXFE7,128,9951,2,72584,35986,36989
12155104,12155094,TXFE7,128,9951,10,72594,35993,36990
12155129,12155117,TXFE7,128,9951,1,72595,35994,36991
12155192,12155190,TXFE7,128,9951,4,72599,35998,36992
12155192,12155191,TXFE7,128,9952,9,72608,35999,36993
12155229,12155226,TXFE7,128,9951,1,72609,36000,36994
12155342,12155340,TXFE7,128,9951,1,72610,36001,36995
12155367,12155357,TXFE7,128,9951,5,72615,36003,36996
12155704,12155695,TXFE7,128,9951,1,72616,36004,36997
12155729,12155726,TXFE7,128,9951,1,72617,36005,36998
12155742,12155730,TXFE7,128,9952,1,72618,36006,36999
12155917,12155914,TXFE7,128,9951,1,72619,36007,37000
12160042,12160036,TXFE7,128,9951,1,72620,36008,37001
12160104,12160099,TXFE7,128,9951,17,72637,36021,37002
12160117,12160112,TXFE7,128,9951,2,72639,36023,37003
12160117,12160113,TXFE7,129,9951,1,72641,36025,37004
12160117,12160113,TXFE7,129,9950,1,72641,36025,37004
12160117,12160115,TXFE7,128,9950,2,72643,36026,37005
12160117,12160116,TXFE7,128,9950,2,72645,36027,37006
12160129,12160117,TXFE7,129,9951,1,72647,36029,37007
12160129,12160117,TXFE7,129,9950,1,72647,36029,37007
12160167,12160158,TXFE7,128,9952,1,72648,36030,37008
12160167,12160163,TXFE7,128,9951,6,72654,36032,37009
12160204,12160202,TXFE7,128,9951,1,72655,36033,37010
12160517,12160516,TXFE7,128,9951,1,72656,36034,37011
12160617,12160607,TXFE7,128,9951,5,72661,36036,37012
12160792,12160786,TXFE7,128,9952,9,72670,36037,37013
12160804,12160803,TXFE7,128,9951,5,72675,36038,37014
12160817,12160813,TXFE7,128,9951,1,72676,36039,37015
12161279,12161276,TXFE7,128,9951,1,72677,36040,37016
12161304,12161293,TXFE7,128,9952,1,72678,36041,37017
12161317,12161315,TXFE7,128,9951,2,72680,36042,37018
12161479,12161472,TXFE7,128,9951,7,72687,36046,37019
12162079,12162075,TXFE7,128,9951,1,72688,36047,37020
12162092,12162084,TXFE7,128,9952,1,72689,36048,37021
12162104,12162092,TXFE7,128,9952,66,72755,36049,37055
12162167,12162157,TXFE7,128,9952,1,72756,36050,37056
12162304,12162292,TXFE7,128,9953,5,72761,36051,37058
12162304,12162292,TXFE7,128,9953,14,72775,36052,37064
12162304,12162303,TXFE7,128,9953,5,72780,36053,37067
12162317,12162304,TXFE7,128,9953,1,72781,36054,37068
12162317,12162304,TXFE7,128,9953,2,72783,36055,37069
12162317,12162311,TXFE7,128,9953,1,72784,36056,37070
12162329,12162317,TXFE7,128,9953,5,72789,36057,37073
12162329,12162317,TXFE7,128,9953,1,72790,36058,37074
12162329,12162317,TXFE7,128,9953,1,72791,36059,37075
12162329,12162317,TXFE7,128,9953,1,72792,36060,37076
12162329,12162317,TXFE7,128,9953,1,72793,36061,37077
12162329,12162317,TXFE7,128,9953,1,72794,36062,37078
12162329,12162317,TXFE7,128,9953,4,72798,36063,37079
12162329,12162317,TXFE7,128,9953,19,72817,36064,37090
12162354,12162351,TXFE7,128,9953,1,72818,36065,37091
12162392,12162380,TXFE7,128,9954,2,72820,36066,37093
12162417,12162406,TXFE7,128,9953,1,72821,36067,37094
12162417,12162411,TXFE7,128,9954,3,72824,36068,37095
12162442,12162431,TXFE7,128,9953,5,72829,36070,37096
12162454,12162452,TXFE7,128,9954,2,72831,36071,37098
12162654,12162651,TXFE7,128,9953,1,72832,36072,37099
12162729,12162717,TXFE7,128,9953,2,72834,36074,37100
12162754,12162752,TXFE7,128,9953,5,72839,36075,37101
12162904,12162895,TXFE7,128,9953,1,72840,36076,37102
12162992,12162989,TXFE7,128,9953,1,72841,36077,37103
12163017,12163006,TXFE7,128,9953,5,72846,36080,37104
12163029,12163018,TXFE7,128,9953,1,72847,36081,37105
12163054,12163045,TXFE7,128,9953,1,72848,36082,37106
12163192,12163183,TXFE7,128,9953,2,72850,36083,37107
12163279,12163270,TXFE7,128,9953,1,72851,36084,37108
12163354,12163346,TXFE7,128,9953,1,72852,36085,37109
12163479,12163472,TXFE7,128,9953,1,72853,36086,37110
12163504,12163498,TXFE7,128,9953,2,72855,36088,37111
12163729,12163724,TXFE7,128,9953,2,72857,36090,37112
12163779,12163769,TXFE7,128,9953,1,72858,36091,37113
12163792,12163779,TXFE7,128,9953,2,72860,36092,37114
12163892,12163888,TXFE7,128,9953,1,72861,36093,37115
12164067,12164060,TXFE7,128,9953,1,72862,36094,37116
12164092,12164080,TXFE7,128,9953,7,72869,36095,37117
12164092,12164085,TXFE7,128,9953,1,72870,36096,37118
12164117,12164105,TXFE7,128,9953,1,72871,36097,37119
12164217,12164209,TXFE7,128,9953,1,72872,36098,37120
12164254,12164251,TXFE7,128,9953,1,72873,36099,37121
12164279,12164279,TXFE7,128,9953,1,72874,36100,37122
12164292,12164286,TXFE7,128,9953,3,72877,36101,37123
12170067,12170057,TXFE7,128,9952,1,72878,36102,37124
12170292,12170281,TXFE7,128,9952,5,72883,36103,37125
12170654,12170653,TXFE7,128,9953,1,72884,36104,37126
12170904,12170894,TXFE7,128,9953,1,72885,36105,37127
12171229,12171228,TXFE7,128,9952,2,72887,36107,37128
12171367,12171361,TXFE7,128,9952,2,72889,36109,37129
12171429,12171417,TXFE7,128,9952,1,72890,36110,37130
12171429,12171417,TXFE7,128,9952,1,72891,36111,37131
12171429,12171418,TXFE7,128,9952,1,72892,36112,37132
12171442,12171429,TXFE7,128,9952,4,72896,36114,37133
12171492,12171487,TXFE7,128,9952,5,72901,36116,37134
12171529,12171519,TXFE7,128,9953,5,72906,36117,37136
12171554,12171547,TXFE7,128,9953,1,72907,36118,37137
12171967,12171962,TXFE7,128,9952,1,72908,36119,37138
12172054,12172048,TXFE7,128,9953,1,72909,36120,37139
12172154,12172144,TXFE7,128,9952,2,72911,36122,37140
12173104,12173097,TXFE7,128,9953,1,72912,36123,37141
12173179,12173169,TXFE7,128,9952,1,72913,36124,37142
12173517,12173510,TXFE7,128,9953,1,72914,36125,37143
12173554,12173553,TXFE7,128,9952,1,72915,36126,37144
12173692,12173691,TXFE7,128,9952,1,72916,36127,37145
12173879,12173868,TXFE7,128,9953,1,72917,36128,37146
12173979,12173974,TXFE7,128,9952,1,72918,36129,37147
12173979,12173975,TXFE7,128,9952,2,72920,36130,37148
12174729,12174717,TXFE7,128,9953,4,72924,36131,37150
12174792,12174781,TXFE7,128,9952,1,72925,36132,37151
12174879,12174871,TXFE7,128,9952,4,72929,36135,37152
12174942,12174935,TXFE7,128,9952,5,72934,36139,37153
12175242,12175237,TXFE7,128,9953,2,72936,36140,37155
12180467,12180458,TXFE7,128,9953,1,72937,36141,37156
12180542,12180541,TXFE7,128,9952,1,72938,36142,37157
12180579,12180571,TXFE7,128,9953,1,72939,36143,37158
12180754,12180745,TXFE7,128,9952,5,72944,36146,37159
12181042,12181039,TXFE7,128,9952,2,72946,36148,37160
12181329,12181323,TXFE7,128,9952,10,72956,36155,37161
12181354,12181347,TXFE7,128,9952,1,72957,36156,37162
12181379,12181370,TXFE7,128,9952,5,72962,36159,37163
12181442,12181430,TXFE7,128,9952,1,72963,36160,37164
12181542,12181539,TXFE7,128,9952,2,72965,36161,37165
12181567,12181563,TXFE7,128,9952,2,72967,36162,37167
12182142,12182131,TXFE7,128,9952,1,72968,36163,37168
12182217,12182213,TXFE7,128,9951,1,72969,36164,37169
12182942,12182938,TXFE7,128,9951,2,72971,36165,37170
12182992,12182988,TXFE7,128,9951,7,72978,36170,37171
12183292,12183288,TXFE7,128,9951,2,72980,36172,37172
12183767,12183763,TXFE7,128,9951,7,72987,36175,37173
12183967,12183959,TXFE7,128,9951,22,73009,36189,37174
12184042,12184032,TXFE7,128,9951,1,73010,36190,37175
12184092,12184079,TXFE7,128,9951,31,73041,36209,37176
12184104,12184093,TXFE7,128,9951,5,73046,36210,37179
12184129,12184118,TXFE7,128,9950,9,73055,36215,37180
12184129,12184124,TXFE7,128,9951,1,73056,36216,37181
12184142,12184130,TXFE7,128,9951,1,73057,36217,37182
12184217,12184213,TXFE7,128,9951,2,73059,36218,37183
12184304,12184293,TXFE7,128,9951,2,73061,36219,37184
12184317,12184312,TXFE7,128,9951,1,73062,36220,37185
12184342,12184334,TXFE7,128,9951,3,73065,36221,37186
12184417,12184406,TXFE7,128,9951,1,73066,36222,37187
12184792,12184781,TXFE7,128,9951,1,73067,36223,37188
12184967,12184957,TXFE7,128,9951,5,73072,36225,37189
12184967,12184959,TXFE7,128,9951,1,73073,36226,37190
12185017,12185009,TXFE7,128,9951,5,73078,36227,37191
12185317,12185315,TXFE7,128,9951,2,73086,36233,37194
12185404,12185402,TXFE7,128,9951,1,73087,36234,37195
12185417,12185405,TXFE7,128,9951,3,73090,36236,37196
12185679,12185676,TXFE7,128,9951,1,73094,36239,37199
12185942,12185941,TXFE7,128,9951,2,73096,36240,37200
12190179,12190174,TXFE7,128,9952,1,73097,36241,37201
12190317,12190308,TXFE7,128,9951,1,73098,36242,37202
12190342,12190332,TXFE7,128,9951,6,73104,36243,37203
12190404,12190393,TXFE7,128,9951,2,73106,36245,37204
12190479,12190473,TXFE7,128,9951,1,73107,36246,37205
12191029,12191026,TXFE7,128,9952,61,73168,36247,37230
12191142,12191142,TXFE7,128,9952,2,73170,36248,37231
12191467,12191463,TXFE7,128,9953,10,73180,36249,37238
12191717,12191707,TXFE7,128,9953,1,73181,36250,37239
12191767,12191755,TXFE7,128,9953,2,73183,36251,37240
12191929,12191918,TXFE7,128,9952,1,73184,36252,37241
12192067,12192067,TXFE7,128,9953,1,73185,36253,37242
12192154,12192150,TXFE7,128,9953,2,73187,36254,37243
12192404,12192402,TXFE7,128,9952,1,73188,36255,37244
12192654,12192650,TXFE7,128,9953,1,73189,36256,37245
12192692,12192691,TXFE7,128,9952,1,73190,36257,37246
12192704,12192702,TXFE7,128,9952,1,73191,36258,37247
12192879,12192870,TXFE7,128,9952,1,73192,36259,37248
12193004,12193004,TXFE7,128,9952,3,73195,36261,37250
12193254,12193254,TXFE7,128,9952,1,73196,36262,37251
12193279,12193270,TXFE7,128,9952,2,73198,36264,37252
12193292,12193279,TXFE7,128,9952,1,73199,36265,37253
12193317,12193310,TXFE7,128,9952,1,73200,36266,37254
12193329,12193325,TXFE7,128,9952,1,73201,36267,37255
12194167,12194159,TXFE7,128,9951,1,73202,36268,37256
12194642,12194635,TXFE7,128,9952,1,73203,36269,37257
12194942,12194930,TXFE7,128,9952,3,73206,36270,37260
12195004,12194996,TXFE7,128,9953,1,73207,36271,37261
12195042,12195032,TXFE7,128,9952,5,73212,36272,37262
12195217,12195212,TXFE7,128,9952,1,73213,36273,37263
12195304,12195299,TXFE7,128,9952,3,73216,36274,37264
12200079,12200075,TXFE7,128,9953,1,73217,36275,37265
12200192,12200187,TXFE7,128,9952,1,73218,36276,37266
12200242,12200235,TXFE7,128,9952,1,73219,36277,37267
12200454,12200451,TXFE7,128,9952,1,73220,36278,37268
12200717,12200714,TXFE7,128,9953,2,73222,36279,37270
12200854,12200842,TXFE7,128,9952,1,73223,36280,37271
12201429,12201428,TXFE7,128,9952,1,73224,36281,37272
12201917,12201912,TXFE7,128,9952,1,73225,36282,37273
12202117,12202110,TXFE7,128,9952,1,73226,36283,37274
12202242,12202237,TXFE7,128,9952,1,73227,36284,37275
12202454,12202448,TXFE7,128,9952,1,73228,36285,37276
12202979,12202978,TXFE7,128,9952,5,73233,36286,37277
12203004,12202996,TXFE7,128,9953,1,73234,36287,37278
12203029,12203023,TXFE7,128,9952,1,73235,36288,37279
12203354,12203351,TXFE7,128,9952,1,73236,36289,37280
12203642,12203641,TXFE7,128,9952,5,73241,36292,37281
12203667,12203656,TXFE7,128,9951,1,73242,36293,37282
12203729,12203721,TXFE7,128,9951,2,73244,36295,37283
12203804,12203798,TXFE7,128,9952,1,73245,36296,37284
12204929,12204919,TXFE7,128,9952,1,73246,36297,37285
12210054,12210045,TXFE7,128,9952,1,73247,36298,37286
12210317,12210312,TXFE7,128,9952,1,73248,36299,37287
12210542,12210539,TXFE7,128,9951,1,73249,36300,37288
12210967,12210963,TXFE7,128,9951,1,73250,36301,37289
12212242,12212237,TXFE7,128,9951,1,73251,36302,37290
12212479,12212476,TXFE7,128,9951,1,73252,36303,37291
12212504,12212502,TXFE7,128,9951,15,73267,36311,37292
12212517,12212504,TXFE7,128,9951,1,73268,36312,37293
12212517,12212509,TXFE7,128,9951,1,73269,36313,37294
12212517,12212509,TXFE7,128,9951,1,73270,36314,37295
12212529,12212517,TXFE7,128,9951,6,73276,36320,37296
12212554,12212542,TXFE7,128,9950,1,73277,36321,37297
12212579,12212576,TXFE7,128,9950,29,73306,36333,37298
12212592,12212579,TXFE7,128,9950,1,73307,36334,37299
12212604,12212592,TXFE7,128,9950,4,73311,36338,37300
12212629,12212618,TXFE7,128,9950,1,73312,36339,37301
12212754,12212747,TXFE7,128,9950,3,73315,36341,37302
12212954,12212942,TXFE7,128,9950,1,73316,36342,37303
12212967,12212955,TXFE7,128,9950,1,73317,36343,37304
12213054,12213045,TXFE7,128,9950,1,73318,36344,37305
12213079,12213072,TXFE7,128,9950,1,73319,36345,37306
12213117,12213105,TXFE7,128,9950,2,73321,36347,37307
12213129,12213122,TXFE7,128,9950,1,73322,36348,37308
12213142,12213139,TXFE7,128,9950,1,73323,36349,37309
12213192,12213180,TXFE7,128,9950,1,73324,36350,37310
12213317,12213313,TXFE7,128,9951,2,73326,36351,37312
12213904,12213893,TXFE7,128,9951,2,73328,36352,37313
12213992,12213986,TXFE7,128,9951,1,73329,36353,37314
12214004,12213998,TXFE7,128,9951,1,73330,36354,37315
12214017,12214016,TXFE7,128,9951,3,73333,36355,37318
12214129,12214126,TXFE7,128,9951,6,73339,36359,37319
12214192,12214184,TXFE7,128,9951,1,73340,36360,37320
12214254,12214248,TXFE7,128,9951,1,73341,36361,37321
12214904,12214893,TXFE7,128,9950,1,73342,36362,37322
12215492,12215480,TXFE7,128,9950,1,73343,36363,37323
12215579,12215569,TXFE7,128,9950,6,73349,36366,37324
12215592,12215584,TXFE7,128,9950,2,73351,36368,37325
12215804,12215798,TXFE7,128,9950,1,73352,36369,37326
12215804,12215799,TXFE7,128,9950,5,73357,36373,37327
12215817,12215808,TXFE7,128,9950,2,73359,36374,37328
12220029,12220025,TXFE7,128,9951,1,73360,36375,37329
12220154,12220152,TXFE7,128,9950,2,73362,36376,37330
12220179,12220176,TXFE7,128,9951,6,73368,36377,37331
12220317,12220314,TXFE7,128,9950,2,73370,36379,37332
12220317,12220315,TXFE7,128,9950,2,73372,36381,37333
12220329,12220328,TXFE7,128,9950,1,73373,36382,37334
12220504,12220496,TXFE7,128,9951,1,73374,36383,37335
12220517,12220510,TXFE7,128,9950,1,73375,36384,37336
12220529,12220526,TXFE7,128,9951,1,73376,36385,37337
12220604,12220597,TXFE7,128,9950,1,73377,36386,37338
12220704,12220702,TXFE7,128,9950,2,73379,36388,37339
12221267,12221259,TXFE7,128,9950,1,73380,36389,37340
12221392,12221390,TXFE7,128,9951,3,73383,36390,37342
12221542,12221542,TXFE7,128,9950,1,73384,36391,37343
12222804,12222804,TXFE7,128,9950,1,73385,36392,37344
12222829,12222821,TXFE7,128,9951,1,73386,36393,37345
12223129,12223126,TXFE7,128,9951,3,73389,36394,37348
12223904,12223896,TXFE7,128,9950,5,73394,36399,37349
12224442,12224440,TXFE7,128,9950,1,73395,36400,37350
12225329,12225327,TXFE7,128,9950,1,73396,36401,37351
12225442,12225431,TXFE7,128,9950,1,73397,36402,37352
12225442,12225436,TXFE7,128,9951,1,73398,36403,37353
12225467,12225457,TXFE7,128,9951,5,73403,36404,37354
12225679,12225672,TXFE7,128,9951,5,73408,36405,37358
12225704,12225692,TXFE7,128,9951,2,73410,36406,37360
12225704,12225692,TXFE7,128,9951,1,73411,36407,37361
12225792,12225785,TXFE7,128,9951,2,73413,36408,37363
12225954,12225942,TXFE7,128,9951,1,73414,36409,37364
12230017,12230005,TXFE7,128,9951,1,73415,36410,37365
12230029,12230023,TXFE7,128,9951,5,73420,36411,37367
12230479,12230467,TXFE7,128,9951,11,73431,36412,37374
12230479,12230467,TXFE7,128,9951,1,73432,36413,37375
12230479,12230467,TXFE7,128,9951,1,73433,36414,37376
12230492,12230479,TXFE7,128,9951,8,73441,36415,37379
12230492,12230479,TXFE7,128,9951,2,73443,36416,37380
12230492,12230479,TXFE7,128,9951,1,73444,36417,37381
12230492,12230479,TXFE7,128,9951,2,73446,36418,37382
12230504,12230492,TXFE7,128,9951,9,73455,36419,37389
12230504,12230492,TXFE7,128,9951,5,73460,36420,37392
12230504,12230492,TXFE7,128,9951,3,73463,36421,37395
12230504,12230492,TXFE7,128,9951,7,73470,36422,37400
12230529,12230517,TXFE7,128,9952,3,73473,36423,37403
12231054,12231054,TXFE7,128,9951,1,73474,36424,37404
12231079,12231078,TXFE7,128,9952,4,73478,36425,37408
12231154,12231142,TXFE7,128,9952,2,73480,36426,37410
12231392,12231386,TXFE7,128,9952,1,73481,36427,37411
12232579,12232579,TXFE7,128,9952,1,73482,36428,37412
12232617,12232605,TXFE7,128,9952,1,73483,36429,37413
12232617,12232607,TXFE7,128,9952,1,73484,36430,37414
12232617,12232614,TXFE7,128,9951,1,73485,36431,37415
12232817,12232814,TXFE7,128,9952,1,73486,36432,37416
12232842,12232832,TXFE7,128,9952,2,73488,36433,37418
12233042,12233041,TXFE7,128,9951,3,73491,36435,37419
12233129,12233119,TXFE7,128,9952,4,73495,36436,37420
12233292,12233290,TXFE7,128,9952,1,73496,36437,37421
12233317,12233306,TXFE7,128,9952,1,73497,36438,37422
12233342,12233334,TXFE7,128,9952,1,73498,36439,37423
12233379,12233376,TXFE7,128,9952,1,73499,36440,37424
12234417,12234412,TXFE7,128,9952,4,73503,36441,37427
12234492,12234488,TXFE7,128,9951,1,73504,36442,37428
12240592,12240587,TXFE7,128,9952,1,73505,36443,37429
12240617,12240606,TXFE7,128,9951,1,73506,36444,37430
12240629,12240618,TXFE7,128,9952,3,73509,36445,37432
12241204,12241202,TXFE7,128,9952,1,73510,36446,37433
12241667,12241661,TXFE7,128,9951,1,73511,36447,37434
12241667,12241664,TXFE7,128,9952,2,73513,36448,37435
12242504,12242496,TXFE7,128,9951,1,73514,36449,37436
12242617,12242608,TXFE7,128,9952,2,73516,36450,37438
12243154,12243154,TXFE7,128,9952,1,73517,36451,37439
12243229,12243229,TXFE7,128,9951,1,73518,36452,37440
12243942,12243931,TXFE7,128,9951,2,73520,36453,37441
12244604,12244593,TXFE7,128,9952,1,73521,36454,37442
12244904,12244895,TXFE7,128,9952,1,73522,36455,37443
12250117,12250111,TXFE7,128,9951,1,73523,36456,37444
12250192,12250180,TXFE7,128,9951,4,73527,36460,37445
12250717,12250707,TXFE7,128,9951,1,73528,36461,37446
12251067,12251058,TXFE7,128,9951,1,73529,36462,37447
12251517,12251505,TXFE7,128,9951,3,73532,36465,37448
12253054,12253052,TXFE7,128,9951,1,73533,36466,37449
12253517,12253508,TXFE7,128,9951,1,73534,36467,37450
12253542,12253541,TXFE7,128,9952,1,73535,36468,37451
12254092,12254081,TXFE7,128,9951,2,73537,36469,37452
12254942,12254942,TXFE7,128,9951,1,73538,36470,37453
12255804,12255792,TXFE7,128,9951,1,73539,36471,37454
12261217,12261211,TXFE7,128,9952,2,73541,36472,37456
12261679,12261669,TXFE7,128,9952,1,73542,36473,37457
12261767,12261766,TXFE7,128,9952,2,73544,36474,37458
12261867,12261860,TXFE7,128,9952,1,73545,36475,37459
12262204,12262195,TXFE7,128,9952,1,73546,36476,37460
12262429,12262418,TXFE7,128,9951,1,73547,36477,37461
12262442,12262437,TXFE7,128,9952,4,73551,36478,37462
12262617,12262615,TXFE7,128,9952,2,73553,36479,37464
12263217,12263210,TXFE7,128,9952,1,73554,36480,37465
12263567,12263566,TXFE7,128,9952,1,73555,36481,37466
12265554,12265551,TXFE7,128,9952,1,73556,36482,37467
12270154,12270149,TXFE7,128,9952,1,73557,36483,37468
12270767,12270755,TXFE7,128,9951,2,73559,36484,37469
12270929,12270927,TXFE7,128,9952,1,73560,36485,37470
12270942,12270933,TXFE7,128,9951,1,73561,36486,37471
12271004,12271003,TXFE7,128,9951,1,73562,36487,37472
12271042,12271040,TXFE7,128,9951,1,73563,36488,37473
12271129,12271124,TXFE7,128,9951,1,73564,36489,37474
12271429,12271425,TXFE7,128,9951,1,73565,36490,37475
12271754,12271748,TXFE7,128,9951,1,73566,36491,37476
12271829,12271818,TXFE7,128,9952,1,73567,36492,37477
12272317,12272312,TXFE7,128,9952,1,73568,36493,37478
12272579,12272574,TXFE7,128,9951,9,73577,36496,37479
12272654,12272652,TXFE7,128,9952,1,73578,36497,37480
12273104,12273099,TXFE7,128,9952,1,73579,36498,37481
12273329,12273328,TXFE7,128,9951,1,73580,36499,37482
12273742,12273740,TXFE7,128,9952,2,73582,36500,37483
12274329,12274322,TXFE7,128,9952,1,73583,36501,37484
12274742,12274732,TXFE7,128,9952,1,73584,36502,37485
12275142,12275130,TXFE7,128,9952,1,73585,36503,37486
12275204,12275201,TXFE7,128,9952,10,73595,36504,37488
12275317,12275316,TXFE7,128,9952,6,73601,36505,37491
12275542,12275540,TXFE7,128,9952,1,73602,36506,37492
12280079,12280078,TXFE7,128,9952,1,73603,36507,37493
12280129,12280120,TXFE7,128,9951,1,73604,36508,37494
12280142,12280131,TXFE7,128,9952,1,73605,36509,37495
12280654,12280649,TXFE7,128,9952,1,73606,36510,37496
12281204,12281203,TXFE7,128,9952,2,73608,36511,37497
12281429,12281422,TXFE7,128,9952,3,73611,36512,37498
12281504,12281504,TXFE7,128,9952,1,73612,36513,37499
12281704,12281704,TXFE7,128,9951,1,73613,36514,37500
12282004,12281995,TXFE7,128,9952,2,73615,36515,37501
12282067,12282059,TXFE7,128,9952,1,73616,36516,37502
12282829,12282828,TXFE7,128,9952,8,73624,36517,37506
12283479,12283476,TXFE7,128,9952,1,73625,36518,37507
12283567,12283558,TXFE7,128,9952,1,73626,36519,37508
12283717,12283716,TXFE7,128,9952,1,73627,36520,37509
12283967,12283955,TXFE7,128,9952,5,73632,36521,37514
12284029,12284025,TXFE7,128,9952,1,73633,36522,37515
12284042,12284034,TXFE7,128,9952,1,73634,36523,37516
12284054,12284042,TXFE7,128,9952,33,73667,36524,37541
12284054,12284043,TXFE7,128,9952,4,73671,36525,37545
12284079,12284067,TXFE7,128,9952,6,73677,36530,37546
12284117,12284116,TXFE7,128,9953,3,73680,36531,37548
12284442,12284434,TXFE7,128,9952,1,73681,36532,37549
12284454,12284450,TXFE7,128,9952,1,73682,36533,37550
12284579,12284567,TXFE7,128,9953,1,73683,36534,37551
12284579,12284575,TXFE7,128,9952,1,73684,36535,37552
12284854,12284842,TXFE7,128,9953,1,73685,36536,37553
12285642,12285641,TXFE7,128,9953,4,73689,36537,37557
12285917,12285914,TXFE7,128,9953,1,73690,36538,37558
12290854,12290844,TXFE7,128,9952,1,73691,36539,37559
12290854,12290846,TXFE7,128,9952,25,73716,36552,37560
12290867,12290854,TXFE7,128,9952,1,73717,36553,37561
12290867,12290857,TXFE7,128,9952,8,73725,36555,37562
12290867,12290858,TXFE7,128,9952,1,73726,36556,37563
12290879,12290874,TXFE7,128,9951,10,73736,36560,37564
12291079,12291070,TXFE7,128,9952,1,73737,36561,37565
12291292,12291284,TXFE7,128,9952,1,73738,36562,37566
12291329,12291318,TXFE7,128,9952,1,73739,36563,37567
12291742,12291739,TXFE7,128,9952,1,73740,36564,37568
12291817,12291813,TXFE7,128,9951,1,73741,36565,37569
12292679,12292673,TXFE7,128,9952,3,73744,36566,37572
12292692,12292679,TXFE7,128,9952,1,73745,36567,37573
12293292,12293286,TXFE7,128,9952,1,73746,36568,37574
12295454,12295447,TXFE7,128,9952,2,73748,36569,37576
12295717,12295717,TXFE7,128,9952,1,73749,36570,37577
12295729,12295720,TXFE7,128,9952,1,73750,36571,37578
12295729,12295721,TXFE7,128,9952,3,73753,36572,37579
12295742,12295729,TXFE7,128,9952,4,73757,36573,37581
12295742,12295729,TXFE7,128,9952,3,73760,36574,37584
12295754,12295742,TXFE7,128,9952,1,73761,36575,37585
12295779,12295773,TXFE7,128,9952,1,73762,36576,37586
12295854,12295844,TXFE7,128,9952,1,73763,36577,37587
12300779,12300773,TXFE7,128,9953,3,73766,36578,37588
12300817,12300810,TXFE7,128,9952,3,73769,36580,37589
12300842,12300842,TXFE7,128,9952,3,73772,36583,37590
12301129,12301124,TXFE7,128,9952,4,73776,36586,37591
12301217,12301216,TXFE7,128,9952,3,73779,36589,37592
12301379,12301378,TXFE7,128,9952,1,73780,36590,37593
12301417,12301409,TXFE7,128,9952,1,73781,36591,37594
12302492,12302489,TXFE7,128,9952,1,73782,36592,37595
12302617,12302615,TXFE7,128,9952,1,73783,36593,37596
12302667,12302662,TXFE7,128,9952,1,73784,36594,37597
12302979,12302971,TXFE7,128,9952,1,73785,36595,37598
12303942,12303937,TXFE7,128,9952,1,73786,36596,37599
12305304,12305296,TXFE7,128,9952,1,73787,36597,37600
12310692,12310692,TXFE7,128,9952,1,73788,36598,37601
12310992,12310981,TXFE7,128,9953,1,73789,36599,37602
12311004,12311003,TXFE7,128,9952,9,73798,36600,37603
12311017,12311008,TXFE7,128,9952,3,73801,36602,37604
12311017,12311008,TXFE7,128,9952,9,73810,36606,37605
12311029,12311017,TXFE7,128,9952,2,73812,36607,37606
12311029,12311017,TXFE7,128,9952,2,73814,36608,37607
12311779,12311778,TXFE7,128,9952,1,73815,36609,37608
12311817,12311813,TXFE7,128,9952,25,73840,36626,37609
12311829,12311817,TXFE7,128,9952,3,73843,36629,37610
12311979,12311967,TXFE7,128,9952,1,73844,36630,37611
12312117,12312111,TXFE7,128,9952,1,73845,36631,37612
12312442,12312436,TXFE7,128,9952,1,73846,36632,37613
12312554,12312543,TXFE7,128,9952,1,73847,36633,37614
12312767,12312762,TXFE7,128,9952,1,73848,36634,37615
12312992,12312991,TXFE7,128,9952,1,73849,36635,37616
12313667,12313655,TXFE7,128,9952,1,73850,36636,37617
12313854,12313848,TXFE7,128,9952,1,73851,36637,37618
12313904,12313902,TXFE7,128,9952,2,73853,36638,37619
12314167,12314165,TXFE7,128,9952,1,73854,36639,37620
12314392,12314389,TXFE7,128,9952,6,73860,36640,37623
12320592,12320582,TXFE7,128,9952,1,73861,36641,37624
12323704,12323701,TXFE7,128,9953,1,73862,36642,37625
12323754,12323746,TXFE7,128,9952,1,73863,36643,37626
12323804,12323793,TXFE7,128,9953,3,73866,36644,37629
12323954,12323946,TXFE7,128,9952,11,73877,36649,37634
12324304,12324293,TXFE7,128,9953,3,73880,36650,37637
12324329,12324322,TXFE7,128,9953,58,73938,36651,37678
12324342,12324329,TXFE7,128,9953,1,73939,36652,37679
12324529,12324527,TXFE7,128,9954,1,73940,36653,37680
12324542,12324532,TXFE7,128,9953,1,73941,36654,37681
12324542,12324542,TXFE7,128,9954,7,73948,36655,37684
12324579,12324571,TXFE7,128,9953,1,73949,36656,37685
12324592,12324579,TXFE7,128,9954,2,73951,36657,37687
12324642,12324637,TXFE7,128,9954,1,73952,36658,37688
12324879,12324871,TXFE7,128,9954,1,73953,36659,37689
12324904,12324896,TXFE7,128,9954,1,73954,36660,37690
12324904,12324897,TXFE7,128,9954,2,73956,36661,37691
12324929,12324919,TXFE7,128,9954,1,73957,36662,37692
12324942,12324941,TXFE7,128,9954,1,73958,36663,37693
12324967,12324963,TXFE7,128,9954,1,73959,36664,37694
12324992,12324983,TXFE7,128,9954,1,73960,36665,37695
12325017,12325007,TXFE7,128,9954,1,73961,36666,37696
12325054,12325047,TXFE7,128,9954,1,73962,36667,37697
12325054,12325048,TXFE7,128,9954,1,73963,36668,37698
12325079,12325069,TXFE7,128,9954,1,73964,36669,37699
12325092,12325090,TXFE7,128,9954,1,73965,36670,37700
12325117,12325109,TXFE7,128,9954,1,73966,36671,37701
12325154,12325149,TXFE7,128,9954,2,73968,36672,37703
12325154,12325150,TXFE7,128,9953,2,73970,36673,37704
12325179,12325172,TXFE7,128,9954,2,73972,36674,37706
12325204,12325193,TXFE7,128,9954,2,73974,36675,37707
12325217,12325211,TXFE7,128,9954,2,73976,36676,37708
12325229,12325228,TXFE7,128,9954,2,73978,36677,37710
12325254,12325246,TXFE7,128,9954,2,73980,36678,37712
12325267,12325263,TXFE7,128,9954,2,73982,36679,37713
12325279,12325278,TXFE7,128,9954,2,73984,36680,37714
12325304,12325297,TXFE7,128,9954,61,74045,36681,37742
12325317,12325304,TXFE7,128,9954,2,74047,36682,37744
12325317,12325313,TXFE7,128,9955,3,74050,36683,37747
12325317,12325314,TXFE7,128,9954,5,74055,36685,37748
12325342,12325331,TXFE7,128,9955,3,74058,36686,37750
12325354,12325349,TXFE7,128,9954,1,74059,36687,37751
12325354,12325350,TXFE7,128,9955,3,74062,36688,37754
12325367,12325365,TXFE7,128,9955,1,74063,36689,37755
12325379,12325367,TXFE7,128,9955,3,74066,36690,37756
12325379,12325369,TXFE7,128,9955,1,74067,36691,37757
12325392,12325384,TXFE7,128,9955,3,74070,36692,37760
12325392,12325387,TXFE7,128,9954,2,74072,36694,37761
12325417,12325414,TXFE7,128,9955,1,74073,36695,37762
12325467,12325461,TXFE7,128,9955,1,74074,36696,37763
12325517,12325510,TXFE7,128,9955,1,74075,36697,37764
12325617,12325611,TXFE7,128,9955,1,74076,36698,37765
12325642,12325637,TXFE7,128,9955,2,74078,36699,37766
12325679,12325673,TXFE7,128,9955,1,74079,36700,37767
12325679,12325675,TXFE7,128,9955,1,74080,36701,37768
12325692,12325687,TXFE7,128,9955,1,74081,36702,37769
12325704,12325704,TXFE7,128,9955,1,74082,36703,37770
12325729,12325721,TXFE7,128,9955,1,74083,36704,37771
12325742,12325739,TXFE7,128,9955,1,74084,36705,37772
12325767,12325756,TXFE7,128,9955,1,74085,36706,37773
12325779,12325773,TXFE7,128,9955,1,74086,36707,37774
12325804,12325792,TXFE7,128,9955,1,74087,36708,37775
12325817,12325810,TXFE7,128,9955,1,74088,36709,37776
12325842,12325839,TXFE7,128,9955,1,74089,36710,37777
12325854,12325843,TXFE7,128,9955,1,74090,36711,37778
12325854,12325845,TXFE7,128,9955,1,74091,36712,37779
12325854,12325846,TXFE7,128,9955,1,74092,36713,37780
12325879,12325878,TXFE7,128,9955,1,74093,36714,37781
12325879,12325879,TXFE7,128,9955,1,74094,36715,37782
12325892,12325885,TXFE7,128,9955,1,74095,36716,37783
12325979,12325971,TXFE7,128,9955,1,74096,36717,37784
12325992,12325989,TXFE7,128,9955,1,74097,36718,37785
12330067,12330056,TXFE7,128,9955,1,74098,36719,37786
12330079,12330075,TXFE7,128,9954,1,74099,36720,37787
12330092,12330083,TXFE7,128,9955,2,74101,36721,37788
12330142,12330140,TXFE7,128,9955,1,74102,36722,37789
12330204,12330193,TXFE7,128,9954,8,74110,36726,37790
12330217,12330216,TXFE7,128,9954,1,74111,36727,37791
12330242,12330236,TXFE7,128,9955,1,74112,36728,37792
12330429,12330419,TXFE7,128,9955,1,74113,36729,37793
12330529,12330527,TXFE7,128,9955,1,74114,36730,37794
12330642,12330640,TXFE7,128,9954,2,74116,36731,37795
12330654,12330644,TXFE7,128,9955,1,74117,36732,37796
12330717,12330710,TXFE7,128,9955,2,74119,36733,37797
12330742,12330741,TXFE7,128,9955,1,74120,36734,37798
12331342,12331340,TXFE7,128,9954,1,74121,36735,37799
12331442,12331442,TXFE7,128,9954,1,74122,36736,37800
12331479,12331474,TXFE7,128,9955,1,74123,36737,37801
12331504,12331493,TXFE7,128,9954,5,74128,36741,37802
12331529,12331527,TXFE7,128,9955,1,74129,36742,37803
12331667,12331665,TXFE7,128,9954,1,74130,36743,37804
12331692,12331681,TXFE7,128,9955,1,74131,36744,37805
12332079,12332079,TXFE7,128,9954,2,74133,36746,37807
12332304,12332301,TXFE7,128,9954,1,74134,36747,37808
12332304,12332301,TXFE7,128,9954,1,74135,36748,37809
12332379,12332372,TXFE7,128,9954,1,74136,36749,37810
12332392,12332389,TXFE7,128,9954,20,74156,36765,37811
12332454,12332453,TXFE7,128,9954,1,74157,36766,37812
12332492,12332490,TXFE7,128,9954,1,74158,36767,37813
12332554,12332554,TXFE7,128,9954,1,74159,36768,37814
12332642,12332630,TXFE7,128,9954,1,74160,36769,37815
12332717,12332714,TXFE7,128,9954,1,74161,36770,37816
12332804,12332798,TXFE7,128,9954,1,74162,36771,37817
12332879,12332870,TXFE7,128,9955,1,74163,36772,37818
12333217,12333216,TXFE7,128,9954,1,74164,36773,37819
12334304,12334298,TXFE7,128,9954,1,74165,36774,37820
12335054,12335044,TXFE7,128,9955,1,74166,36775,37821
12335167,12335158,TXFE7,128,9955,5,74171,36776,37826
12335217,12335208,TXFE7,128,9955,2,74173,36777,37828
12335517,12335510,TXFE7,128,9955,1,74174,36778,37829
12335804,12335795,TXFE7,128,9955,1,74175,36779,37830
12340567,12340562,TXFE7,128,9954,10,74185,36783,37834
12342004,12341993,TXFE7,128,9955,1,74186,36784,37835
12342342,12342331,TXFE7,128,9955,2,74188,36785,37837
12342692,12342680,TXFE7,128,9955,1,74189,36786,37838
12343354,12343348,TXFE7,128,9955,2,74191,36787,37839
12343579,12343576,TXFE7,128,9955,4,74195,36788,37843
12344179,12344177,TXFE7,128,9955,1,74196,36789,37844
12344379,12344368,TXFE7,128,9955,3,74199,36790,37847
12344392,12344383,TXFE7,128,9954,4,74203,36793,37848
12344529,12344519,TXFE7,128,9955,5,74208,36794,37853
12344542,12344538,TXFE7,128,9955,5,74213,36795,37856
12344567,12344566,TXFE7,128,9955,3,74216,36796,37857
12345079,12345075,TXFE7,128,9955,1,74217,36797,37858
12345854,12345847,TXFE7,128,9955,5,74222,36798,37862
12345892,12345883,TXFE7,128,9954,1,74223,36799,37863
12345917,12345912,TXFE7,128,9955,2,74225,36800,37864
12350029,12350024,TXFE7,128,9955,1,74226,36801,37865
12350042,12350033,TXFE7,128,9955,5,74231,36802,37869
12350104,12350102,TXFE7,128,9955,1,74232,36803,37870
12350154,12350147,TXFE7,128,9954,1,74233,36804,37871
12350367,12350355,TXFE7,128,9955,5,74238,36805,37876
12350417,12350405,TXFE7,128,9955,1,74239,36806,37877
12350554,12350553,TXFE7,128,9954,6,74245,36807,37878
12351067,12351061,TXFE7,128,9955,3,74248,36808,37880
12351079,12351070,TXFE7,128,9955,2,74250,36809,37881
12352179,12352167,TXFE7,128,9955,1,74251,36810,37882
12352392,12352390,TXFE7,128,9955,2,74253,36811,37884
12352729,12352725,TXFE7,128,9955,1,74254,36812,37885
12353092,12353089,TXFE7,128,9955,4,74258,36813,37886
12353542,12353531,TXFE7,128,9954,1,74259,36814,37887
12354117,12354107,TXFE7,128,9954,1,74260,36815,37888
12354342,12354331,TXFE7,128,9954,1,74261,36816,37889
12355792,12355788,TXFE7,128,9954,10,74271,36822,37890
12360167,12360156,TXFE7,128,9954,1,74272,36823,37891
12360304,12360294,TXFE7,128,9954,1,74273,36824,37892
12360829,12360828,TXFE7,128,9954,3,74276,36826,37893
12360892,12360890,TXFE7,128,9954,1,74277,36827,37894
12360967,12360965,TXFE7,128,9954,1,74278,36828,37895
12361104,12361097,TXFE7,128,9954,5,74283,36831,37896
12361154,12361154,TXFE7,128,9954,2,74285,36832,37897
12361279,12361272,TXFE7,128,9954,1,74286,36833,37898
12361404,12361403,TXFE7,128,9954,1,74287,36834,37899
12361679,12361670,TXFE7,128,9954,2,74289,36835,37900
12362204,12362201,TXFE7,128,9954,1,74290,36836,37901
12362329,12362317,TXFE7,128,9954,1,74291,36837,37902
12362354,12362351,TXFE7,128,9954,40,74331,36860,37903
12362367,12362354,TXFE7,128,9954,1,74332,36861,37904
12362429,12362421,TXFE7,128,9953,1,74333,36862,37905
12362492,12362484,TXFE7,128,9953,2,74335,36863,37906
12362654,12362646,TXFE7,128,9953,1,74336,36864,37907
12362742,12362736,TXFE7,128,9953,1,74337,36865,37908
12362967,12362958,TXFE7,128,9953,1,74338,36866,37909
12364529,12364520,TXFE7,128,9953,1,74339,36867,37910
12365117,12365113,TXFE7,128,9954,1,74340,36868,37911
12365654,12365646,TXFE7,128,9954,2,74342,36869,37912
12370342,12370338,TXFE7,128,9953,1,74343,36870,37913
12370667,12370657,TXFE7,128,9954,1,74344,36871,37914
12371129,12371121,TXFE7,128,9953,5,74349,36872,37915
12373404,12373392,TXFE7,128,9954,45,74394,36873,37949
12373404,12373392,TXFE7,128,9954,2,74396,36874,37951
12374442,12374441,TXFE7,128,9954,1,74397,36875,37952
12374792,12374782,TXFE7,128,9954,4,74401,36876,37953
12374917,12374908,TXFE7,128,9955,4,74405,36877,37956
12374929,12374922,TXFE7,128,9955,4,74409,36878,37959
12374942,12374930,TXFE7,128,9955,39,74448,36879,37982
12374954,12374942,TXFE7,128,9955,1,74449,36880,37983
12374954,12374942,TXFE7,128,9955,34,74483,36881,38008
12374954,12374946,TXFE7,128,9956,28,74511,36882,38024
12374967,12374955,TXFE7,128,9956,13,74524,36883,38032
12374979,12374970,TXFE7,128,9956,4,74528,36884,38033
12374992,12374981,TXFE7,128,9956,1,74529,36885,38034
12374992,12374985,TXFE7,128,9956,24,74553,36886,38042
12375004,12374994,TXFE7,128,9956,1,74554,36887,38043
12375029,12375021,TXFE7,128,9956,2,74556,36888,38045
12375029,12375024,TXFE7,128,9955,4,74560,36890,38046
12375079,12375076,TXFE7,128,9956,3,74563,36891,38047
12375167,12375161,TXFE7,128,9956,7,74570,36892,38054
12375217,12375207,TXFE7,128,9955,1,74571,36893,38055
12375267,12375262,TXFE7,128,9955,12,74583,36898,38060
12375292,12375284,TXFE7,128,9955,1,74584,36899,38061
12375467,12375459,TXFE7,128,9955,1,74585,36900,38062
12375504,12375503,TXFE7,128,9954,2,74587,36901,38063
12375529,12375520,TXFE7,128,9955,1,74588,36902,38064
12375542,12375537,TXFE7,128,9955,1,74589,36903,38065
12375667,12375665,TXFE7,128,9955,1,74590,36904,38066
12375679,12375677,TXFE7,128,9955,3,74593,36905,38067
12375954,12375946,TXFE7,128,9956,1,74594,36906,38068
12380054,12380048,TXFE7,128,9955,1,74595,36907,38069
12380067,12380055,TXFE7,128,9955,1,74596,36908,38070
12380179,12380172,TXFE7,128,9955,1,74597,36909,38071
12380254,12380245,TXFE7,128,9955,1,74598,36910,38072
12380642,12380641,TXFE7,128,9955,2,74600,36911,38073
12380842,12380830,TXFE7,128,9955,4,74604,36912,38074
12380854,12380845,TXFE7,128,9955,2,74606,36913,38076
12380867,12380858,TXFE7,128,9954,10,74616,36918,38081
12380929,12380920,TXFE7,128,9955,10,74626,36919,38088
12380942,12380938,TXFE7,128,9955,1,74627,36920,38089
12381029,12381028,TXFE7,128,9955,4,74631,36921,38092
12381054,12381044,TXFE7,128,9955,1,74632,36922,38093
12381067,12381055,TXFE7,128,9955,5,74637,36923,38094
12381079,12381070,TXFE7,128,9955,10,74647,36924,38096
12381117,12381117,TXFE7,128,9955,5,74652,36925,38097
12381267,12381256,TXFE7,128,9956,1,74653,36926,38098
12381404,12381394,TXFE7,128,9955,1,74654,36927,38099
12381542,12381533,TXFE7,128,9955,9,74663,36932,38104
12381567,12381554,TXFE7,128,9955,1,74664,36933,38105
12381567,12381555,TXFE7,128,9955,10,74674,36937,38106
12381792,12381785,TXFE7,128,9955,2,74676,36938,38108
12381942,12381933,TXFE7,128,9954,1,74677,36939,38109
12381954,12381942,TXFE7,128,9954,1,74678,36940,38110
12381954,12381950,TXFE7,128,9954,1,74679,36941,38111
12381954,12381953,TXFE7,128,9954,1,74680,36942,38112
12381979,12381971,TXFE7,128,9955,1,74681,36943,38113
12381992,12381986,TXFE7,128,9955,1,74682,36944,38114
12382104,12382092,TXFE7,128,9954,4,74686,36946,38115
12382379,12382371,TXFE7,128,9955,1,74687,36947,38116
12382392,12382379,TXFE7,128,9955,4,74691,36948,38120
12382404,12382392,TXFE7,128,9955,3,74694,36949,38121
12382604,12382598,TXFE7,128,9955,1,74695,36950,38122
12382717,12382706,TXFE7,128,9956,1,74696,36951,38123
12382754,12382742,TXFE7,128,9956,1,74697,36952,38124
12382829,12382822,TXFE7,128,9956,1,74698,36953,38125
12382854,12382842,TXFE7,128,9956,1,74699,36954,38126
12382867,12382864,TXFE7,128,9956,1,74700,36955,38127
12382904,12382896,TXFE7,128,9955,1,74701,36956,38128
12382904,12382901,TXFE7,128,9956,3,74704,36957,38129
12382942,12382938,TXFE7,128,9955,1,74705,36958,38130
12382967,12382961,TXFE7,128,9956,1,74706,36959,38131
12383054,12383051,TXFE7,128,9956,1,74707,36960,38132
12383079,12383070,TXFE7,128,9955,1,74708,36961,38133
12383104,12383094,TXFE7,128,9956,1,74709,36962,38134
12383167,12383155,TXFE7,128,9956,1,74710,36963,38135
12383229,12383218,TXFE7,128,9956,1,74711,36964,38136
12383292,12383280,TXFE7,128,9956,1,74712,36965,38137
12383304,12383296,TXFE7,128,9956,1,74713,36966,38138
12383317,12383310,TXFE7,128,9955,1,74714,36967,38139
12383342,12383342,TXFE7,128,9956,1,74715,36968,38140
12383392,12383383,TXFE7,128,9956,1,74716,36969,38141
12383429,12383423,TXFE7,128,9956,1,74717,36970,38142
12383479,12383471,TXFE7,128,9956,1,74718,36971,38143
12383529,12383527,TXFE7,128,9956,1,74719,36972,38144
12383592,12383589,TXFE7,128,9956,1,74720,36973,38145
12383642,12383636,TXFE7,128,9955,1,74721,36974,38146
12383679,12383667,TXFE7,128,9956,1,74722,36975,38147
12383754,12383744,TXFE7,128,9956,1,74723,36976,38148
12383867,12383857,TXFE7,128,9956,1,74724,36977,38149
12383904,12383900,TXFE7,128,9956,1,74725,36978,38150
12384017,12384011,TXFE7,128,9956,1,74726,36979,38151
12384117,12384104,TXFE7,128,9956,8,74734,36980,38157
12384117,12384104,TXFE7,128,9956,1,74735,36981,38158
12384117,12384104,TXFE7,128,9956,1,74736,36982,38159
12384129,12384117,TXFE7,128,9956,4,74740,36983,38162
12384129,12384117,TXFE7,128,9956,6,74746,36984,38164
12384129,12384117,TXFE7,128,9956,10,74756,36985,38169
12384142,12384138,TXFE7,128,9956,1,74757,36986,38170
12384142,12384140,TXFE7,128,9956,1,74758,36987,38171
12384167,12384165,TXFE7,128,9957,1,74759,36988,38172
12384179,12384167,TXFE7,128,9957,1,74760,36989,38173
12384179,12384171,TXFE7,128,9957,3,74763,36990,38176
12384192,12384181,TXFE7,128,9957,2,74765,36991,38177
12384204,12384196,TXFE7,128,9957,2,74767,36992,38179
12384229,12384220,TXFE7,128,9957,1,74768,36993,38180
12384254,12384247,TXFE7,128,9957,2,74770,36994,38182
12384279,12384268,TXFE7,128,9957,1,74771,36995,38183
12384292,12384284,TXFE7,128,9957,10,74781,36996,38186
12384342,12384336,TXFE7,128,9957,1,74782,36997,38187
12384354,12384352,TXFE7,128,9956,3,74785,37000,38188
12384367,12384360,TXFE7,128,9956,4,74789,37002,38189
12384429,12384418,TXFE7,128,9957,1,74790,37003,38190
12384517,12384516,TXFE7,128,9957,1,74791,37004,38191
12384617,12384612,TXFE7,128,9957,1,74792,37005,38192
12384629,12384619,TXFE7,128,9956,1,74793,37006,38193
12384629,12384620,TXFE7,128,9957,10,74803,37007,38196
12384642,12384633,TXFE7,128,9956,1,74804,37008,38197
12384667,12384662,TXFE7,128,9956,1,74805,37009,38198
12384704,12384704,TXFE7,128,9957,1,74806,37010,38199
12384817,12384805,TXFE7,128,9956,1,74807,37011,38200
12384817,12384806,TXFE7,128,9957,1,74808,37012,38201
12384879,12384875,TXFE7,128,9956,1,74809,37013,38202
12384942,12384933,TXFE7,128,9957,1,74810,37014,38203
12385017,12385014,TXFE7,128,9957,1,74811,37015,38204
12385142,12385137,TXFE7,128,9957,1,74812,37016,38205
12385167,12385156,TXFE7,128,9956,1,74813,37017,38206
12385179,12385173,TXFE7,128,9956,1,74814,37018,38207
12385192,12385188,TXFE7,128,9956,1,74815,37019,38208
12385217,12385215,TXFE7,128,9956,1,74816,37020,38209
12385254,12385247,TXFE7,128,9957,1,74817,37021,38210
12385292,12385281,TXFE7,128,9956,4,74821,37025,38211
12385317,12385315,TXFE7,128,9956,1,74822,37026,38212
12385329,12385323,TXFE7,128,9956,1,74823,37027,38213
12385404,12385393,TXFE7,128,9957,1,74824,37028,38214
12385454,12385450,TXFE7,128,9956,1,74825,37029,38215
12385654,12385647,TXFE7,128,9956,1,74826,37030,38216
12385729,12385722,TXFE7,128,9956,1,74827,37031,38217
12385842,12385842,TXFE7,128,9957,4,74831,37032,38218
12385879,12385872,TXFE7,128,9957,1,74832,37033,38219
12390004,12385993,TXFE7,128,9956,1,74833,37034,38220
12390017,12390005,TXFE7,128,9957,1,74834,37035,38221
12390017,12390007,TXFE7,128,9957,1,74835,37036,38222
12390054,12390049,TXFE7,128,9957,1,74836,37037,38223
12390217,12390206,TXFE7,128,9956,1,74837,37038,38224
12390217,12390206,TXFE7,128,9956,1,74838,37039,38225
12390217,12390212,TXFE7,128,9956,1,74839,37040,38226
12390254,12390250,TXFE7,128,9957,1,74840,37041,38227
12390267,12390256,TXFE7,128,9957,1,74841,37042,38228
12390292,12390280,TXFE7,128,9957,3,74844,37043,38229
12390379,12390377,TXFE7,128,9957,1,74845,37044,38230
12390767,12390763,TXFE7,128,9956,1,74846,37045,38231
12390829,12390822,TXFE7,128,9956,1,74847,37046,38232
12390892,12390884,TXFE7,128,9956,1,74848,37047,38233
12391029,12391022,TXFE7,128,9956,5,74853,37052,38234
12391067,12391064,TXFE7,128,9956,3,74856,37053,38235
12391417,12391416,TXFE7,128,9956,1,74857,37054,38236
12391542,12391542,TXFE7,128,9956,5,74862,37055,38238
12391704,12391697,TXFE7,128,9955,1,74863,37056,38239
12392679,12392679,TXFE7,128,9956,1,74864,37057,38240
12392704,12392695,TXFE7,128,9955,1,74865,37058,38241
12393429,12393422,TXFE7,128,9956,1,74866,37059,38242
12393729,12393726,TXFE7,128,9955,2,74868,37060,38243
12395054,12395050,TXFE7,128,9955,1,74869,37061,38244
12395429,12395419,TXFE7,128,9955,25,74894,37067,38245
12395442,12395432,TXFE7,128,9955,1,74895,37068,38246
12395679,12395668,TXFE7,128,9956,1,74896,37069,38247
12395792,12395781,TXFE7,128,9955,30,74926,37083,38248
12395804,12395792,TXFE7,128,9955,4,74930,37084,38249
12395804,12395796,TXFE7,128,9955,1,74931,37085,38250
12395804,12395796,TXFE7,128,9955,2,74933,37087,38251
12395929,12395927,TXFE7,128,9954,1,74934,37088,38252
12395979,12395975,TXFE7,128,9954,1,74935,37089,38253
12395979,12395977,TXFE7,128,9954,1,74936,37090,38254
12400167,12400166,TXFE7,128,9955,3,74939,37091,38257
12400229,12400229,TXFE7,128,9955,1,74940,37092,38258
12400242,12400231,TXFE7,128,9955,4,74944,37093,38262
12400342,12400332,TXFE7,128,9955,1,74945,37094,38263
12400442,12400433,TXFE7,128,9955,1,74946,37095,38264
12400442,12400433,TXFE7,128,9955,4,74950,37096,38268
12400642,12400638,TXFE7,128,9955,1,74951,37097,38269
12401042,12401036,TXFE7,128,9955,1,74952,37098,38270
12401304,12401300,TXFE7,128,9955,1,74953,37099,38271
12401529,12401520,TXFE7,128,9955,1,74954,37100,38272
12401779,12401768,TXFE7,128,9955,1,74955,37101,38273
12401967,12401964,TXFE7,128,9955,2,74957,37102,38275
12402017,12402014,TXFE7,128,9955,1,74958,37103,38276
12402142,12402137,TXFE7,128,9955,1,74959,37104,38277
12402529,12402519,TXFE7,128,9955,1,74960,37105,38278
12402629,12402617,TXFE7,128,9955,1,74961,37106,38279
12403054,12403045,TXFE7,128,9955,1,74962,37107,38280
12403354,12403351,TXFE7,128,9955,1,74963,37108,38281
12403542,12403539,TXFE7,128,9956,2,74965,37109,38282
12403729,12403722,TXFE7,128,9955,1,74966,37110,38283
12404167,12404155,TXFE7,128,9955,1,74967,37111,38284
12404167,12404165,TXFE7,128,9955,1,74968,37112,38285
12404642,12404631,TXFE7,128,9955,2,74970,37113,38287
12404892,12404887,TXFE7,128,9954,1,74971,37114,38288
12405317,12405312,TXFE7,128,9955,1,74972,37115,38289
12405904,12405899,TXFE7,128,9954,1,74973,37116,38290
12405942,12405937,TXFE7,128,9954,1,74974,37117,38291
12405942,12405937,TXFE7,128,9954,2,74976,37118,38292
12405954,12405942,TXFE7,128,9954,15,74991,37124,38293
12405954,12405942,TXFE7,128,9954,3,74994,37125,38294
12405954,12405942,TXFE7,128,9954,1,74995,37126,38295
12405954,12405942,TXFE7,128,9954,2,74997,37127,38296
12405954,12405942,TXFE7,128,9954,1,74998,37128,38297
12405954,12405942,TXFE7,128,9954,1,74999,37129,38298
12405967,12405954,TXFE7,128,9954,2,75001,37130,38299
12405967,12405954,TXFE7,128,9954,4,75005,37134,38300
12405967,12405954,TXFE7,128,9954,1,75006,37135,38301
12405967,12405954,TXFE7,128,9954,1,75007,37136,38302
12405967,12405954,TXFE7,128,9954,2,75009,37138,38303
12405967,12405955,TXFE7,128,9954,7,75016,37145,38304
12410004,12405997,TXFE7,128,9954,1,75017,37146,38305
12410004,12405997,TXFE7,128,9954,1,75018,37147,38306
12410017,12410017,TXFE7,128,9955,1,75019,37148,38307
12410054,12410043,TXFE7,128,9954,2,75021,37149,38308
12410067,12410057,TXFE7,128,9955,1,75022,37150,38309
12410079,12410077,TXFE7,128,9955,12,75034,37151,38317
12410229,12410225,TXFE7,128,9955,3,75037,37152,38318
12410529,12410528,TXFE7,128,9955,1,75038,37153,38319
12410542,12410539,TXFE7,128,9956,1,75039,37154,38320
12410542,12410540,TXFE7,128,9956,1,75040,37155,38321
12410554,12410543,TXFE7,128,9956,1,75041,37156,38322
12410567,12410559,TXFE7,128,9955,1,75042,37157,38323
12411042,12411040,TXFE7,128,9955,1,75043,37158,38324
12411254,12411253,TXFE7,128,9955,1,75044,37159,38325
12411579,12411567,TXFE7,128,9955,3,75047,37162,38328
12411742,12411731,TXFE7,128,9955,1,75048,37163,38329
12412242,12412232,TXFE7,128,9955,1,75049,37164,38330
12412654,12412647,TXFE7,128,9955,1,75050,37165,38331
12412904,12412899,TXFE7,128,9955,1,75051,37166,38332
12413354,12413354,TXFE7,128,9955,1,75052,37167,38333
12413542,12413539,TXFE7,128,9955,1,75053,37168,38334
12414292,12414281,TXFE7,128,9955,1,75054,37169,38335
12414517,12414507,TXFE7,128,9955,1,75055,37170,38336
12414667,12414658,TXFE7,128,9955,1,75056,37171,38337
12414717,12414708,TXFE7,128,9955,1,75057,37172,38338
12414854,12414842,TXFE7,128,9955,1,75058,37173,38339
12415854,12415845,TXFE7,128,9956,1,75059,37174,38340
12420054,12420052,TXFE7,128,9956,1,75060,37175,38341
12420092,12420090,TXFE7,128,9955,1,75061,37176,38342
12420279,12420279,TXFE7,128,9955,1,75062,37177,38343
12420454,12420450,TXFE7,128,9955,1,75063,37178,38344
12421529,12421526,TXFE7,128,9955,1,75064,37179,38345
12421717,12421714,TXFE7,128,9955,1,75065,37180,38346
12421729,12421724,TXFE7,128,9955,1,75066,37181,38347
12422042,12422041,TXFE7,128,9955,1,75067,37182,38348
12423142,12423140,TXFE7,128,9955,1,75068,37183,38349
12424054,12424050,TXFE7,128,9955,1,75069,37184,38350
12424592,12424589,TXFE7,128,9955,5,75074,37189,38351
12424767,12424755,TXFE7,128,9955,2,75076,37190,38352
12424767,12424757,TXFE7,128,9955,1,75077,37191,38353
12430317,12430306,TXFE7,128,9955,3,75080,37192,38354
12430479,12430478,TXFE7,128,9955,1,75081,37193,38355
12430692,12430688,TXFE7,128,9955,1,75082,37194,38356
12432542,12432531,TXFE7,128,9955,1,75083,37195,38357
12432692,12432689,TXFE7,128,9955,1,75084,37196,38358
12432892,12432882,TXFE7,128,9956,1,75085,37197,38359
12433329,12433328,TXFE7,128,9956,1,75086,37198,38360
12433817,12433811,TXFE7,128,9955,1,75087,37199,38361
12434517,12434510,TXFE7,128,9955,1,75088,37200,38362
12434529,12434518,TXFE7,128,9955,1,75089,37201,38363
12434567,12434558,TXFE7,128,9955,1,75090,37202,38364
12434654,12434652,TXFE7,128,9956,10,75100,37203,38369
12434704,12434697,TXFE7,128,9956,10,75110,37204,38370
12434979,12434974,TXFE7,128,9955,1,75111,37205,38371
12435717,12435712,TXFE7,128,9955,1,75112,37206,38372
12435992,12435987,TXFE7,128,9955,1,75113,37207,38373
12440079,12440072,TXFE7,128,9955,1,75114,37208,38374
12440142,12440138,TXFE7,128,9955,1,75115,37209,38375
12440617,12440608,TXFE7,128,9955,1,75116,37210,38376
12441317,12441316,TXFE7,128,9955,5,75121,37211,38377
12441592,12441586,TXFE7,128,9955,11,75132,37214,38380
12442279,12442270,TXFE7,128,9955,1,75133,37215,38381
12443942,12443935,TXFE7,128,9955,1,75134,37216,38382
12444004,12443997,TXFE7,128,9955,1,75135,37217,38383
12444254,12444248,TXFE7,128,9955,1,75136,37218,38384
12444354,12444343,TXFE7,128,9955,1,75137,37219,38385
12445604,12445601,TXFE7,128,9955,1,75138,37220,38386
12445742,12445742,TXFE7,128,9956,4,75142,37221,38387
12445904,12445902,TXFE7,128,9955,4,75146,37222,38388
12445904,12445903,TXFE7,128,9955,4,75150,37223,38389
12445904,12445904,TXFE7,128,9955,4,75154,37226,38390
12445917,12445906,TXFE7,128,9955,4,75158,37227,38391
12445917,12445908,TXFE7,128,9955,3,75161,37229,38392
12450642,12450641,TXFE7,128,9956,20,75181,37230,38407
12450654,12450654,TXFE7,128,9955,2,75183,37231,38408
12450679,12450671,TXFE7,128,9956,1,75184,37232,38409
12450692,12450682,TXFE7,128,9955,10,75194,37238,38410
12450692,12450688,TXFE7,128,9956,8,75202,37239,38412
12450692,12450689,TXFE7,128,9955,2,75204,37241,38413
12450717,12450706,TXFE7,128,9955,1,75205,37242,38414
12450717,12450714,TXFE7,128,9955,2,75207,37243,38415
12451179,12451175,TXFE7,128,9955,1,75208,37244,38416
12451504,12451499,TXFE7,128,9955,2,75210,37246,38417
12451904,12451894,TXFE7,128,9956,1,75211,37247,38418
12451904,12451894,TXFE7,128,9956,1,75212,37248,38419
12451917,12451904,TXFE7,128,9956,3,75215,37249,38422
12451917,12451904,TXFE7,128,9956,10,75225,37250,38430
12451917,12451907,TXFE7,128,9956,1,75226,37251,38431
12451929,12451917,TXFE7,128,9956,2,75228,37252,38432
12452429,12452424,TXFE7,128,9956,1,75229,37253,38433
12452517,12452514,TXFE7,128,9956,1,75230,37254,38434
12452892,12452889,TXFE7,128,9956,1,75231,37255,38435
12453029,12453025,TXFE7,128,9956,1,75232,37256,38436
12453367,12453358,TXFE7,128,9955,1,75233,37257,38437
12453717,12453713,TXFE7,128,9955,2,75235,37258,38438
12453854,12453845,TXFE7,128,9955,2,75237,37260,38439
12454442,12454433,TXFE7,128,9955,2,75239,37262,38440
12454604,12454593,TXFE7,128,9955,1,75240,37263,38441
12454604,12454593,TXFE7,128,9955,4,75244,37266,38442
12454604,12454593,TXFE7,128,9955,6,75250,37270,38443
12454604,12454593,TXFE7,128,9955,1,75251,37271,38444
12454604,12454593,TXFE7,128,9955,1,75252,37272,38445
12454604,12454593,TXFE7,128,9955,1,75253,37273,38446
12454604,12454593,TXFE7,128,9955,9,75262,37282,38447
12454617,12454605,TXFE7,128,9954,1,75263,37283,38448
12454629,12454617,TXFE7,128,9954,13,75276,37289,38449
12454642,12454630,TXFE7,128,9955,1,75277,37290,38450
12454929,12454920,TXFE7,128,9955,1,75278,37291,38451
12455129,12455119,TXFE7,128,9955,2,75280,37292,38453
12455142,12455135,TXFE7,128,9955,5,75285,37293,38458
12455204,12455201,TXFE7,128,9955,2,75287,37295,38459
12455229,12455218,TXFE7,128,9955,1,75288,37296,38460
12455392,12455388,TXFE7,128,9955,1,75289,37297,38461
12455579,12455574,TXFE7,128,9955,1,75290,37298,38462
12460042,12460032,TXFE7,128,9954,1,75291,37299,38463
12460117,12460104,TXFE7,128,9954,1,75292,37300,38464
12460517,12460515,TXFE7,128,9954,1,75293,37301,38465
12461154,12461142,TXFE7,128,9955,4,75297,37302,38468
12461154,12461142,TXFE7,128,9955,1,75298,37303,38469
12461167,12461154,TXFE7,128,9955,1,75299,37304,38470
12461167,12461154,TXFE7,128,9955,4,75303,37305,38472
12461179,12461167,TXFE7,128,9955,1,75304,37306,38473
12461179,12461167,TXFE7,128,9955,6,75310,37307,38477
12461179,12461172,TXFE7,128,9955,1,75311,37308,38478
12461192,12461179,TXFE7,128,9955,1,75312,37309,38479
12461192,12461179,TXFE7,128,9955,2,75314,37310,38480
12461192,12461179,TXFE7,128,9955,1,75315,37311,38481
12461192,12461179,TXFE7,128,9955,1,75316,37312,38482
12461192,12461184,TXFE7,128,9955,1,75317,37313,38483
12461279,12461272,TXFE7,128,9954,5,75322,37317,38484
12462342,12462333,TXFE7,128,9954,15,75337,37324,38485
12465042,12465036,TXFE7,128,9955,1,75340,37327,38488
12465979,12465968,TXFE7,128,9954,25,75365,37340,38489
12465992,12465979,TXFE7,128,9954,2,75367,37341,38490
12470029,12470019,TXFE7,128,9954,2,75369,37343,38491
12470242,12470242,TXFE7,128,9953,1,75370,37344,38492
12470254,12470251,TXFE7,128,9953,3,75373,37346,38493
12470292,12470286,TXFE7,128,9953,2,75375,37347,38494
12470304,12470298,TXFE7,128,9953,1,75376,37348,38495
12470317,12470306,TXFE7,128,9953,1,75377,37349,38496
12470817,12470817,TXFE7,128,9954,1,75378,37350,38497
12471479,12471473,TXFE7,128,9953,1,75379,37351,38498
12471742,12471736,TXFE7,128,9953,10,75389,37353,38499
12472642,12472636,TXFE7,128,9954,1,75390,37354,38500
12472754,12472750,TXFE7,128,9953,1,75391,37355,38501
12472904,12472895,TXFE7,128,9954,1,75392,37356,38502
12472954,12472945,TXFE7,128,9954,1,75393,37357,38503
12472967,12472962,TXFE7,128,9953,1,75394,37358,38504
12473104,12473099,TXFE7,128,9953,1,75395,37359,38505
12473142,12473134,TXFE7,128,9954,1,75396,37360,38506
12473417,12473417,TXFE7,128,9954,32,75428,37361,38520
12473429,12473417,TXFE7,128,9954,1,75429,37362,38521
12473579,12473567,TXFE7,128,9954,2,75431,37364,38522
12473579,12473573,TXFE7,128,9955,1,75432,37365,38523
12474092,12474084,TXFE7,128,9955,2,75434,37366,38524
12474804,12474803,TXFE7,128,9954,1,75435,37367,38525
12475042,12475040,TXFE7,128,9955,3,75438,37368,38527
12475142,12475136,TXFE7,128,9954,1,75439,37369,38528
12475154,12475148,TXFE7,128,9955,3,75442,37370,38531
12475229,12475229,TXFE7,128,9955,1,75443,37371,38532
12480329,12480324,TXFE7,128,9955,3,75446,37372,38533
12480404,12480401,TXFE7,128,9955,1,75447,37373,38534
12480442,12480438,TXFE7,128,9954,2,75449,37375,38535
12480554,12480543,TXFE7,128,9955,1,75450,37376,38536
12480704,12480692,TXFE7,128,9954,1,75451,37377,38537
12480704,12480696,TXFE7,128,9954,1,75452,37378,38538
12480717,12480704,TXFE7,128,9954,2,75454,37379,38539
12480717,12480704,TXFE7,128,9954,1,75455,37380,38540
12480729,12480717,TXFE7,128,9954,1,75456,37381,38541
12480742,12480729,TXFE7,128,9954,1,75457,37382,38542
12480792,12480784,TXFE7,128,9955,3,75460,37383,38543
12481392,12481385,TXFE7,128,9954,1,75461,37384,38544
12481592,12481583,TXFE7,128,9954,7,75468,37390,38550
12482629,12482625,TXFE7,128,9954,1,75469,37391,38551
12483004,12482999,TXFE7,128,9953,1,75470,37392,38552
12483329,12483324,TXFE7,128,9953,1,75471,37393,38553
12483742,12483735,TXFE7,128,9953,2,75473,37394,38554
12484104,12484093,TXFE7,128,9953,1,75474,37395,38555
12485154,12485143,TXFE7,128,9953,1,75475,37396,38556
12485429,12485421,TXFE7,128,9954,1,75476,37397,38557
12485942,12485930,TXFE7,128,9953,1,75477,37398,38558
12490292,12490285,TXFE7,128,9954,1,75478,37399,38559
12490317,12490312,TXFE7,128,9953,1,75479,37400,38560
12490354,12490345,TXFE7,128,9954,2,75481,37401,38562
12490529,12490517,TXFE7,128,9954,20,75501,37402,38570
12490542,12490529,TXFE7,128,9954,2,75503,37403,38571
12490579,12490567,TXFE7,128,9954,1,75504,37404,38572
12490654,12490654,TXFE7,128,9954,2,75506,37405,38573
12491342,12491336,TXFE7,128,9954,3,75509,37406,38575
12491379,12491371,TXFE7,128,9954,1,75510,37407,38576
12492054,12492049,TXFE7,128,9954,1,75511,37408,38577
12492054,12492051,TXFE7,128,9953,1,75512,37409,38578
12493854,12493850,TXFE7,128,9954,4,75516,37410,38579
12494529,12494523,TXFE7,128,9954,1,75517,37411,38580
12494829,12494824,TXFE7,128,9953,1,75518,37412,38581
12500292,12500288,TXFE7,128,9953,1,75519,37413,38582
12500329,12500319,TXFE7,128,9953,1,75520,37414,38583
12500354,12500348,TXFE7,128,9954,10,75530,37415,38585
12500354,12500348,TXFE7,128,9954,6,75536,37416,38590
12500554,12500550,TXFE7,128,9954,1,75537,37417,38591
12500704,12500697,TXFE7,128,9954,1,75538,37418,38592
12500879,12500870,TXFE7,128,9953,1,75539,37419,38593
12501542,12501535,TXFE7,128,9953,1,75540,37420,38594
12501617,12501616,TXFE7,128,9954,1,75541,37421,38595
12501754,12501745,TXFE7,128,9953,1,75542,37422,38596
12502079,12502078,TXFE7,128,9953,1,75543,37423,38597
12502104,12502099,TXFE7,128,9953,2,75545,37424,38598
12502117,12502110,TXFE7,128,9953,2,75547,37425,38599
12502129,12502118,TXFE7,128,9953,4,75551,37426,38600
12503142,12503141,TXFE7,128,9953,1,75552,37427,38601
12503392,12503388,TXFE7,128,9953,3,75555,37429,38602
12504092,12504079,TXFE7,128,9954,7,75562,37430,38609
12504142,12504130,TXFE7,128,9953,1,75563,37431,38610
12504867,12504862,TXFE7,128,9953,1,75564,37432,38611
12505029,12505026,TXFE7,128,9954,1,75565,37433,38612
12505067,12505054,TXFE7,128,9953,4,75569,37437,38613
12505067,12505054,TXFE7,128,9953,4,75573,37441,38614
12505079,12505067,TXFE7,128,9953,2,75575,37443,38615
12505079,12505067,TXFE7,128,9953,1,75576,37444,38616
12505079,12505067,TXFE7,128,9953,1,75577,37445,38617
12505267,12505261,TXFE7,128,9954,1,75578,37446,38618
12505379,12505369,TXFE7,128,9953,1,75579,37447,38619
12505629,12505620,TXFE7,128,9953,1,75580,37448,38620
12505717,12505707,TXFE7,128,9954,1,75581,37449,38621
12505817,12505804,TXFE7,128,9953,2,75583,37451,38622
12510267,12510254,TXFE7,128,9953,7,75590,37458,38623
12510267,12510254,TXFE7,128,9953,1,75591,37459,38624
12510292,12510283,TXFE7,128,9953,4,75595,37462,38625
12510304,12510294,TXFE7,128,9953,2,75597,37463,38626
12510579,12510568,TXFE7,128,9954,1,75598,37464,38627
12510817,12510807,TXFE7,128,9953,1,75599,37465,38628
12511092,12511091,TXFE7,128,9954,1,75600,37466,38629
12511092,12511091,TXFE7,128,9954,4,75604,37467,38632
12511092,12511091,TXFE7,128,9954,2,75606,37468,38634
12511142,12511130,TXFE7,128,9954,2,75608,37469,38635
12511467,12511454,TXFE7,128,9954,5,75613,37470,38636
12511467,12511454,TXFE7,128,9954,1,75614,37471,38637
12511817,12511804,TXFE7,128,9954,4,75618,37472,38640
12512704,12512700,TXFE7,128,9954,4,75622,37473,38644
12513267,12513265,TXFE7,128,9954,1,75623,37474,38645
12513429,12513417,TXFE7,128,9953,4,75627,37476,38646
12513829,12513817,TXFE7,128,9953,2,75629,37477,38647
12515229,12515227,TXFE7,128,9953,1,75630,37478,38648
12520004,12515993,TXFE7,128,9953,1,75631,37479,38649
12520792,12520779,TXFE7,128,9954,16,75647,37480,38662
12520792,12520779,TXFE7,128,9954,1,75648,37481,38663
12520804,12520792,TXFE7,128,9954,1,75649,37482,38664
12520804,12520792,TXFE7,128,9954,1,75650,37483,38665
12520804,12520792,TXFE7,128,9954,1,75651,37484,38666
12520804,12520792,TXFE7,128,9954,4,75655,37485,38667
12520804,12520797,TXFE7,128,9954,13,75668,37486,38671
12520817,12520804,TXFE7,128,9954,6,75674,37488,38672
12520817,12520804,TXFE7,128,9954,2,75676,37489,38673
12520817,12520812,TXFE7,128,9954,1,75677,37490,38674
12520829,12520827,TXFE7,128,9954,1,75678,37491,38675
12520842,12520831,TXFE7,128,9954,1,75679,37492,38676
12520842,12520831,TXFE7,128,9954,1,75680,37493,38677
12520854,12520853,TXFE7,128,9954,3,75683,37496,38678
12520892,12520880,TXFE7,128,9953,2,75685,37497,38679
12521117,12521108,TXFE7,128,9954,1,75686,37498,38680
12521229,12521218,TXFE7,128,9954,1,75687,37499,38681
12521392,12521379,TXFE7,128,9953,2,75689,37501,38682
12521404,12521392,TXFE7,128,9953,4,75693,37505,38683
12521404,12521392,TXFE7,128,9953,34,75727,37527,38684
12521404,12521392,TXFE7,128,9953,2,75729,37528,38685
12521417,12521404,TXFE7,128,9953,4,75733,37530,38686
12521429,12521417,TXFE7,128,9953,2,75735,37531,38688
12521867,12521854,TXFE7,128,9953,3,75738,37532,38690
12521992,12521988,TXFE7,128,9953,2,75740,37533,38691
12521992,12521988,TXFE7,128,9953,2,75742,37535,38692
12522229,12522222,TXFE7,128,9952,1,75743,37536,38693
12522242,12522239,TXFE7,128,9952,1,75744,37537,38694
12522292,12522280,TXFE7,128,9953,1,75745,37538,38695
12522304,12522304,TXFE7,129,9953,1,75747,37540,38696
12522304,12522304,TXFE7,129,9952,1,75747,37540,38696
12522392,12522385,TXFE7,128,9953,3,75750,37541,38699
12522442,12522439,TXFE7,128,9953,1,75751,37542,38700
12522854,12522854,TXFE7,128,9953,1,75752,37543,38701
12523129,12523117,TXFE7,128,9953,1,75753,37544,38702
12523704,12523704,TXFE7,128,9953,1,75754,37545,38703
12523904,12523898,TXFE7,128,9953,1,75755,37546,38704
12524067,12524056,TXFE7,128,9953,1,75756,37547,38705
12524417,12524407,TXFE7,128,9953,1,75757,37548,38706
12524504,12524503,TXFE7,128,9953,6,75763,37549,38707
12524692,12524682,TXFE7,129,9953,7,75771,37550,38710
12524692,12524682,TXFE7,129,9954,1,75771,37550,38710
12525204,12525192,TXFE7,128,9953,1,75772,37551,38711
12525292,12525290,TXFE7,128,9953,2,75774,37552,38712
12525304,12525292,TXFE7,128,9953,4,75778,37553,38714
12525654,12525642,TXFE7,128,9953,1,75779,37554,38715
12525867,12525854,TXFE7,128,9953,1,75780,37555,38716
12530392,12530390,TXFE7,128,9953,1,75781,37556,38717
12532079,12532067,TXFE7,128,9953,12,75793,37567,38718
12532079,12532069,TXFE7,128,9953,1,75794,37568,38719
12532204,12532199,TXFE7,128,9953,1,75795,37569,38720
12532567,12532555,TXFE7,128,9953,1,75796,37570,38721
12533067,12533056,TXFE7,128,9952,1,75797,37571,38722
12533092,12533082,TXFE7,128,9952,2,75799,37573,38723
12533704,12533692,TXFE7,128,9952,1,75800,37574,38724
12534542,12534532,TXFE7,128,9953,8,75808,37575,38726
12534692,12534680,TXFE7,128,9953,2,75810,37576,38727
12535867,12535856,TXFE7,128,9953,1,75811,37577,38728
12540404,12540396,TXFE7,128,9953,2,75813,37578,38730
12540467,12540463,TXFE7,128,9952,2,75815,37579,38731
12540542,12540539,TXFE7,128,9953,3,75818,37580,38732
12541529,12541522,TXFE7,128,9952,100,75918,37631,38733
12541529,12541522,TXFE7,128,9952,2,75920,37633,38734
12541529,12541522,TXFE7,128,9952,10,75930,37638,38735
12541542,12541529,TXFE7,128,9952,2,75932,37640,38736
12541542,12541529,TXFE7,128,9951,5,75937,37642,38737
12541542,12541529,TXFE7,128,9951,1,75938,37643,38738
12541554,12541542,TXFE7,128,9951,1,75939,37644,38739
12541554,12541542,TXFE7,128,9951,1,75940,37645,38740
12541554,12541549,TXFE7,128,9951,2,75942,37647,38741
12541567,12541559,TXFE7,128,9951,1,75943,37648,38742
12541567,12541563,TXFE7,128,9951,2,75945,37650,38743
12541579,12541574,TXFE7,128,9951,1,75946,37651,38744
12541767,12541759,TXFE7,128,9951,1,75947,37652,38745
12541842,12541835,TXFE7,128,9951,1,75948,37653,38746
12541917,12541907,TXFE7,128,9951,1,75949,37654,38747
12542354,12542353,TXFE7,128,9951,1,75951,37656,38749
12542379,12542376,TXFE7,128,9952,1,75952,37657,38750
12542392,12542384,TXFE7,128,9951,1,75953,37658,38751
12542517,12542506,TXFE7,128,9951,1,75954,37659,38752
12542667,12542663,TXFE7,128,9952,1,75955,37660,38753
12542692,12542680,TXFE7,128,9951,1,75956,37661,38754
12543029,12543019,TXFE7,128,9951,1,75957,37662,38755
12543192,12543190,TXFE7,128,9951,1,75958,37663,38756
12543204,12543204,TXFE7,128,9951,1,75959,37664,38757
12543517,12543515,TXFE7,128,9951,1,75960,37665,38758
12543579,12543577,TXFE7,128,9951,1,75961,37666,38759
12543679,12543673,TXFE7,128,9951,1,75962,37667,38760
12543979,12543978,TXFE7,128,9951,1,75963,37668,38761
12543992,12543991,TXFE7,128,9952,10,75973,37669,38762
12544029,12544025,TXFE7,128,9952,5,75978,37670,38766
12544167,12544155,TXFE7,128,9952,1,75979,37671,38767
12544367,12544364,TXFE7,128,9952,1,75980,37672,38768
12544404,12544398,TXFE7,128,9952,1,75981,37673,38769
12544467,12544455,TXFE7,128,9952,8,75989,37674,38775
12544467,12544463,TXFE7,128,9951,3,75992,37677,38776
12544642,12544633,TXFE7,128,9951,1,75993,37678,38777
12545017,12545012,TXFE7,128,9952,1,75994,37679,38778
12545304,12545302,TXFE7,128,9952,2,75996,37680,38780
12545379,12545374,TXFE7,128,9952,1,75997,37681,38781
12545929,12545920,TXFE7,128,9951,1,75998,37682,38782
12550167,12550156,TXFE7,128,9952,1,75999,37683,38783
12550204,12550192,TXFE7,128,9951,2,76001,37685,38784
12550204,12550195,TXFE7,128,9951,1,76002,37686,38785
12550204,12550197,TXFE7,128,9951,1,76003,37687,38786
12550267,12550265,TXFE7,128,9951,3,76006,37689,38787
12550492,12550479,TXFE7,128,9952,1,76007,37690,38788
12550542,12550535,TXFE7,128,9952,2,76009,37691,38789
12550542,12550535,TXFE7,128,9952,2,76011,37692,38790
12550667,12550662,TXFE7,128,9952,1,76012,37693,38791
12550717,12550714,TXFE7,128,9951,2,76014,37694,38792
12550729,12550723,TXFE7,128,9951,1,76015,37695,38793
12550817,12550813,TXFE7,128,9951,8,76023,37700,38794
12550929,12550925,TXFE7,128,9951,25,76048,37709,38795
12550942,12550933,TXFE7,128,9952,1,76049,37710,38796
12551017,12551017,TXFE7,128,9951,3,76052,37711,38797
12551292,12551281,TXFE7,128,9952,2,76054,37712,38798
12551592,12551587,TXFE7,128,9952,1,76055,37713,38799
12551942,12551932,TXFE7,128,9952,1,76056,37714,38800
12552092,12552085,TXFE7,128,9952,1,76057,37715,38801
12552267,12552266,TXFE7,128,9952,1,76058,37716,38802
12552679,12552672,TXFE7,128,9952,1,76059,37717,38803
12552692,12552679,TXFE7,128,9952,1,76060,37718,38804
12552692,12552679,TXFE7,128,9952,4,76064,37719,38806
12552692,12552684,TXFE7,128,9952,2,76066,37720,38807
12552704,12552692,TXFE7,128,9952,1,76067,37721,38808
12552704,12552692,TXFE7,128,9952,3,76070,37722,38810
12552704,12552692,TXFE7,128,9952,2,76072,37723,38811
12552704,12552692,TXFE7,128,9952,1,76073,37724,38812
12552717,12552704,TXFE7,128,9952,3,76076,37725,38814
12552717,12552704,TXFE7,128,9952,3,76079,37726,38817
12552717,12552704,TXFE7,128,9952,2,76081,37727,38819
12552817,12552805,TXFE7,128,9953,1,76082,37728,38820
12553354,12553352,TXFE7,128,9953,1,76083,37729,38821
12554004,12554002,TXFE7,128,9952,1,76084,37730,38822
12554242,12554236,TXFE7,128,9952,2,76086,37732,38823
12554354,12554346,TXFE7,128,9952,2,76088,37733,38824
12554567,12554565,TXFE7,128,9952,2,76090,37735,38825
12554804,12554798,TXFE7,128,9952,2,76092,37736,38826
12555054,12555044,TXFE7,128,9952,2,76094,37737,38827
12555092,12555080,TXFE7,128,9952,2,76096,37739,38828
12555229,12555224,TXFE7,128,9952,5,76101,37741,38829
12555254,12555244,TXFE7,128,9952,2,76103,37742,38830
12555354,12555347,TXFE7,128,9952,1,76104,37743,38831
12555379,12555367,TXFE7,128,9952,1,76105,37744,38832
12555392,12555387,TXFE7,128,9952,1,76106,37745,38833
12555404,12555404,TXFE7,128,9952,1,76107,37746,38834
12555429,12555420,TXFE7,128,9952,1,76108,37747,38835
12555442,12555434,TXFE7,128,9952,1,76109,37748,38836
12555467,12555455,TXFE7,128,9952,1,76110,37749,38837
12555554,12555550,TXFE7,128,9952,1,76111,37750,38838
12555567,12555565,TXFE7,128,9952,1,76112,37751,38839
12555579,12555572,TXFE7,128,9952,1,76113,37752,38840
12555592,12555584,TXFE7,128,9952,1,76114,37753,38841
12555604,12555601,TXFE7,128,9952,1,76115,37754,38842
12555629,12555620,TXFE7,128,9952,1,76116,37755,38843
12555629,12555622,TXFE7,128,9952,2,76118,37756,38844
12555642,12555638,TXFE7,128,9952,1,76119,37757,38845
12555667,12555657,TXFE7,128,9952,1,76120,37758,38846
12555692,12555680,TXFE7,128,9952,1,76121,37759,38847
12555704,12555699,TXFE7,128,9952,1,76122,37760,38848
12555729,12555719,TXFE7,128,9952,1,76123,37761,38849
12555742,12555740,TXFE7,128,9952,1,76124,37762,38850
12555767,12555755,TXFE7,128,9952,1,76125,37763,38851
12555779,12555775,TXFE7,128,9952,1,76126,37764,38852
12555779,12555779,TXFE7,128,9953,2,76128,37765,38854
12555792,12555788,TXFE7,128,9952,1,76129,37766,38855
12555829,12555826,TXFE7,128,9952,2,76131,37768,38856
12555854,12555848,TXFE7,128,9952,2,76133,37769,38857
12555879,12555868,TXFE7,128,9952,2,76135,37770,38858
12555892,12555888,TXFE7,128,9952,2,76137,37772,38859
12555917,12555906,TXFE7,129,9952,1,76139,37774,38860
12555917,12555906,TXFE7,129,9951,1,76139,37774,38860
12555929,12555924,TXFE7,128,9951,2,76141,37775,38861
12555942,12555940,TXFE7,128,9951,2,76143,37776,38862
12560054,12560050,TXFE7,128,9951,1,76144,37777,38863
12560079,12560076,TXFE7,128,9951,1,76145,37778,38864
12560192,12560180,TXFE7,128,9951,1,76146,37779,38865
12560229,12560223,TXFE7,128,9952,1,76147,37780,38866
12560304,12560292,TXFE7,128,9951,1,76148,37781,38867
12560342,12560342,TXFE7,128,9951,1,76149,37782,38868
12560404,12560396,TXFE7,128,9951,1,76150,37783,38869
12560454,12560453,TXFE7,128,9951,1,76151,37784,38870
12560517,12560512,TXFE7,128,9951,1,76152,37785,38871
12560579,12560574,TXFE7,128,9951,1,76153,37786,38872
12560642,12560637,TXFE7,128,9951,1,76154,37787,38873
12560742,12560741,TXFE7,128,9951,1,76155,37788,38874
12560942,12560938,TXFE7,128,9951,1,76156,37789,38875
12561929,12561928,TXFE7,128,9952,1,76157,37790,38876
12563504,12563500,TXFE7,128,9952,1,76158,37791,38877
12563579,12563567,TXFE7,128,9952,5,76163,37792,38879
12563592,12563579,TXFE7,128,9952,8,76171,37793,38882
12563604,12563592,TXFE7,128,9952,4,76175,37794,38884
12563604,12563592,TXFE7,128,9952,4,76179,37795,38886
12563617,12563604,TXFE7,128,9952,1,76180,37796,38887
12563617,12563604,TXFE7,128,9952,1,76181,37797,38888
12563629,12563626,TXFE7,128,9952,2,76183,37798,38889
12563629,12563626,TXFE7,128,9952,2,76185,37799,38890
12563629,12563626,TXFE7,128,9952,4,76189,37800,38892
12563629,12563626,TXFE7,128,9952,1,76190,37801,38893
12563629,12563626,TXFE7,128,9952,4,76194,37802,38896
12563629,12563626,TXFE7,128,9952,4,76198,37803,38899
12563629,12563626,TXFE7,128,9953,1,76199,37804,38900
12563742,12563732,TXFE7,128,9953,8,76207,37805,38903
12564042,12564032,TXFE7,128,9952,1,76208,37806,38904
12564267,12564260,TXFE7,128,9952,1,76209,37807,38905
12565592,12565589,TXFE7,128,9952,3,76212,37808,38906
12570054,12570047,TXFE7,128,9953,1,76213,37809,38907
12570092,12570085,TXFE7,128,9952,4,76217,37812,38908
12570142,12570135,TXFE7,128,9952,21,76238,37824,38909
12570829,12570827,TXFE7,128,9951,1,76239,37825,38910
12571354,12571353,TXFE7,128,9951,1,76240,37826,38911
12573004,12572999,TXFE7,128,9951,1,76241,37827,38912
12574842,12574840,TXFE7,128,9952,1,76242,37828,38913
12574879,12574875,TXFE7,128,9951,2,76244,37830,38914
12574992,12574985,TXFE7,128,9951,2,76246,37832,38915
12575092,12575086,TXFE7,128,9951,2,76248,37833,38916
12580917,12580910,TXFE7,128,9952,1,76249,37834,38917
12581029,12581022,TXFE7,128,9952,1,76250,37835,38918
12581492,12581490,TXFE7,128,9952,1,76251,37836,38919
12582717,12582713,TXFE7,128,9952,1,76252,37837,38920
12582992,12582990,TXFE7,128,9952,4,76256,37838,38922
12584504,12584493,TXFE7,128,9952,2,76258,37839,38923
12585004,12585003,TXFE7,128,9952,1,76259,37840,38924
12585079,12585073,TXFE7,128,9952,10,76269,37841,38928
12585167,12585165,TXFE7,128,9952,1,76270,37842,38929
12585204,12585201,TXFE7,128,9952,12,76282,37843,38936
12585317,12585305,TXFE7,128,9952,1,76283,37844,38937
12585379,12585369,TXFE7,128,9952,1,76284,37845,38938
12585392,12585380,TXFE7,128,9952,1,76285,37846,38939
12585554,12585553,TXFE7,128,9952,2,76287,37847,38940
12585717,12585709,TXFE7,128,9952,2,76289,37848,38941
12585892,12585882,TXFE7,128,9952,1,76290,37849,38942
12585942,12585939,TXFE7,128,9951,10,76300,37858,38943
12590004,12585995,TXFE7,128,9952,1,76301,37859,38944
12590154,12590146,TXFE7,128,9951,19,76320,37868,38945
12590204,12590198,TXFE7,128,9951,2,76322,37870,38946
12590242,12590233,TXFE7,128,9951,1,76323,37871,38947
12590429,12590420,TXFE7,128,9952,1,76324,37872,38948
12591254,12591254,TXFE7,128,9952,2,76326,37873,38949
12591492,12591487,TXFE7,128,9952,2,76328,37874,38951
12591517,12591512,TXFE7,128,9952,2,76330,37875,38953
12592204,12592199,TXFE7,128,9952,1,76331,37876,38954
12593142,12593135,TXFE7,128,9952,5,76336,37877,38955
12593604,12593599,TXFE7,128,9952,1,76337,37878,38956
12593704,12593696,TXFE7,128,9952,1,76338,37879,38957
12594304,12594298,TXFE7,128,9952,1,76339,37880,38958
12594442,12594432,TXFE7,128,9951,1,76340,37881,38959
12594454,12594444,TXFE7,128,9951,10,76350,37887,38960
13000029,13000018,TXFE7,128,9952,23,76373,37888,38966
13000042,13000032,TXFE7,128,9952,1,76374,37889,38967
13000042,13000039,TXFE7,128,9951,4,76378,37890,38968
13000054,13000047,TXFE7,128,9951,4,76382,37894,38969
13000142,13000138,TXFE7,128,9951,6,76388,37898,38970
13000242,13000231,TXFE7,128,9951,6,76394,37903,38971
13000404,13000396,TXFE7,128,9952,1,76395,37904,38972
13000467,13000455,TXFE7,128,9952,5,76400,37905,38977
13000529,13000518,TXFE7,128,9952,4,76404,37906,38978
13000929,13000926,TXFE7,128,9952,1,76405,37907,38979
13001142,13001132,TXFE7,128,9952,5,76410,37908,38982
13001404,13001393,TXFE7,128,9952,1,76411,37909,38983
13001417,13001408,TXFE7,128,9952,1,76412,37910,38984
13001442,13001430,TXFE7,128,9952,1,76413,37911,38985
13001629,13001617,TXFE7,128,9952,1,76414,37912,38986
13001629,13001627,TXFE7,128,9952,1,76415,37913,38987
13001642,13001629,TXFE7,128,9952,1,76416,37914,38988
13001642,13001634,TXFE7,128,9952,2,76418,37915,38989
13001642,13001634,TXFE7,128,9952,1,76419,37916,38990
13001642,13001635,TXFE7,128,9952,1,76420,37917,38991
13001654,13001642,TXFE7,128,9952,2,76422,37918,38992
13001654,13001642,TXFE7,128,9952,1,76423,37919,38993
13001854,13001847,TXFE7,128,9952,1,76424,37920,38994
13001992,13001981,TXFE7,128,9952,1,76425,37921,38995
13002179,13002171,TXFE7,128,9952,2,76427,37922,38997
13002279,13002270,TXFE7,128,9952,5,76432,37923,38998
13002617,13002611,TXFE7,128,9952,1,76433,37924,38999
13002629,13002617,TXFE7,128,9952,1,76434,37925,39000
13002679,13002678,TXFE7,128,9952,6,76440,37926,39001
13002729,13002727,TXFE7,128,9952,1,76441,37927,39002
13003629,13003629,TXFE7,128,9952,1,76442,37928,39003
13003679,13003668,TXFE7,128,9952,1,76443,37929,39004
13003704,13003694,TXFE7,128,9952,1,76444,37930,39005
13003779,13003772,TXFE7,128,9952,1,76445,37931,39006
13003779,13003779,TXFE7,128,9952,2,76447,37932,39007
13004117,13004114,TXFE7,128,9952,2,76449,37933,39008
13004142,13004141,TXFE7,128,9952,1,76450,37934,39009
13004367,13004356,TXFE7,128,9952,1,76451,37935,39010
13005429,13005418,TXFE7,128,9952,1,76452,37936,39011
13005442,13005435,TXFE7,128,9951,3,76455,37939,39012
13005542,13005537,TXFE7,128,9951,8,76463,37945,39013
13010929,13010925,TXFE7,128,9952,1,76464,37946,39014
13010967,13010955,TXFE7,128,9952,1,76465,37947,39015
13012117,13012105,TXFE7,128,9952,1,76466,37948,39016
13014679,13014671,TXFE7,128,9952,3,76469,37949,39017
13014692,13014679,TXFE7,128,9952,14,76483,37950,39024
13014704,13014692,TXFE7,128,9952,7,76490,37951,39025
13014704,13014696,TXFE7,128,9952,7,76497,37952,39026
13014704,13014696,TXFE7,128,9952,1,76498,37953,39027
13014704,13014696,TXFE7,128,9952,8,76506,37954,39028
13014704,13014696,TXFE7,128,9952,3,76509,37955,39029
13014717,13014704,TXFE7,128,9952,2,76511,37956,39030
13014717,13014704,TXFE7,128,9952,6,76517,37957,39032
13014717,13014704,TXFE7,128,9952,1,76518,37958,39033
13014717,13014704,TXFE7,128,9952,2,76520,37959,39035
13014717,13014704,TXFE7,128,9952,1,76521,37960,39036
13014717,13014709,TXFE7,128,9952,1,76522,37961,39037
13014717,13014714,TXFE7,128,9952,1,76523,37962,39038
13014729,13014717,TXFE7,128,9952,2,76525,37963,39040
13014729,13014717,TXFE7,128,9952,1,76526,37964,39041
13015154,13015154,TXFE7,128,9952,2,76528,37965,39042
13015617,13015605,TXFE7,128,9952,1,76529,37966,39043
13015942,13015929,TXFE7,128,9953,2,76531,37967,39044
13015954,13015954,TXFE7,128,9952,3,76534,37968,39045
13021517,13021510,TXFE7,128,9953,1,76535,37969,39046
13021554,13021543,TXFE7,128,9953,1,76536,37970,39047
13021567,13021560,TXFE7,128,9952,3,76539,37972,39048
13021567,13021560,TXFE7,128,9952,2,76541,37974,39049
13021592,13021590,TXFE7,128,9953,10,76551,37975,39052
13021629,13021629,TXFE7,128,9953,10,76561,37976,39054
13021667,13021666,TXFE7,128,9953,10,76571,37977,39058
13022217,13022211,TXFE7,128,9953,22,76593,37978,39069
13022229,13022217,TXFE7,128,9953,1,76594,37979,39070
13022279,13022271,TXFE7,128,9953,4,76598,37980,39072
13022279,13022278,TXFE7,128,9953,4,76602,37981,39075
13022329,13022322,TXFE7,128,9953,1,76603,37982,39076
13022329,13022322,TXFE7,128,9953,5,76608,37983,39078
13022342,13022337,TXFE7,128,9953,10,76618,37984,39087
13022367,13022359,TXFE7,128,9954,10,76628,37985,39094
13022404,13022396,TXFE7,128,9954,2,76630,37986,39095
13022429,13022426,TXFE7,128,9954,2,76632,37987,39096
13022454,13022442,TXFE7,128,9954,2,76634,37988,39098
13022517,13022509,TXFE7,128,9954,1,76635,37989,39099
13022579,13022569,TXFE7,128,9953,1,76636,37990,39100
13022704,13022697,TXFE7,128,9953,1,76637,37991,39101
13023354,13023344,TXFE7,128,9953,1,76638,37992,39102
13023367,13023366,TXFE7,128,9953,4,76642,37993,39103
13023379,13023367,TXFE7,128,9953,7,76649,37996,39104
13023379,13023367,TXFE7,128,9953,1,76650,37997,39105
13023392,13023379,TXFE7,128,9953,2,76652,37998,39106
13023392,13023379,TXFE7,128,9953,3,76655,37999,39107
13023392,13023384,TXFE7,128,9953,2,76657,38001,39108
13023404,13023392,TXFE7,128,9953,3,76660,38002,39109
13023404,13023396,TXFE7,128,9953,9,76669,38005,39110
13023404,13023397,TXFE7,128,9953,7,76676,38008,39111
13023429,13023419,TXFE7,128,9953,7,76683,38009,39115
13023567,13023560,TXFE7,128,9953,1,76684,38010,39116
13023717,13023714,TXFE7,128,9953,4,76688,38012,39117
13024079,13024069,TXFE7,128,9953,1,76689,38013,39118
13024129,13024125,TXFE7,128,9953,1,76690,38014,39119
13024592,13024581,TXFE7,128,9953,1,76691,38015,39120
13024692,13024684,TXFE7,128,9954,2,76693,38016,39122
13024692,13024685,TXFE7,128,9954,1,76694,38017,39123
13025104,13025093,TXFE7,128,9953,1,76695,38018,39124
13025717,13025713,TXFE7,128,9953,1,76696,38019,39125
13025904,13025894,TXFE7,128,9953,11,76707,38025,39126
13025904,13025894,TXFE7,128,9953,2,76709,38026,39127
13025904,13025894,TXFE7,128,9953,2,76711,38027,39128
13025917,13025904,TXFE7,128,9953,9,76720,38032,39129
13025954,13025954,TXFE7,128,9953,1,76721,38033,39130
13030042,13030034,TXFE7,128,9952,2,76723,38034,39131
13030079,13030071,TXFE7,128,9953,1,76724,38035,39132
13030092,13030089,TXFE7,128,9952,2,76726,38036,39133
13030179,13030178,TXFE7,128,9952,2,76728,38038,39134
13030179,13030178,TXFE7,128,9952,6,76734,38040,39135
13030179,13030178,TXFE7,128,9952,1,76735,38041,39136
13030179,13030178,TXFE7,128,9952,5,76740,38042,39137
13030179,13030178,TXFE7,128,9952,1,76741,38043,39138
13030179,13030178,TXFE7,128,9952,1,76742,38044,39139
13030179,13030178,TXFE7,128,9952,1,76743,38045,39140
13030192,13030179,TXFE7,128,9952,18,76761,38052,39141
13030192,13030179,TXFE7,128,9952,1,76762,38053,39142
13030192,13030180,TXFE7,128,9952,6,76768,38055,39143
13030204,13030192,TXFE7,128,9952,2,76770,38056,39144
13030204,13030192,TXFE7,128,9952,1,76771,38057,39145
13030204,13030192,TXFE7,128,9952,3,76774,38058,39146
13030204,13030192,TXFE7,128,9952,2,76776,38060,39147
13030204,13030192,TXFE7,128,9952,2,76778,38062,39148
13030204,13030195,TXFE7,128,9952,16,76794,38068,39149
13030342,13030335,TXFE7,128,9951,5,76799,38071,39150
13030379,13030370,TXFE7,128,9952,6,76805,38072,39153
13030392,13030382,TXFE7,128,9951,5,76810,38074,39154
13030392,13030387,TXFE7,128,9951,1,76811,38075,39155
13030404,13030395,TXFE7,128,9951,1,76812,38076,39156
13030642,13030632,TXFE7,128,9951,5,76817,38081,39157
13030867,13030866,TXFE7,128,9951,1,76818,38082,39158
13030879,13030872,TXFE7,128,9951,20,76838,38094,39159
13030917,13030909,TXFE7,128,9952,1,76839,38095,39160
13030929,13030921,TXFE7,128,9951,5,76844,38096,39161
13030954,13030945,TXFE7,128,9951,6,76850,38097,39162
13030954,13030950,TXFE7,128,9951,6,76856,38098,39163
13030979,13030969,TXFE7,128,9952,2,76858,38099,39164
13032429,13032420,TXFE7,128,9951,1,76859,38100,39165
13032554,13032549,TXFE7,128,9952,1,76860,38101,39166
13032629,13032621,TXFE7,128,9951,1,76861,38102,39167
13032929,13032921,TXFE7,128,9951,2,76863,38103,39168
13033129,13033121,TXFE7,128,9951,3,76866,38105,39169
13034342,13034333,TXFE7,128,9951,1,76867,38106,39170
13034767,13034755,TXFE7,128,9952,1,76868,38107,39171
13035129,13035128,TXFE7,128,9951,10,76878,38112,39172
13035404,13035397,TXFE7,128,9951,10,76888,38119,39173
13035567,13035562,TXFE7,128,9951,1,76889,38120,39174
13035604,13035597,TXFE7,128,9951,1,76890,38121,39175
13035742,13035733,TXFE7,128,9951,10,76900,38124,39176
13035767,13035754,TXFE7,128,9951,42,76942,38149,39177
13035767,13035766,TXFE7,128,9951,1,76943,38150,39178
13040017,13040010,TXFE7,128,9951,1,76944,38151,39179
13040079,13040074,TXFE7,128,9951,11,76955,38152,39183
13040092,13040085,TXFE7,128,9951,3,76958,38153,39185
13040104,13040098,TXFE7,128,9951,1,76959,38154,39186
13040329,13040319,TXFE7,128,9951,1,76960,38155,39187
13040504,13040500,TXFE7,128,9951,1,76961,38156,39188
13040642,13040638,TXFE7,128,9951,3,76964,38157,39191
13041217,13041211,TXFE7,128,9951,1,76965,38158,39192
13042204,13042193,TXFE7,128,9951,2,76967,38159,39193
13042292,13042280,TXFE7,128,9951,2,76969,38160,39194
13042604,13042602,TXFE7,128,9951,1,76970,38161,39195
13042992,13042979,TXFE7,128,9951,13,76983,38162,39204
13043154,13043151,TXFE7,128,9951,1,76984,38163,39205
13043204,13043199,TXFE7,128,9951,1,76985,38164,39206
13043617,13043614,TXFE7,128,9951,1,76986,38165,39207
13043829,13043821,TXFE7,128,9951,1,76987,38166,39208
13043867,13043861,TXFE7,128,9951,1,76988,38167,39209
13043879,13043867,TXFE7,128,9951,2,76990,38169,39210
13043904,13043901,TXFE7,128,9951,7,76997,38170,39211
13043929,13043926,TXFE7,128,9951,2,76999,38171,39212
13044017,13044005,TXFE7,128,9951,1,77000,38172,39213
13044167,13044162,TXFE7,128,9951,1,77001,38173,39214
13044192,13044179,TXFE7,128,9951,1,77002,38174,39215
13044267,13044265,TXFE7,128,9951,1,77003,38175,39216
13044554,13044552,TXFE7,128,9951,15,77018,38176,39219
13044617,13044605,TXFE7,128,9950,2,77020,38178,39220
13044629,13044621,TXFE7,128,9950,1,77021,38179,39221
13044629,13044626,TXFE7,128,9950,1,77022,38180,39222
13044642,13044638,TXFE7,128,9950,1,77023,38181,39223
13044654,13044646,TXFE7,128,9950,1,77024,38182,39224
13044704,13044700,TXFE7,128,9951,1,77025,38183,39225
13044704,13044704,TXFE7,128,9951,9,77034,38184,39227
13044729,13044722,TXFE7,128,9950,1,77035,38185,39228
13044729,13044723,TXFE7,128,9950,1,77036,38186,39229
13044929,13044923,TXFE7,128,9950,12,77048,38194,39230
13044929,13044928,TXFE7,128,9951,1,77049,38195,39231
13044992,13044979,TXFE7,128,9951,1,77050,38196,39232
13045117,13045109,TXFE7,128,9951,4,77054,38197,39235
13045229,13045224,TXFE7,128,9951,1,77055,38198,39236
13045279,13045275,TXFE7,128,9951,1,77056,38199,39237
13045579,13045576,TXFE7,128,9951,1,77057,38200,39238
13045629,13045628,TXFE7,128,9951,1,77058,38201,39239
13045729,13045728,TXFE7,128,9951,1,77059,38202,39240
13045767,13045757,TXFE7,128,9951,4,77063,38203,39243
13050104,13050092,TXFE7,128,9951,1,77064,38204,39244
13050117,13050105,TXFE7,128,9951,2,77066,38205,39245
13050167,13050161,TXFE7,128,9951,2,77068,38206,39246
13050192,13050181,TXFE7,128,9951,1,77069,38207,39247
13050517,13050512,TXFE7,128,9951,1,77070,38208,39248
13050679,13050672,TXFE7,128,9951,1,77071,38209,39249
13050692,13050685,TXFE7,128,9951,2,77073,38211,39250
13050929,13050925,TXFE7,128,9951,1,77074,38212,39251
13052054,13052052,TXFE7,128,9951,1,77075,38213,39252
13052692,13052682,TXFE7,128,9951,2,77077,38214,39254
13052692,13052684,TXFE7,128,9951,3,77080,38215,39255
13052742,13052734,TXFE7,128,9951,2,77082,38216,39256
13053742,13053735,TXFE7,128,9950,2,77084,38218,39257
13055079,13055079,TXFE7,128,9950,1,77085,38219,39258
13055792,13055780,TXFE7,128,9950,1,77086,38220,39259
13055942,13055932,TXFE7,128,9950,4,77090,38224,39260
13061142,13061141,TXFE7,128,9950,1,77091,38225,39261
13061879,13061867,TXFE7,128,9950,2,77093,38226,39262
13061892,13061883,TXFE7,128,9951,1,77094,38227,39263
13061942,13061931,TXFE7,128,9951,1,77095,38228,39264
13061954,13061947,TXFE7,128,9951,2,77097,38229,39266
13062779,13062779,TXFE7,128,9950,1,77098,38230,39267
13063404,13063400,TXFE7,128,9951,5,77103,38231,39271
13063642,13063641,TXFE7,128,9950,1,77104,38232,39272
13063667,13063665,TXFE7,128,9950,1,77105,38233,39273
13063729,13063726,TXFE7,128,9951,1,77106,38234,39274
13063954,13063951,TXFE7,128,9950,2,77108,38235,39275
13064592,13064585,TXFE7,128,9950,1,77109,38236,39276
13065079,13065071,TXFE7,128,9950,5,77114,38239,39277
13065292,13065289,TXFE7,128,9950,1,77115,38240,39278
13065429,13065421,TXFE7,128,9951,1,77116,38241,39279
13065479,13065473,TXFE7,128,9951,4,77120,38242,39280
13065654,13065643,TXFE7,128,9951,4,77124,38243,39281
13065692,13065687,TXFE7,128,9950,3,77127,38245,39282
13065817,13065808,TXFE7,128,9951,1,77128,38246,39283
13065842,13065830,TXFE7,128,9950,1,77129,38247,39284
13065842,13065830,TXFE7,128,9950,1,77130,38248,39285
13070017,13070013,TXFE7,128,9950,1,77131,38249,39286
13070079,13070079,TXFE7,128,9950,15,77146,38259,39287
13070179,13070168,TXFE7,128,9950,2,77148,38260,39288
13070492,13070487,TXFE7,128,9950,1,77149,38261,39289
13070492,13070488,TXFE7,128,9951,2,77151,38262,39291
13070517,13070510,TXFE7,128,9950,5,77156,38264,39292
13070517,13070511,TXFE7,128,9950,1,77157,38265,39293
13070517,13070516,TXFE7,128,9950,1,77158,38266,39294
13070529,13070523,TXFE7,128,9950,1,77159,38267,39295
13070542,13070539,TXFE7,128,9950,1,77160,38268,39296
13070567,13070555,TXFE7,128,9950,1,77161,38269,39297
13070579,13070574,TXFE7,128,9950,1,77162,38270,39298
13070592,13070584,TXFE7,128,9951,1,77163,38271,39299
13070617,13070608,TXFE7,128,9950,1,77164,38272,39300
13070642,13070636,TXFE7,128,9950,1,77165,38273,39301
13070742,13070738,TXFE7,128,9950,2,77167,38274,39302
13070767,13070762,TXFE7,128,9950,1,77168,38275,39303
13071042,13071031,TXFE7,128,9950,2,77170,38277,39304
13071067,13071061,TXFE7,128,9951,12,77182,38278,39311
13071129,13071126,TXFE7,128,9950,2,77184,38279,39312
13071454,13071453,TXFE7,128,9950,12,77196,38286,39313
13071529,13071525,TXFE7,128,9950,6,77202,38290,39314
13071642,13071639,TXFE7,128,9950,1,77203,38291,39315
13071742,13071734,TXFE7,128,9950,2,77205,38293,39316
13071929,13071926,TXFE7,128,9950,10,77215,38299,39317
13071954,13071945,TXFE7,128,9950,1,77216,38300,39318
13071992,13071984,TXFE7,128,9950,1,77217,38301,39319
13072129,13072123,TXFE7,128,9950,13,77230,38310,39320
13072129,13072127,TXFE7,128,9950,1,77231,38311,39321
13072154,13072145,TXFE7,128,9950,1,77232,38312,39322
13072229,13072226,TXFE7,128,9950,1,77233,38313,39323
13072292,13072288,TXFE7,128,9950,1,77234,38314,39324
13072379,13072371,TXFE7,128,9950,2,77236,38315,39325
13072392,13072387,TXFE7,128,9950,17,77253,38325,39326
13072404,13072392,TXFE7,128,9950,47,77300,38357,39327
13072442,13072433,TXFE7,129,9950,3,77304,38358,39330
13072442,13072433,TXFE7,129,9951,1,77304,38358,39330
13072504,13072500,TXFE7,128,9949,1,77305,38359,39331
13072517,13072510,TXFE7,128,9949,1,77306,38360,39332
13072529,13072528,TXFE7,128,9949,1,77307,38361,39333
13072542,13072530,TXFE7,128,9949,1,77308,38362,39334
13072542,13072532,TXFE7,128,9949,1,77309,38363,39335
13072542,13072534,TXFE7,128,9950,4,77313,38364,39337
13072554,13072543,TXFE7,128,9949,1,77314,38365,39338
13072554,13072551,TXFE7,128,9949,1,77315,38366,39339
13072567,13072554,TXFE7,128,9949,6,77321,38370,39340
13072567,13072557,TXFE7,128,9949,1,77322,38371,39341
13072567,13072559,TXFE7,128,9949,1,77323,38372,39342
13072567,13072559,TXFE7,128,9950,26,77349,38373,39352
13072579,13072570,TXFE7,128,9950,2,77351,38374,39353
13072579,13072573,TXFE7,128,9950,2,77353,38375,39354
13072592,13072579,TXFE7,128,9950,20,77373,38376,39355
13072592,13072580,TXFE7,128,9950,2,77375,38377,39356
13072754,13072748,TXFE7,128,9949,8,77383,38380,39357
13073167,13073164,TXFE7,128,9950,5,77388,38381,39359
13073417,13073405,TXFE7,128,9949,1,77389,38382,39360
13073717,13073713,TXFE7,128,9949,1,77390,38383,39361
13073754,13073753,TXFE7,128,9950,2,77392,38384,39363
13073842,13073837,TXFE7,128,9949,3,77395,38385,39364
13073867,13073860,TXFE7,128,9950,1,77396,38386,39365
13074029,13074020,TXFE7,128,9949,1,77397,38387,39366
13074317,13074309,TXFE7,128,9949,1,77398,38388,39367
13074517,13074504,TXFE7,128,9950,2,77400,38389,39369
13074592,13074590,TXFE7,128,9950,1,77401,38390,39370
13074667,13074658,TXFE7,128,9949,1,77402,38391,39371
13075154,13075144,TXFE7,128,9950,13,77415,38392,39374
13075617,13075605,TXFE7,128,9950,1,77416,38393,39375
13075842,13075832,TXFE7,128,9950,1,77417,38394,39376
13075942,13075940,TXFE7,128,9949,2,77419,38395,39377
13080017,13080009,TXFE7,128,9949,1,77420,38396,39378
13080067,13080065,TXFE7,128,9950,5,77425,38397,39380
13080642,13080635,TXFE7,128,9949,3,77428,38398,39381
13080879,13080873,TXFE7,128,9950,1,77429,38399,39382
13081242,13081232,TXFE7,128,9950,1,77430,38400,39383
13081604,13081593,TXFE7,128,9950,34,77464,38401,39408
13081817,13081814,TXFE7,128,9950,5,77469,38402,39409
13081867,13081857,TXFE7,128,9950,6,77475,38403,39412
13081879,13081874,TXFE7,128,9950,6,77481,38404,39415
13081979,13081975,TXFE7,128,9950,1,77482,38405,39416
13082604,13082598,TXFE7,128,9950,4,77486,38406,39418
13082642,13082636,TXFE7,128,9950,1,77487,38407,39419
13082704,13082703,TXFE7,128,9950,1,77488,38408,39420
13082942,13082931,TXFE7,128,9950,5,77493,38409,39422
13082992,13082989,TXFE7,128,9950,2,77495,38410,39424
13083029,13083029,TXFE7,128,9950,3,77498,38411,39426
13083092,13083080,TXFE7,128,9951,1,77499,38412,39427
13083392,13083385,TXFE7,128,9950,1,77500,38413,39428
13083704,13083701,TXFE7,128,9950,1,77501,38414,39429
13084117,13084113,TXFE7,128,9950,1,77502,38415,39430
13084604,13084604,TXFE7,128,9951,22,77524,38416,39446
13084617,13084604,TXFE7,128,9951,4,77528,38417,39449
13084617,13084604,TXFE7,128,9951,14,77542,38418,39455
13084617,13084604,TXFE7,128,9951,1,77543,38419,39456
13084617,13084604,TXFE7,128,9951,2,77545,38420,39457
13084617,13084604,TXFE7,128,9951,1,77546,38421,39458
13084617,13084605,TXFE7,128,9951,18,77564,38422,39465
13084617,13084609,TXFE7,128,9951,1,77565,38423,39466
13084629,13084617,TXFE7,128,9951,3,77568,38424,39469
13084629,13084622,TXFE7,128,9952,1,77569,38425,39470
13084642,13084629,TXFE7,128,9952,1,77570,38426,39471
13084642,13084629,TXFE7,128,9952,1,77571,38427,39472
13084642,13084632,TXFE7,128,9952,1,77572,38428,39473
13084642,13084634,TXFE7,128,9951,1,77573,38429,39474
13084704,13084697,TXFE7,128,9952,6,77579,38430,39476
13085067,13085063,TXFE7,128,9952,23,77602,38431,39490
13085079,13085067,TXFE7,128,9952,2,77604,38432,39491
13085079,13085067,TXFE7,128,9952,3,77607,38433,39494
13085217,13085211,TXFE7,128,9952,1,77608,38434,39495
13085629,13085619,TXFE7,128,9952,1,77609,38435,39496
13085967,13085967,TXFE7,128,9952,1,77610,38436,39497
13090017,13090010,TXFE7,128,9952,1,77611,38437,39498
13090067,13090054,TXFE7,128,9952,4,77615,38441,39499
13090067,13090054,TXFE7,128,9952,4,77619,38445,39500
13090079,13090067,TXFE7,128,9952,3,77622,38448,39501
13090079,13090067,TXFE7,128,9952,2,77624,38450,39502
13090092,13090091,TXFE7,128,9951,1,77625,38451,39503
13090104,13090104,TXFE7,128,9952,3,77628,38452,39504
13090117,13090116,TXFE7,128,9953,2,77630,38453,39505
13090217,13090205,TXFE7,128,9953,2,77632,38454,39507
13090529,13090524,TXFE7,128,9952,1,77633,38455,39508
13090617,13090607,TXFE7,128,9952,3,77636,38456,39509
13090642,13090636,TXFE7,128,9953,1,77637,38457,39510
13090917,13090916,TXFE7,128,9952,1,77638,38458,39511
13090942,13090935,TXFE7,128,9952,2,77640,38459,39512
13091379,13091376,TXFE7,128,9952,1,77641,38460,39513
13091642,13091632,TXFE7,128,9952,5,77646,38465,39514
13091867,13091862,TXFE7,128,9952,1,77647,38466,39515
13092029,13092025,TXFE7,128,9952,1,77648,38467,39516
13092167,13092164,TXFE7,128,9952,1,77649,38468,39517
13092242,13092236,TXFE7,128,9952,5,77654,38471,39518
13092329,13092318,TXFE7,128,9952,1,77655,38472,39519
13092367,13092360,TXFE7,128,9953,1,77656,38473,39520
13092367,13092365,TXFE7,128,9952,2,77658,38475,39521
13092404,13092393,TXFE7,128,9952,1,77659,38476,39522
13092429,13092420,TXFE7,128,9952,2,77661,38477,39524
13092492,13092490,TXFE7,128,9951,1,77662,38478,39525
13092617,13092614,TXFE7,128,9952,1,77663,38479,39526
13092879,13092867,TXFE7,128,9951,1,77664,38480,39527
13092879,13092867,TXFE7,128,9951,1,77665,38481,39528
13092879,13092867,TXFE7,128,9951,1,77666,38482,39529
13092892,13092884,TXFE7,128,9952,20,77686,38483,39537
13093017,13093005,TXFE7,128,9952,10,77696,38484,39543
13093154,13093148,TXFE7,128,9952,1,77697,38485,39544
13093267,13093266,TXFE7,128,9952,10,77707,38486,39551
13093279,13093271,TXFE7,128,9953,1,77708,38487,39552
13093292,13093279,TXFE7,128,9953,4,77712,38488,39555
13093292,13093279,TXFE7,128,9953,4,77716,38489,39557
13093292,13093279,TXFE7,128,9953,1,77717,38490,39558
13093292,13093279,TXFE7,128,9953,12,77729,38491,39567
13093292,13093279,TXFE7,128,9953,1,77730,38492,39568
13093292,13093279,TXFE7,128,9953,1,77731,38493,39569
13093292,13093279,TXFE7,128,9953,1,77732,38494,39570
13093292,13093280,TXFE7,128,9953,36,77768,38495,39587
13093304,13093295,TXFE7,128,9954,20,77788,38496,39600
13093342,13093337,TXFE7,128,9954,1,77789,38497,39601
13093354,13093347,TXFE7,128,9954,1,77790,38498,39602
13093367,13093362,TXFE7,128,9954,1,77791,38499,39603
13093404,13093395,TXFE7,128,9954,2,77793,38500,39604
13093454,13093444,TXFE7,128,9954,2,77795,38501,39606
13093479,13093474,TXFE7,128,9954,4,77799,38502,39609
13094004,13093995,TXFE7,128,9953,5,77804,38505,39610
13094142,13094141,TXFE7,128,9953,3,77807,38506,39611
13094167,13094166,TXFE7,128,9954,1,77808,38507,39612
13094242,13094229,TXFE7,128,9954,1,77809,38508,39613
13094467,13094459,TXFE7,128,9954,1,77810,38509,39614
13094667,13094661,TXFE7,128,9953,1,77811,38510,39615
13094854,13094850,TXFE7,128,9953,5,77816,38514,39616
13094879,13094870,TXFE7,128,9954,1,77817,38515,39617
13095192,13095186,TXFE7,128,9953,5,77822,38519,39618
13095329,13095322,TXFE7,128,9953,1,77823,38520,39619
13095704,13095694,TXFE7,128,9953,1,77824,38521,39620
13095892,13095890,TXFE7,128,9953,1,77825,38522,39621
13095992,13095986,TXFE7,128,9954,1,77826,38523,39622
13100054,13100048,TXFE7,128,9953,1,77827,38524,39623
13100342,13100339,TXFE7,128,9954,1,77828,38525,39624
13100367,13100357,TXFE7,128,9953,3,77831,38526,39625
13100404,13100401,TXFE7,128,9954,2,77833,38527,39626
13100442,13100435,TXFE7,128,9954,4,77837,38528,39628
13100579,13100572,TXFE7,128,9953,4,77841,38529,39629
13100654,13100649,TXFE7,128,9953,3,77844,38530,39630
13100654,13100649,TXFE7,128,9953,1,77845,38531,39631
13100667,13100655,TXFE7,128,9953,1,77846,38532,39632
13100667,13100660,TXFE7,128,9953,3,77849,38535,39633
13100667,13100664,TXFE7,128,9954,2,77851,38536,39635
13100679,13100667,TXFE7,128,9953,1,77852,38537,39636
13100679,13100668,TXFE7,128,9953,1,77853,38538,39637
13100692,13100685,TXFE7,128,9954,1,77854,38539,39638
13100729,13100720,TXFE7,128,9953,1,77855,38540,39639
13100817,13100812,TXFE7,128,9953,1,77856,38541,39640
13100817,13100816,TXFE7,128,9953,1,77857,38542,39641
13100829,13100820,TXFE7,128,9953,1,77858,38543,39642
13100829,13100823,TXFE7,128,9953,1,77859,38544,39643
13100854,13100850,TXFE7,128,9953,3,77862,38547,39644
13100867,13100854,TXFE7,128,9953,1,77863,38548,39645
13100879,13100867,TXFE7,128,9953,2,77865,38550,39646
13100892,13100879,TXFE7,128,9953,2,77867,38552,39647
13100892,13100886,TXFE7,128,9953,2,77869,38554,39648
13100904,13100892,TXFE7,128,9953,1,77870,38555,39649
13100917,13100910,TXFE7,128,9952,2,77872,38556,39650
13101054,13101054,TXFE7,128,9953,1,77873,38557,39651
13101117,13101108,TXFE7,128,9953,1,77874,38558,39652
13101967,13101962,TXFE7,128,9953,1,77875,38559,39653
13102217,13102211,TXFE7,128,9952,1,77876,38560,39654
13105904,13105898,TXFE7,128,9953,1,77877,38561,39655
13110329,13110327,TXFE7,128,9952,1,77878,38562,39656
13111554,13111546,TXFE7,128,9952,1,77879,38563,39657
13112554,13112547,TXFE7,128,9953,1,77880,38564,39658
13112992,13112983,TXFE7,128,9952,2,77882,38565,39659
13113254,13113253,TXFE7,128,9953,1,77883,38566,39660
13113617,13113613,TXFE7,128,9952,1,77884,38567,39661
13114092,13114081,TXFE7,128,9952,15,77899,38574,39662
13114104,13114096,TXFE7,128,9952,1,77900,38575,39663
13114117,13114113,TXFE7,128,9952,1,77901,38576,39664
13114367,13114362,TXFE7,128,9952,1,77902,38577,39665
13114617,13114609,TXFE7,128,9952,1,77903,38578,39666
13114842,13114842,TXFE7,128,9952,1,77904,38579,39667
13115479,13115477,TXFE7,128,9952,1,77905,38580,39668
13120954,13120948,TXFE7,128,9952,1,77906,38581,39669
13120992,13120980,TXFE7,128,9952,8,77914,38586,39670
13121054,13121051,TXFE7,128,9953,1,77915,38587,39671
13121504,13121492,TXFE7,128,9953,1,77916,38588,39672
13122354,13122342,TXFE7,128,9952,1,77917,38589,39673
13122367,13122354,TXFE7,128,9952,3,77920,38591,39674
13122367,13122354,TXFE7,128,9952,2,77922,38593,39675
13122379,13122367,TXFE7,128,9952,3,77925,38596,39676
13122379,13122367,TXFE7,128,9952,2,77927,38598,39677
13122379,13122367,TXFE7,128,9952,6,77933,38603,39678
13122392,13122379,TXFE7,128,9952,1,77934,38604,39679
13122392,13122379,TXFE7,128,9952,1,77935,38605,39680
13122392,13122379,TXFE7,128,9952,1,77936,38606,39681
13122404,13122396,TXFE7,128,9952,1,77937,38607,39682
13122742,13122741,TXFE7,128,9953,1,77938,38608,39683
13122829,13122819,TXFE7,128,9952,5,77943,38609,39684
13122842,13122834,TXFE7,128,9952,10,77953,38612,39685
13122842,13122834,TXFE7,128,9952,1,77954,38613,39686
13122842,13122834,TXFE7,128,9952,3,77957,38616,39687
13122854,13122842,TXFE7,128,9951,1,77958,38617,39688
13122854,13122842,TXFE7,128,9951,2,77960,38618,39689
13122854,13122842,TXFE7,128,9951,7,77967,38623,39690
13122854,13122842,TXFE7,128,9951,1,77968,38624,39691
13122854,13122842,TXFE7,128,9951,1,77969,38625,39692
13122867,13122854,TXFE7,128,9951,1,77970,38626,39693
13122867,13122857,TXFE7,128,9952,1,77971,38627,39694
13122867,13122857,TXFE7,128,9951,1,77972,38628,39695
13122879,13122874,TXFE7,128,9951,2,77974,38629,39696
13123179,13123177,TXFE7,128,9952,2,77976,38630,39697
13124692,13124681,TXFE7,128,9952,6,77982,38631,39698
13124967,13124957,TXFE7,128,9952,1,77983,38632,39699
13125592,13125591,TXFE7,128,9951,3,77986,38634,39700
13130079,13130070,TXFE7,128,9951,1,77987,38635,39701
13132192,13132181,TXFE7,128,9952,1,77988,38636,39702
13132204,13132196,TXFE7,128,9952,4,77992,38637,39706
13132229,13132223,TXFE7,128,9951,3,77995,38638,39707
13132229,13132228,TXFE7,128,9951,1,77996,38639,39708
13132242,13132233,TXFE7,128,9951,2,77998,38640,39709
13132254,13132246,TXFE7,128,9952,2,78000,38641,39710
13132917,13132916,TXFE7,128,9952,1,78001,38642,39711
13133079,13133077,TXFE7,128,9952,1,78002,38643,39712
13133167,13133155,TXFE7,128,9952,3,78005,38644,39715
13134167,13134157,TXFE7,128,9952,2,78007,38645,39716
13134279,13134274,TXFE7,128,9952,1,78008,38646,39717
13134404,13134392,TXFE7,128,9952,1,78009,38647,39718
13134429,13134422,TXFE7,128,9952,1,78010,38648,39719
13134442,13134432,TXFE7,128,9951,1,78011,38649,39720
13134479,13134468,TXFE7,128,9952,2,78013,38650,39721
13135054,13135045,TXFE7,128,9952,1,78014,38651,39722
13135442,13135435,TXFE7,128,9952,3,78017,38652,39723
13142292,13142292,TXFE7,128,9952,1,78018,38653,39724
13142317,13142313,TXFE7,128,9952,1,78019,38654,39725
13142329,13142318,TXFE7,128,9952,1,78020,38655,39726
13142779,13142773,TXFE7,128,9952,5,78025,38656,39731
13143092,13143087,TXFE7,128,9951,1,78026,38657,39732
13143117,13143115,TXFE7,128,9952,1,78027,38658,39733
13143379,13143374,TXFE7,128,9951,1,78028,38659,39734
13144167,13144162,TXFE7,128,9952,1,78029,38660,39735
13144292,13144285,TXFE7,128,9951,2,78031,38661,39736
13144742,13144735,TXFE7,128,9952,1,78032,38662,39737
13145304,13145293,TXFE7,128,9952,5,78037,38663,39739
13145829,13145824,TXFE7,128,9952,2,78039,38664,39741
13150054,13150043,TXFE7,128,9951,8,78047,38666,39742
13150054,13150043,TXFE7,128,9951,8,78055,38672,39743
13150054,13150043,TXFE7,128,9951,8,78063,38676,39744
13150054,13150043,TXFE7,128,9951,8,78071,38679,39745
13150067,13150057,TXFE7,128,9951,1,78072,38680,39746
13150567,13150562,TXFE7,128,9952,2,78074,38681,39748
13150592,13150580,TXFE7,128,9952,3,78077,38682,39751
13150767,13150759,TXFE7,128,9951,1,78078,38683,39752
13151129,13151126,TXFE7,128,9951,1,78079,38684,39753
13151554,13151551,TXFE7,128,9952,3,78082,38685,39754
13151567,13151558,TXFE7,128,9951,1,78083,38686,39755
13151967,13151956,TXFE7,128,9952,1,78084,38687,39756
13152517,13152505,TXFE7,128,9952,1,78085,38688,39757
13153154,13153153,TXFE7,128,9952,2,78087,38689,39758
13153154,13153153,TXFE7,128,9952,1,78088,38690,39759
13153154,13153153,TXFE7,128,9952,1,78089,38691,39760
13153517,13153512,TXFE7,128,9952,3,78092,38692,39763
13155154,13155146,TXFE7,128,9951,1,78093,38693,39764
13155179,13155179,TXFE7,128,9952,1,78094,38694,39765
13163029,13163021,TXFE7,128,9952,1,78095,38695,39766
13163042,13163029,TXFE7,128,9952,1,78096,38696,39767
13163442,13163435,TXFE7,128,9952,1,78097,38697,39768
13164342,13164339,TXFE7,128,9952,1,78098,38698,39769
13165367,13165356,TXFE7,128,9952,1,78099,38699,39770
13165454,13165453,TXFE7,128,9951,1,78100,38700,39771
13165479,13165479,TXFE7,128,9951,1,78101,38701,39772
13170517,13170505,TXFE7,128,9951,1,78102,38702,39773
13173154,13173144,TXFE7,128,9951,1,78103,38703,39774
13173429,13173418,TXFE7,128,9951,1,78104,38704,39775
13173442,13173436,TXFE7,128,9951,1,78105,38705,39776
13173867,13173859,TXFE7,128,9951,1,78106,38706,39777
13173904,13173904,TXFE7,128,9952,3,78109,38707,39780
13173917,13173907,TXFE7,128,9951,1,78110,38708,39781
13174054,13174052,TXFE7,128,9951,1,78111,38709,39782
13174254,13174250,TXFE7,128,9951,1,78112,38710,39783
13174479,13174476,TXFE7,128,9952,1,78113,38711,39784
13174629,13174618,TXFE7,128,9952,1,78114,38712,39785
13175167,13175159,TXFE7,128,9952,1,78115,38713,39786
13175542,13175538,TXFE7,128,9952,1,78116,38714,39787
13175729,13175718,TXFE7,128,9951,1,78117,38715,39788
13175967,13175966,TXFE7,128,9952,1,78118,38716,39789
13180042,13180035,TXFE7,128,9952,1,78119,38717,39790
13180104,13180101,TXFE7,128,9952,1,78120,38718,39791
13180129,13180117,TXFE7,128,9951,1,78121,38719,39792
13180529,13180522,TXFE7,128,9952,1,78122,38720,39793
13181342,13181336,TXFE7,128,9951,2,78124,38722,39794
13181567,13181556,TXFE7,128,9952,1,78125,38723,39795
13181729,13181727,TXFE7,128,9951,1,78126,38724,39796
13181754,13181748,TXFE7,128,9951,1,78127,38725,39797
13181954,13181954,TXFE7,128,9952,1,78128,38726,39798
13182792,13182787,TXFE7,128,9951,1,78129,38727,39799
13184004,13183996,TXFE7,128,9951,2,78131,38728,39800
13184004,13183998,TXFE7,128,9951,1,78132,38729,39801
13184254,13184253,TXFE7,128,9952,1,78133,38730,39802
13184367,13184359,TXFE7,128,9952,2,78135,38731,39803
13184367,13184360,TXFE7,128,9951,2,78137,38733,39804
13184604,13184599,TXFE7,128,9951,1,78138,38734,39805
13185704,13185698,TXFE7,128,9951,1,78139,38735,39806
13190029,13190022,TXFE7,128,9951,2,78141,38736,39807
13190429,13190422,TXFE7,128,9951,1,78142,38737,39808
13190454,13190444,TXFE7,128,9951,4,78146,38738,39809
13191604,13191603,TXFE7,128,9951,2,78148,38740,39810
13191629,13191628,TXFE7,128,9951,1,78149,38741,39811
13191929,13191923,TXFE7,128,9951,2,78151,38742,39812
13192104,13192096,TXFE7,128,9951,8,78159,38748,39813
13192167,13192159,TXFE7,128,9951,1,78160,38749,39814
13192179,13192172,TXFE7,128,9951,1,78161,38750,39815
13192229,13192217,TXFE7,128,9951,1,78162,38751,39816
13192404,13192404,TXFE7,128,9951,8,78170,38758,39817
13192417,13192408,TXFE7,128,9951,1,78171,38759,39818
13192454,13192444,TXFE7,128,9951,1,78172,38760,39819
13192479,13192469,TXFE7,128,9952,1,78173,38761,39820
13192492,13192486,TXFE7,128,9951,1,78174,38762,39821
13192867,13192859,TXFE7,128,9951,1,78175,38763,39822
13192879,13192877,TXFE7,128,9951,2,78177,38765,39823
13192892,13192886,TXFE7,128,9951,1,78178,38766,39824
13193179,13193172,TXFE7,128,9951,1,78179,38767,39825
13193879,13193875,TXFE7,128,9951,3,78182,38770,39826
13194017,13194009,TXFE7,128,9951,1,78183,38771,39827
13194092,13194087,TXFE7,128,9951,42,78225,38805,39828
13194104,13194096,TXFE7,128,9950,1,78226,38806,39829
13194104,13194098,TXFE7,128,9950,1,78227,38807,39830
13194129,13194118,TXFE7,128,9951,1,78228,38808,39831
13194504,13194495,TXFE7,128,9950,1,78229,38809,39832
13194829,13194819,TXFE7,128,9951,1,78230,38810,39833
13194942,13194932,TXFE7,128,9951,2,78232,38811,39835
13194954,13194942,TXFE7,128,9951,4,78236,38812,39837
13194954,13194942,TXFE7,128,9951,1,78237,38813,39838
13194967,13194954,TXFE7,128,9951,1,78238,38814,39839
13194967,13194954,TXFE7,128,9951,1,78239,38815,39840
13194967,13194954,TXFE7,128,9951,3,78242,38816,39842
13194979,13194967,TXFE7,128,9951,1,78243,38817,39843
13194979,13194967,TXFE7,128,9951,4,78247,38818,39845
13194979,13194972,TXFE7,128,9950,1,78248,38819,39846
13194979,13194972,TXFE7,128,9950,1,78249,38820,39847
13194992,13194979,TXFE7,128,9951,2,78251,38821,39849
13194992,13194979,TXFE7,128,9951,5,78256,38822,39854
13195054,13195053,TXFE7,128,9952,4,78260,38823,39857
13195129,13195127,TXFE7,128,9951,1,78261,38824,39858
13195167,13195162,TXFE7,128,9951,1,78262,38825,39859
13195304,13195295,TXFE7,128,9951,1,78263,38826,39860
13195842,13195841,TXFE7,128,9951,1,78264,38827,39861
13195867,13195858,TXFE7,128,9951,1,78265,38828,39862
13195917,13195911,TXFE7,128,9951,2,78267,38829,39863
13200004,13200001,TXFE7,128,9951,2,78269,38830,39864
13200029,13200028,TXFE7,128,9951,1,78270,38831,39865
13200042,13200033,TXFE7,128,9951,1,78271,38832,39866
13200054,13200047,TXFE7,129,9951,5,78281,38838,39867
13200054,13200047,TXFE7,129,9950,5,78281,38838,39867
13200079,13200070,TXFE7,128,9950,1,78282,38839,39868
13200092,13200088,TXFE7,128,9951,1,78283,38840,39869
13200104,13200102,TXFE7,128,9952,1,78284,38841,39870
13200142,13200139,TXFE7,128,9950,1,78285,38842,39871
13200142,13200139,TXFE7,128,9952,2,78287,38843,39872
13200179,13200169,TXFE7,128,9950,1,78288,38844,39873
13200267,13200262,TXFE7,128,9952,1,78289,38845,39874
13200304,13200304,TXFE7,128,9950,1,78290,38846,39875
13200317,13200312,TXFE7,128,9952,2,78292,38847,39877
13200392,13200386,TXFE7,128,9952,3,78295,38848,39879
13200604,13200604,TXFE7,128,9951,1,78296,38849,39880
13200617,13200612,TXFE7,128,9950,1,78297,38850,39881
13200829,13200817,TXFE7,128,9950,1,78298,38851,39882
13200904,13200904,TXFE7,128,9950,1,78299,38852,39883
13200929,13200918,TXFE7,128,9950,1,78300,38853,39884
13200929,13200924,TXFE7,128,9951,1,78301,38854,39885
13200954,13200947,TXFE7,128,9950,1,78302,38855,39886
13201204,13201204,TXFE7,128,9951,1,78303,38856,39887
13201254,13201243,TXFE7,128,9952,2,78305,38857,39889
13201504,13201504,TXFE7,128,9951,1,78306,38858,39890
13201804,13201804,TXFE7,128,9951,1,78307,38859,39891
13201867,13201864,TXFE7,128,9951,1,78308,38860,39892
13202042,13202030,TXFE7,128,9951,1,78309,38861,39893
13202104,13202104,TXFE7,128,9950,1,78310,38862,39894
13202154,13202143,TXFE7,128,9951,10,78320,38863,39899
13202179,13202178,TXFE7,128,9950,1,78321,38864,39900
13202179,13202179,TXFE7,128,9950,1,78322,38865,39901
13202404,13202397,TXFE7,128,9951,1,78323,38866,39902
13202404,13202404,TXFE7,128,9950,2,78325,38867,39903
13202454,13202444,TXFE7,128,9951,1,78326,38868,39904
13202592,13202586,TXFE7,128,9951,1,78327,38869,39905
13202692,13202683,TXFE7,128,9951,1,78328,38870,39906
13202704,13202704,TXFE7,128,9951,1,78329,38871,39907
13202792,13202786,TXFE7,128,9951,3,78332,38872,39908
13202854,13202853,TXFE7,128,9951,1,78333,38873,39909
13203004,13203004,TXFE7,128,9951,1,78334,38874,39910
13203142,13203142,TXFE7,128,9951,3,78337,38876,39911
13203204,13203201,TXFE7,128,9951,5,78342,38878,39912
13203229,13203227,TXFE7,128,9950,4,78346,38880,39913
13203267,13203264,TXFE7,128,9952,1,78347,38881,39914
13203304,13203304,TXFE7,128,9950,1,78348,38882,39915
13203604,13203604,TXFE7,128,9950,1,78349,38883,39916
13203867,13203864,TXFE7,128,9952,1,78350,38884,39917
13203904,13203904,TXFE7,128,9951,1,78351,38885,39918
13203917,13203913,TXFE7,128,9950,1,78352,38886,39919
13204204,13204204,TXFE7,128,9950,1,78353,38887,39920
13204379,13204372,TXFE7,128,9950,1,78354,38888,39921
13204392,13204388,TXFE7,128,9950,1,78355,38889,39922
13204429,13204424,TXFE7,128,9951,1,78356,38890,39923
13204504,13204497,TXFE7,128,9951,1,78357,38891,39924
13204504,13204504,TXFE7,128,9951,1,78358,38892,39925
13204517,13204508,TXFE7,128,9951,1,78359,38893,39926
13204617,13204605,TXFE7,128,9951,3,78362,38895,39927
13204629,13204628,TXFE7,128,9950,1,78363,38896,39928
13204642,13204630,TXFE7,128,9950,1,78364,38897,39929
13204704,13204700,TXFE7,128,9951,2,78366,38898,39931
13204804,13204804,TXFE7,128,9950,1,78367,38899,39932
13205104,13205104,TXFE7,128,9950,1,78368,38900,39933
13205404,13205404,TXFE7,128,9950,1,78369,38901,39934
13205417,13205407,TXFE7,128,9951,2,78371,38902,39935
13205704,13205704,TXFE7,128,9950,2,78373,38903,39936
13205729,13205725,TXFE7,128,9950,3,78376,38905,39937
13205867,13205855,TXFE7,128,9950,1,78377,38906,39938
13210004,13210004,TXFE7,128,9950,1,78378,38907,39939
13210242,13210236,TXFE7,128,9951,1,78379,38908,39940
13210292,13210281,TXFE7,128,9951,1,78380,38909,39941
13210304,13210304,TXFE7,128,9950,1,78381,38910,39942
13210317,13210313,TXFE7,128,9950,2,78383,38912,39943
13210604,13210604,TXFE7,128,9950,1,78384,38913,39944
13210904,13210904,TXFE7,128,9950,1,78385,38914,39945
13211179,13211169,TXFE7,128,9951,1,78386,38915,39946
13211204,13211204,TXFE7,128,9950,2,78388,38917,39947
13211267,13211259,TXFE7,128,9951,2,78390,38918,39949
13211392,13211387,TXFE7,128,9951,2,78392,38919,39950
13211504,13211504,TXFE7,128,9950,1,78393,38920,39951
13211567,13211562,TXFE7,128,9951,1,78394,38921,39952
13211804,13211804,TXFE7,128,9950,1,78395,38922,39953
13211979,13211976,TXFE7,128,9951,1,78396,38923,39954
13212104,13212104,TXFE7,128,9950,1,78397,38924,39955
13212404,13212404,TXFE7,128,9950,1,78398,38925,39956
13212692,13212686,TXFE7,128,9951,2,78400,38926,39957
13212704,13212694,TXFE7,128,9950,1,78401,38927,39958
13212704,13212695,TXFE7,128,9950,1,78402,38928,39959
13212704,13212704,TXFE7,128,9950,2,78404,38930,39960
13213004,13213004,TXFE7,128,9950,1,78405,38931,39961
13213304,13213304,TXFE7,128,9950,1,78406,38932,39962
13213604,13213604,TXFE7,128,9950,1,78407,38933,39963
13213904,13213904,TXFE7,128,9950,1,78408,38934,39964
13214204,13214204,TXFE7,128,9950,1,78409,38935,39965
13214217,13214215,TXFE7,128,9950,1,78410,38936,39966
13214267,13214255,TXFE7,128,9951,1,78411,38937,39967
13214504,13214504,TXFE7,128,9950,2,78413,38939,39968
13214804,13214804,TXFE7,128,9950,1,78414,38940,39969
13215104,13215104,TXFE7,128,9950,1,78415,38941,39970
13215404,13215404,TXFE7,128,9950,1,78416,38942,39971
13215417,13215407,TXFE7,128,9950,1,78417,38943,39972
13215592,13215591,TXFE7,128,9951,1,78418,38944,39973
13215704,13215704,TXFE7,128,9950,1,78419,38945,39974
13215754,13215745,TXFE7,128,9950,1,78420,38946,39975
13220004,13220004,TXFE7,128,9950,2,78422,38947,39976
13220304,13220304,TXFE7,128,9950,1,78423,38948,39977
13220579,13220577,TXFE7,128,9951,1,78424,38949,39978
13220604,13220604,TXFE7,128,9950,1,78425,38950,39979
13220704,13220693,TXFE7,128,9951,3,78428,38951,39982
13220717,13220707,TXFE7,128,9951,12,78440,38952,39987
13220729,13220717,TXFE7,128,9951,10,78450,38953,39997
13220729,13220728,TXFE7,128,9950,1,78451,38954,39998
13220742,13220729,TXFE7,128,9951,2,78453,38955,40000
13220742,13220730,TXFE7,128,9951,1,78454,38956,40001
13220904,13220904,TXFE7,128,9951,1,78455,38957,40002
13221079,13221068,TXFE7,128,9952,1,78456,38958,40003
13221204,13221204,TXFE7,128,9951,1,78457,38959,40004
13221504,13221504,TXFE7,128,9951,1,78458,38960,40005
13221729,13221720,TXFE7,128,9951,1,78459,38961,40006
13221804,13221804,TXFE7,128,9951,2,78461,38962,40007
13222104,13222104,TXFE7,128,9951,1,78462,38963,40008
13222404,13222404,TXFE7,128,9951,1,78463,38964,40009
13222617,13222608,TXFE7,128,9952,1,78464,38965,40010
13222642,13222633,TXFE7,128,9952,4,78468,38966,40013
13222642,13222633,TXFE7,128,9952,2,78470,38967,40014
13222642,13222636,TXFE7,128,9952,2,78472,38968,40016
13222642,13222636,TXFE7,128,9952,6,78478,38969,40022
13222642,13222638,TXFE7,128,9952,6,78484,38970,40026
13222654,13222645,TXFE7,128,9951,1,78485,38971,40027
13222654,13222646,TXFE7,128,9951,1,78486,38972,40028
13222654,13222647,TXFE7,128,9951,1,78487,38973,40029
13222704,13222704,TXFE7,128,9951,1,78488,38974,40030
13222817,13222814,TXFE7,128,9951,1,78489,38975,40031
13222892,13222891,TXFE7,128,9952,4,78493,38976,40035
13222929,13222917,TXFE7,128,9952,2,78495,38977,40036
13222967,13222961,TXFE7,128,9951,1,78496,38978,40037
13223004,13223004,TXFE7,128,9951,1,78497,38979,40038
13223167,13223157,TXFE7,128,9952,4,78501,38980,40042
13223304,13223304,TXFE7,128,9951,2,78503,38981,40043
13223442,13223434,TXFE7,128,9952,3,78506,38982,40046
13223604,13223604,TXFE7,128,9951,1,78507,38983,40047
13223904,13223904,TXFE7,128,9951,1,78508,38984,40048
13224167,13224165,TXFE7,128,9952,1,78509,38985,40049
13224204,13224204,TXFE7,128,9951,1,78510,38986,40050
13224292,13224291,TXFE7,128,9952,1,78511,38987,40051
13224429,13224420,TXFE7,128,9951,1,78512,38988,40052
13224504,13224504,TXFE7,128,9951,1,78513,38989,40053
13224542,13224539,TXFE7,128,9952,1,78514,38990,40054
13224804,13224804,TXFE7,128,9951,1,78515,38991,40055
13224967,13224956,TXFE7,128,9952,1,78516,38992,40056
13225104,13225104,TXFE7,128,9951,2,78518,38994,40057
13225404,13225404,TXFE7,128,9951,1,78519,38995,40058
13225442,13225439,TXFE7,128,9952,1,78520,38996,40059
13225467,13225459,TXFE7,128,9951,1,78521,38997,40060
13225467,13225465,TXFE7,128,9951,1,78522,38998,40061
13225617,13225608,TXFE7,128,9951,1,78523,38999,40062
13225704,13225704,TXFE7,128,9951,1,78524,39000,40063
13225717,13225708,TXFE7,128,9951,2,78526,39002,40064
13225717,13225710,TXFE7,128,9951,1,78527,39003,40065
13225842,13225831,TXFE7,128,9952,10,78537,39004,40069
13225867,13225856,TXFE7,128,9951,1,78538,39005,40070
13230004,13230002,TXFE7,128,9952,1,78539,39006,40071
13230004,13230004,TXFE7,128,9951,1,78540,39007,40072
13230304,13230304,TXFE7,128,9951,1,78541,39008,40073
13230467,13230460,TXFE7,128,9952,1,78542,39009,40074
13230604,13230604,TXFE7,128,9951,2,78544,39010,40075
13230904,13230895,TXFE7,128,9952,1,78545,39011,40076
13230904,13230904,TXFE7,128,9951,1,78546,39012,40077
13231004,13230995,TXFE7,128,9952,1,78547,39013,40078
13231129,13231128,TXFE7,128,9952,1,78548,39014,40079
13231154,13231145,TXFE7,128,9952,1,78549,39015,40080
13231167,13231161,TXFE7,128,9952,3,78552,39016,40081
13231167,13231163,TXFE7,128,9952,1,78553,39017,40082
13231204,13231204,TXFE7,128,9951,1,78554,39018,40083
13231217,13231206,TXFE7,128,9952,2,78556,39019,40084
13231229,13231217,TXFE7,128,9951,1,78557,39020,40085
13231429,13231420,TXFE7,128,9952,2,78559,39021,40086
13231504,13231504,TXFE7,128,9951,1,78560,39022,40087
13231517,13231514,TXFE7,128,9951,1,78561,39023,40088
13231529,13231518,TXFE7,128,9951,1,78562,39024,40089
13231542,13231534,TXFE7,128,9952,3,78565,39025,40090
13231804,13231804,TXFE7,128,9951,1,78566,39026,40091
13231879,13231879,TXFE7,128,9951,1,78567,39027,40092
13232042,13232040,TXFE7,128,9952,6,78573,39028,40093
13232104,13232104,TXFE7,128,9951,2,78575,39030,40094
13232292,13232283,TXFE7,128,9952,2,78577,39031,40095
13232304,13232297,TXFE7,128,9952,2,78579,39032,40096
13232404,13232404,TXFE7,128,9951,1,78580,39033,40097
13232417,13232408,TXFE7,128,9952,1,78581,39034,40098
13232504,13232496,TXFE7,128,9951,2,78583,39036,40099
13232617,13232608,TXFE7,128,9952,8,78591,39037,40104
13232629,13232621,TXFE7,128,9951,1,78592,39038,40105
13232667,13232656,TXFE7,128,9952,6,78598,39039,40109
13232704,13232704,TXFE7,128,9951,1,78599,39040,40110
13233004,13233004,TXFE7,128,9951,1,78600,39041,40111
13233017,13233008,TXFE7,128,9951,1,78601,39042,40112
13233017,13233009,TXFE7,128,9951,1,78602,39043,40113
13233154,13233147,TXFE7,128,9952,1,78603,39044,40114
13233179,13233174,TXFE7,128,9952,5,78608,39045,40117
13233304,13233296,TXFE7,128,9952,1,78609,39046,40118
13233304,13233304,TXFE7,128,9951,1,78610,39047,40119
13233354,13233349,TXFE7,128,9952,3,78613,39048,40121
13233454,13233454,TXFE7,128,9952,1,78614,39049,40122
13233592,13233584,TXFE7,128,9952,1,78615,39050,40123
13233604,13233604,TXFE7,128,9951,1,78616,39051,40124
13233879,13233869,TXFE7,128,9952,1,78617,39052,40125
13233904,13233904,TXFE7,128,9951,2,78619,39053,40126
13234004,13233993,TXFE7,128,9952,3,78622,39054,40128
13234129,13234120,TXFE7,128,9952,1,78623,39055,40129
13234167,13234167,TXFE7,128,9952,2,78625,39056,40130
13234179,13234168,TXFE7,128,9952,2,78627,39057,40132
13234204,13234204,TXFE7,128,9951,1,78628,39058,40133
13234217,13234214,TXFE7,128,9952,1,78629,39059,40134
13234479,13234472,TXFE7,128,9952,3,78632,39060,40137
13234504,13234500,TXFE7,128,9951,2,78634,39061,40138
13234504,13234504,TXFE7,128,9951,1,78635,39062,40139
13234804,13234803,TXFE7,128,9951,1,78636,39063,40140
13234929,13234928,TXFE7,128,9952,1,78637,39064,40141
13234954,13234949,TXFE7,128,9952,1,78638,39065,40142
13234954,13234954,TXFE7,128,9952,2,78640,39066,40143
13234967,13234955,TXFE7,128,9952,4,78644,39067,40145
13234967,13234957,TXFE7,128,9951,1,78645,39068,40146
13234967,13234958,TXFE7,128,9951,1,78646,39069,40147
13234979,13234968,TXFE7,128,9952,2,78648,39070,40148
13234992,13234983,TXFE7,128,9952,2,78650,39071,40149
13235004,13234998,TXFE7,128,9952,1,78651,39072,40150
13235004,13235002,TXFE7,128,9952,1,78652,39073,40151
13235017,13235004,TXFE7,128,9952,4,78656,39074,40152
13235104,13235104,TXFE7,128,9952,1,78657,39075,40153
13235142,13235138,TXFE7,128,9952,2,78659,39076,40154
13235404,13235404,TXFE7,128,9951,2,78661,39077,40155
13235429,13235421,TXFE7,128,9952,2,78663,39078,40156
13235654,13235654,TXFE7,128,9952,1,78664,39079,40157
13235704,13235704,TXFE7,128,9951,1,78665,39080,40158
13235717,13235715,TXFE7,128,9951,1,78666,39081,40159
13235967,13235955,TXFE7,128,9952,1,78667,39082,40160
13240004,13240004,TXFE7,128,9951,1,78668,39083,40161
13240017,13240015,TXFE7,128,9952,4,78672,39084,40162
13240179,13240167,TXFE7,128,9952,21,78693,39085,40170
13240192,13240182,TXFE7,128,9952,1,78694,39086,40171
13240192,13240183,TXFE7,128,9952,1,78695,39087,40172
13240217,13240207,TXFE7,128,9952,1,78696,39088,40173
13240229,13240222,TXFE7,128,9953,3,78699,39089,40174
13240254,13240246,TXFE7,128,9952,3,78702,39090,40175
13240279,13240275,TXFE7,128,9953,3,78705,39091,40176
13240304,13240304,TXFE7,128,9952,1,78706,39092,40177
13240317,13240311,TXFE7,128,9952,1,78707,39093,40178
13240554,13240544,TXFE7,128,9952,1,78708,39094,40179
13240604,13240595,TXFE7,128,9952,2,78710,39095,40180
13240604,13240604,TXFE7,128,9952,1,78711,39096,40181
13240617,13240608,TXFE7,128,9952,2,78713,39097,40182
13240704,13240700,TXFE7,128,9953,1,78714,39098,40183
13240854,13240846,TXFE7,128,9953,1,78715,39099,40184
13240904,13240904,TXFE7,128,9952,1,78716,39100,40185
13241092,13241082,TXFE7,128,9953,1,78717,39101,40186
13241142,13241137,TXFE7,128,9953,3,78720,39102,40187
13241142,13241140,TXFE7,128,9953,22,78742,39103,40199
13241154,13241142,TXFE7,128,9953,2,78744,39104,40201
13241154,13241145,TXFE7,128,9952,1,78745,39105,40202
13241154,13241146,TXFE7,128,9953,2,78747,39106,40204
13241154,13241146,TXFE7,128,9953,3,78750,39107,40207
13241154,13241146,TXFE7,128,9953,2,78752,39108,40209
13241154,13241146,TXFE7,128,9953,2,78754,39109,40211
13241154,13241146,TXFE7,128,9953,1,78755,39110,40212
13241154,13241146,TXFE7,128,9953,1,78756,39111,40213
13241154,13241146,TXFE7,128,9953,3,78759,39112,40215
13241154,13241146,TXFE7,128,9953,1,78760,39113,40216
13241154,13241147,TXFE7,128,9953,15,78775,39114,40218
13241154,13241147,TXFE7,128,9953,2,78777,39115,40219
13241154,13241147,TXFE7,128,9953,2,78779,39116,40220
13241167,13241154,TXFE7,128,9953,8,78787,39117,40225
13241167,13241154,TXFE7,128,9953,1,78788,39118,40226
13241167,13241154,TXFE7,128,9953,16,78804,39119,40238
13241167,13241155,TXFE7,128,9953,6,78810,39120,40243
13241167,13241156,TXFE7,128,9954,2,78812,39121,40244
13241167,13241159,TXFE7,128,9953,1,78813,39122,40245
13241167,13241159,TXFE7,128,9953,1,78814,39123,40246
13241167,13241160,TXFE7,128,9953,1,78815,39124,40247
13241167,13241160,TXFE7,128,9953,1,78816,39125,40248
13241179,13241172,TXFE7,128,9953,1,78817,39126,40249
13241179,13241172,TXFE7,128,9953,1,78818,39127,40250
13241192,13241186,TXFE7,128,9953,5,78823,39129,40251
13241204,13241195,TXFE7,128,9953,1,78824,39130,40252
13241204,13241204,TXFE7,128,9953,2,78826,39131,40253
13241217,13241206,TXFE7,128,9953,1,78827,39132,40254
13241217,13241212,TXFE7,128,9954,8,78835,39133,40260
13241217,13241212,TXFE7,128,9954,6,78841,39134,40264
13241217,13241212,TXFE7,128,9954,2,78843,39135,40265
13241217,13241216,TXFE7,128,9954,2,78845,39136,40267
13241229,13241220,TXFE7,128,9953,1,78846,39137,40268
13241229,13241221,TXFE7,128,9953,1,78847,39138,40269
13241229,13241225,TXFE7,128,9953,1,78848,39139,40270
13241367,13241356,TXFE7,128,9954,1,78849,39140,40271
13241392,13241381,TXFE7,128,9953,3,78852,39141,40272
13241492,13241479,TXFE7,128,9954,1,78853,39142,40273
13241504,13241496,TXFE7,128,9954,1,78854,39143,40274
13241504,13241497,TXFE7,128,9954,1,78855,39144,40275
13241504,13241504,TXFE7,128,9953,1,78856,39145,40276
13241517,13241504,TXFE7,128,9954,1,78857,39146,40277
13241592,13241581,TXFE7,128,9954,1,78858,39147,40278
13241679,13241677,TXFE7,128,9954,1,78859,39148,40279
13241692,13241681,TXFE7,128,9954,1,78860,39149,40280
13241804,13241804,TXFE7,128,9953,1,78861,39150,40281
13241817,13241805,TXFE7,128,9954,1,78862,39151,40282
13241817,13241807,TXFE7,128,9954,1,78863,39152,40283
13241817,13241808,TXFE7,128,9954,1,78864,39153,40284
13241817,13241809,TXFE7,128,9954,1,78865,39154,40285
13242104,13242104,TXFE7,128,9953,1,78866,39155,40286
13242142,13242138,TXFE7,128,9953,1,78867,39156,40287
13242267,13242256,TXFE7,128,9953,1,78868,39157,40288
13242267,13242258,TXFE7,128,9954,1,78869,39158,40289
13242404,13242404,TXFE7,128,9953,1,78870,39159,40290
13242454,13242446,TXFE7,128,9953,11,78881,39167,40291
13242467,13242459,TXFE7,128,9953,1,78882,39168,40292
13242467,13242460,TXFE7,128,9953,1,78883,39169,40293
13242467,13242462,TXFE7,128,9953,1,78884,39170,40294
13242504,13242497,TXFE7,128,9953,3,78887,39171,40295
13242517,13242510,TXFE7,128,9952,2,78889,39173,40296
13242617,13242615,TXFE7,128,9953,2,78891,39174,40297
13242704,13242704,TXFE7,128,9953,2,78893,39175,40298
13242717,13242712,TXFE7,128,9954,1,78894,39176,40299
13243004,13243001,TXFE7,128,9953,3,78897,39179,40300
13243004,13243004,TXFE7,128,9953,1,78898,39180,40301
13243029,13243024,TXFE7,128,9954,1,78899,39181,40302
13243154,13243143,TXFE7,128,9953,5,78904,39182,40303
13243192,13243184,TXFE7,128,9953,1,78905,39183,40304
13243267,13243258,TXFE7,128,9954,1,78906,39184,40305
13243304,13243304,TXFE7,128,9953,1,78907,39185,40306
13243504,13243499,TXFE7,128,9953,2,78909,39186,40307
13243604,13243604,TXFE7,128,9953,1,78910,39187,40308
13243754,13243745,TXFE7,128,9953,1,78911,39188,40309
13243904,13243904,TXFE7,128,9953,1,78912,39189,40310
13244204,13244204,TXFE7,128,9953,1,78913,39190,40311
13244504,13244504,TXFE7,128,9953,2,78915,39192,40312
13244567,13244567,TXFE7,128,9954,5,78920,39193,40314
13244579,13244571,TXFE7,128,9953,1,78921,39194,40315
13244579,13244572,TXFE7,128,9953,1,78922,39195,40316
13244804,13244804,TXFE7,128,9953,1,78923,39196,40317
13244817,13244811,TXFE7,128,9954,1,78924,39197,40318
13245104,13245104,TXFE7,128,9953,1,78925,39198,40319
13245117,13245115,TXFE7,128,9954,25,78950,39199,40333
13245142,13245130,TXFE7,128,9953,1,78951,39200,40334
13245142,13245133,TXFE7,128,9954,3,78954,39201,40337
13245167,13245166,TXFE7,128,9953,1,78955,39202,40338
13245354,13245349,TXFE7,128,9954,1,78956,39203,40339
13245404,13245404,TXFE7,128,9953,1,78957,39204,40340
13245567,13245562,TXFE7,128,9954,1,78958,39205,40341
13245579,13245576,TXFE7,128,9953,2,78960,39207,40342
13245592,13245591,TXFE7,128,9953,1,78961,39208,40343
13245604,13245592,TXFE7,128,9953,1,78962,39209,40344
13245704,13245704,TXFE7,128,9953,1,78963,39210,40345
13245767,13245760,TXFE7,128,9954,1,78964,39211,40346
13245917,13245916,TXFE7,128,9954,3,78967,39212,40348
13250004,13245993,TXFE7,128,9954,1,78968,39213,40349
13250004,13250003,TXFE7,128,9953,2,78970,39214,40350
13250017,13250008,TXFE7,128,9953,1,78971,39215,40351
13250017,13250008,TXFE7,128,9953,1,78972,39216,40352
13250017,13250009,TXFE7,128,9954,1,78973,39217,40353
13250029,13250019,TXFE7,128,9953,12,78985,39225,40354
13250129,13250123,TXFE7,128,9954,1,78986,39226,40355
13250129,13250125,TXFE7,128,9953,8,78994,39231,40356
13250154,13250147,TXFE7,128,9953,2,78996,39232,40357
13250167,13250158,TXFE7,128,9953,1,78997,39233,40358
13250179,13250169,TXFE7,128,9953,1,78998,39234,40359
13250192,13250187,TXFE7,128,9954,2,79000,39235,40361
13250204,13250198,TXFE7,128,9953,1,79001,39236,40362
13250217,13250214,TXFE7,128,9953,1,79002,39237,40363
13250304,13250304,TXFE7,128,9953,1,79003,39238,40364
13250317,13250306,TXFE7,128,9954,1,79004,39239,40365
13250329,13250321,TXFE7,128,9954,2,79006,39240,40367
13250604,13250604,TXFE7,128,9953,1,79007,39241,40368
13250667,13250659,TXFE7,128,9954,1,79008,39242,40369
13250679,13250671,TXFE7,128,9954,1,79009,39243,40370
13250692,13250691,TXFE7,128,9954,3,79012,39244,40373
13250704,13250701,TXFE7,128,9954,4,79016,39245,40376
13250729,13250723,TXFE7,128,9954,1,79017,39246,40377
13250779,13250768,TXFE7,128,9954,1,79018,39247,40378
13250904,13250904,TXFE7,128,9953,1,79019,39248,40379
13250917,13250910,TXFE7,128,9954,1,79020,39249,40380
13250954,13250944,TXFE7,128,9953,1,79021,39250,40381
13250954,13250947,TXFE7,128,9953,1,79022,39251,40382
13250954,13250948,TXFE7,128,9953,1,79023,39252,40383
13251067,13251065,TXFE7,128,9953,1,79024,39253,40384
13251092,13251092,TXFE7,128,9954,1,79025,39254,40385
13251204,13251204,TXFE7,128,9953,1,79026,39255,40386
13251279,13251275,TXFE7,128,9954,6,79032,39256,40391
13251417,13251411,TXFE7,128,9953,1,79033,39257,40392
13251504,13251504,TXFE7,128,9953,2,79035,39258,40393
13251517,13251506,TXFE7,128,9954,1,79036,39259,40394
13251804,13251803,TXFE7,128,9953,1,79037,39260,40395
13251867,13251860,TXFE7,128,9954,1,79038,39261,40396
13252104,13252104,TXFE7,128,9953,1,79039,39262,40397
13252379,13252370,TXFE7,128,9954,1,79040,39263,40398
13252392,13252387,TXFE7,128,9953,1,79041,39264,40399
13252392,13252389,TXFE7,128,9953,1,79042,39265,40400
13252404,13252404,TXFE7,128,9953,1,79043,39266,40401
13252442,13252432,TXFE7,128,9954,1,79044,39267,40402
13252692,13252682,TXFE7,128,9954,1,79045,39268,40403
13252692,13252685,TXFE7,128,9953,1,79046,39269,40404
13252704,13252704,TXFE7,128,9953,1,79047,39270,40405
13252729,13252722,TXFE7,128,9953,2,79049,39272,40406
13252742,13252736,TXFE7,128,9953,2,79051,39273,40407
13252817,13252810,TXFE7,128,9953,1,79052,39274,40408
13252842,13252833,TXFE7,128,9953,1,79053,39275,40409
13252854,13252847,TXFE7,128,9953,3,79056,39277,40410
13252867,13252858,TXFE7,128,9953,1,79057,39278,40411
13252867,13252859,TXFE7,128,9953,1,79058,39279,40412
13252867,13252859,TXFE7,128,9953,11,79069,39287,40413
13252879,13252867,TXFE7,128,9953,1,79070,39288,40414
13252879,13252867,TXFE7,128,9953,2,79072,39289,40415
13252879,13252871,TXFE7,128,9953,1,79073,39290,40416
13252892,13252884,TXFE7,128,9953,4,79077,39292,40417
13252892,13252890,TXFE7,128,9954,2,79079,39293,40418
13252967,13252958,TXFE7,128,9954,1,79080,39294,40419
13252979,13252970,TXFE7,128,9953,1,79081,39295,40420
13252979,13252971,TXFE7,128,9953,1,79082,39296,40421
13253004,13252994,TXFE7,128,9953,1,79083,39297,40422
13253004,13253003,TXFE7,128,9953,1,79084,39298,40423
13253117,13253106,TXFE7,128,9953,2,79086,39299,40424
13253117,13253113,TXFE7,128,9953,4,79090,39301,40425
13253154,13253150,TXFE7,128,9953,1,79091,39302,40426
13253204,13253192,TXFE7,128,9953,1,79092,39303,40427
13253304,13253304,TXFE7,128,9952,2,79094,39304,40428
13253367,13253361,TXFE7,128,9952,2,79096,39305,40429
13253392,13253388,TXFE7,128,9953,2,79098,39306,40431
13253604,13253604,TXFE7,128,9952,1,79099,39307,40432
13253617,13253617,TXFE7,128,9953,2,79101,39308,40434
13253629,13253624,TXFE7,128,9953,29,79130,39309,40439
13253642,13253629,TXFE7,128,9953,1,79131,39310,40440
13253642,13253629,TXFE7,128,9953,8,79139,39311,40444
13253654,13253642,TXFE7,128,9953,5,79144,39312,40445
13253654,13253646,TXFE7,128,9952,1,79145,39313,40446
13253654,13253647,TXFE7,128,9952,1,79146,39314,40447
13253654,13253648,TXFE7,128,9952,1,79147,39315,40448
13253654,13253653,TXFE7,128,9954,1,79148,39316,40449
13253667,13253661,TXFE7,128,9954,3,79151,39317,40452
13253679,13253671,TXFE7,128,9954,1,79152,39318,40453
13253679,13253678,TXFE7,128,9954,1,79153,39319,40454
13253742,13253739,TXFE7,128,9954,5,79158,39320,40455
13253792,13253783,TXFE7,128,9953,1,79159,39321,40456
13253817,13253811,TXFE7,128,9954,5,79164,39322,40459
13253842,13253831,TXFE7,128,9954,1,79165,39323,40460
13253842,13253838,TXFE7,128,9953,1,79166,39324,40461
13253842,13253839,TXFE7,128,9953,1,79167,39325,40462
13253892,13253884,TXFE7,128,9954,10,79177,39326,40466
13253904,13253897,TXFE7,128,9954,8,79185,39327,40471
13253904,13253903,TXFE7,128,9953,1,79186,39328,40472
13253917,13253905,TXFE7,128,9953,1,79187,39329,40473
13253954,13253947,TXFE7,128,9953,1,79188,39330,40474
13253992,13253981,TXFE7,128,9954,1,79189,39331,40475
13254017,13254015,TXFE7,128,9954,4,79193,39332,40479
13254042,13254031,TXFE7,128,9954,2,79195,39333,40481
13254142,13254135,TXFE7,128,9954,3,79198,39334,40484
13254204,13254204,TXFE7,128,9953,1,79199,39335,40485
13254292,13254284,TXFE7,128,9954,2,79201,39336,40486
13254304,13254297,TXFE7,128,9953,1,79202,39337,40487
13254304,13254297,TXFE7,128,9954,1,79203,39338,40488
13254304,13254297,TXFE7,128,9953,1,79204,39339,40489
13254404,13254394,TXFE7,128,9953,1,79205,39340,40490
13254504,13254504,TXFE7,128,9953,1,79206,39341,40491
13254579,13254570,TXFE7,128,9954,2,79208,39342,40493
13254592,13254587,TXFE7,128,9954,2,79210,39343,40495
13254804,13254804,TXFE7,128,9953,2,79212,39345,40496
13255017,13255006,TXFE7,128,9954,2,79214,39346,40497
13255104,13255104,TXFE7,128,9953,1,79215,39347,40498
13255404,13255404,TXFE7,128,9953,1,79216,39348,40499
13255442,13255438,TXFE7,128,9954,48,79264,39349,40520
13255454,13255449,TXFE7,128,9954,1,79265,39350,40521
13255454,13255451,TXFE7,128,9954,1,79266,39351,40522
13255454,13255454,TXFE7,128,9954,1,79267,39352,40523
13255504,13255494,TXFE7,128,9954,1,79268,39353,40524
13255542,13255535,TXFE7,128,9955,2,79270,39354,40525
13255704,13255704,TXFE7,128,9954,1,79271,39355,40526
13255767,13255766,TXFE7,128,9954,1,79272,39356,40527
13260004,13260004,TXFE7,128,9954,1,79273,39357,40528
13260217,13260216,TXFE7,128,9955,1,79274,39358,40529
13260304,13260304,TXFE7,128,9954,1,79275,39359,40530
13260342,13260336,TXFE7,128,9955,24,79299,39360,40537
13260354,13260347,TXFE7,128,9955,24,79323,39361,40553
13260379,13260368,TXFE7,128,9954,1,79324,39362,40554
13260379,13260369,TXFE7,128,9954,1,79325,39363,40555
13260379,13260370,TXFE7,128,9954,1,79326,39364,40556
13260392,13260382,TXFE7,128,9955,1,79327,39365,40557
13260429,13260428,TXFE7,128,9955,1,79328,39366,40558
13260454,13260447,TXFE7,128,9955,5,79333,39367,40559
13260542,13260541,TXFE7,128,9955,5,79338,39368,40560
13260604,13260603,TXFE7,128,9954,2,79340,39369,40561
13260629,13260623,TXFE7,128,9955,1,79341,39370,40562
13260704,13260696,TXFE7,128,9954,1,79342,39371,40563
13260742,13260740,TXFE7,128,9955,5,79347,39372,40564
13260767,13260755,TXFE7,128,9954,1,79348,39373,40565
13260792,13260783,TXFE7,128,9955,1,79349,39374,40566
13260854,13260852,TXFE7,128,9955,1,79350,39375,40567
13260904,13260904,TXFE7,128,9954,1,79351,39376,40568
13260917,13260916,TXFE7,128,9955,2,79353,39377,40569
13261004,13261003,TXFE7,128,9954,5,79358,39378,40570
13261067,13261066,TXFE7,128,9955,1,79359,39379,40571
13261104,13261093,TXFE7,128,9955,2,79361,39380,40572
13261117,13261112,TXFE7,128,9954,1,79362,39381,40573
13261192,13261188,TXFE7,128,9955,5,79367,39382,40578
13261204,13261201,TXFE7,128,9954,1,79368,39383,40579
13261204,13261204,TXFE7,128,9954,1,79369,39384,40580
13261329,13261317,TXFE7,128,9955,1,79370,39385,40581
13261454,13261454,TXFE7,128,9954,2,79372,39386,40582
13261504,13261504,TXFE7,128,9954,1,79373,39387,40583
13261629,13261624,TXFE7,128,9955,1,79374,39388,40584
13261804,13261804,TXFE7,128,9954,1,79375,39389,40585
13262104,13262104,TXFE7,128,9954,2,79377,39390,40586
13262142,13262139,TXFE7,128,9955,1,79378,39391,40587
13262179,13262169,TXFE7,128,9954,1,79379,39392,40588
13262267,13262264,TXFE7,128,9954,1,79380,39393,40589
13262404,13262403,TXFE7,128,9954,1,79381,39394,40590
13262479,13262476,TXFE7,128,9954,2,79383,39396,40591
13262504,13262502,TXFE7,128,9955,1,79384,39397,40592
13262604,13262604,TXFE7,128,9954,1,79385,39398,40593
13262704,13262704,TXFE7,128,9954,1,79386,39399,40594
13262804,13262798,TXFE7,128,9955,1,79387,39400,40595
13262892,13262886,TXFE7,128,9954,5,79392,39403,40596
13263004,13263004,TXFE7,128,9954,1,79393,39404,40597
13263079,13263075,TXFE7,128,9955,1,79394,39405,40598
13263292,13263290,TXFE7,128,9955,2,79396,39406,40600
13263304,13263304,TXFE7,128,9954,1,79397,39407,40601
13263467,13263463,TXFE7,128,9954,40,79437,39429,40602
13263479,13263467,TXFE7,128,9954,26,79463,39440,40603
13263479,13263470,TXFE7,128,9953,1,79464,39441,40604
13263479,13263473,TXFE7,128,9953,1,79465,39442,40605
13263492,13263485,TXFE7,128,9954,5,79470,39443,40607
13263492,13263491,TXFE7,128,9953,1,79471,39444,40608
13263504,13263495,TXFE7,128,9953,1,79472,39445,40609
13263504,13263496,TXFE7,128,9954,5,79477,39446,40611
13263517,13263505,TXFE7,128,9954,1,79478,39447,40612
13263529,13263520,TXFE7,128,9954,1,79479,39448,40613
13263529,13263520,TXFE7,128,9954,10,79489,39449,40616
13263542,13263537,TXFE7,128,9954,2,79491,39450,40617
13263554,13263546,TXFE7,128,9953,1,79492,39451,40618
13263604,13263603,TXFE7,128,9953,1,79493,39452,40619
13263617,13263608,TXFE7,128,9954,1,79494,39453,40620
13263692,13263686,TXFE7,128,9954,1,79495,39454,40621
13263742,13263734,TXFE7,128,9954,1,79496,39455,40622
13263767,13263760,TXFE7,128,9954,5,79501,39456,40625
13263767,13263764,TXFE7,128,9954,3,79504,39457,40626
13263904,13263903,TXFE7,128,9953,2,79506,39458,40627
13264042,13264033,TXFE7,128,9954,1,79507,39459,40628
13264204,13264196,TXFE7,128,9954,4,79511,39460,40630
13264204,13264203,TXFE7,128,9953,1,79512,39461,40631
13264504,13264504,TXFE7,128,9953,1,79513,39462,40632
13264667,13264661,TXFE7,128,9953,5,79518,39464,40633
13264679,13264676,TXFE7,128,9953,1,79519,39465,40634
13264804,13264804,TXFE7,128,9953,1,79520,39466,40635
13264817,13264816,TXFE7,128,9953,1,79521,39467,40636
13264942,13264933,TXFE7,128,9954,4,79525,39468,40637
13265104,13265104,TXFE7,128,9953,1,79526,39469,40638
13265404,13265404,TXFE7,128,9953,2,79528,39471,40639
13265704,13265704,TXFE7,128,9953,1,79529,39472,40640
13265729,13265728,TXFE7,128,9954,1,79530,39473,40641
13265817,13265809,TXFE7,128,9953,7,79537,39476,40642
13265879,13265877,TXFE7,128,9953,2,79539,39477,40643
13265892,13265892,TXFE7,128,9953,1,79540,39478,40644
13270004,13270004,TXFE7,128,9953,1,79541,39479,40645
13270017,13270016,TXFE7,128,9953,7,79548,39480,40646
13270042,13270041,TXFE7,128,9953,2,79550,39481,40647
13270304,13270304,TXFE7,128,9953,1,79551,39482,40648
13270342,13270334,TXFE7,128,9954,1,79552,39483,40649
13270342,13270335,TXFE7,128,9953,5,79557,39484,40650
13270354,13270344,TXFE7,128,9954,3,79560,39485,40651
13270354,13270350,TXFE7,128,9953,3,79563,39486,40652
13270379,13270368,TXFE7,128,9953,1,79564,39487,40653
13270554,13270554,TXFE7,128,9954,4,79568,39488,40654
13270604,13270604,TXFE7,128,9953,1,79569,39489,40655
13270654,13270650,TXFE7,128,9953,1,79570,39490,40656
13270904,13270904,TXFE7,128,9953,2,79572,39491,40657
13271079,13271070,TXFE7,128,9954,1,79573,39492,40658
13271142,13271136,TXFE7,128,9954,4,79577,39493,40659
13271167,13271157,TXFE7,128,9954,1,79578,39494,40660
13271167,13271157,TXFE7,128,9953,1,79579,39495,40661
13271204,13271203,TXFE7,128,9954,1,79580,39496,40662
13271204,13271203,TXFE7,128,9953,1,79581,39497,40663
13271504,13271503,TXFE7,128,9953,1,79582,39498,40664
13271804,13271804,TXFE7,128,9953,1,79583,39499,40665
13272092,13272088,TXFE7,128,9954,1,79584,39500,40666
13272104,13272104,TXFE7,128,9953,1,79585,39501,40667
13272217,13272215,TXFE7,128,9954,1,79586,39502,40668
13272317,13272307,TXFE7,128,9953,1,79587,39503,40669
13272404,13272404,TXFE7,128,9953,1,79588,39504,40670
13272479,13272470,TXFE7,128,9953,2,79590,39505,40671
13272554,13272553,TXFE7,128,9953,2,79592,39506,40672
13272642,13272629,TXFE7,128,9953,1,79593,39507,40673
13272704,13272704,TXFE7,128,9953,2,79595,39509,40674
13272867,13272856,TXFE7,128,9953,1,79596,39510,40675
13272967,13272957,TXFE7,128,9953,67,79663,39539,40676
13272979,13272972,TXFE7,128,9953,5,79668,39540,40677
13272979,13272978,TXFE7,128,9952,1,79669,39541,40678
13272979,13272979,TXFE7,128,9952,1,79670,39542,40679
13272992,13272980,TXFE7,128,9952,1,79671,39543,40680
13273004,13273004,TXFE7,128,9952,1,79672,39544,40681
13273017,13273007,TXFE7,128,9953,1,79673,39545,40682
13273154,13273152,TXFE7,128,9953,1,79674,39546,40683
13273154,13273153,TXFE7,128,9953,1,79675,39547,40684
13273192,13273187,TXFE7,128,9953,5,79680,39548,40686
13273204,13273199,TXFE7,128,9953,5,79685,39549,40689
13273204,13273201,TXFE7,128,9952,1,79686,39550,40690
13273217,13273211,TXFE7,128,9953,5,79691,39551,40691
13273229,13273226,TXFE7,128,9953,4,79695,39552,40692
13273254,13273243,TXFE7,128,9952,1,79696,39553,40693
13273304,13273304,TXFE7,128,9952,1,79697,39554,40694
13273329,13273323,TXFE7,128,9953,2,79699,39555,40695
13273604,13273604,TXFE7,128,9952,1,79700,39556,40696
13273892,13273881,TXFE7,128,9952,1,79701,39557,40697
13273904,13273904,TXFE7,128,9952,1,79702,39558,40698
13273929,13273921,TXFE7,128,9953,1,79703,39559,40699
13274017,13274010,TXFE7,128,9953,1,79704,39560,40700
13274079,13274078,TXFE7,128,9953,1,79705,39561,40701
13274204,13274204,TXFE7,128,9952,2,79707,39562,40702
13274317,13274312,TXFE7,128,9953,3,79710,39563,40703
13274379,13274375,TXFE7,128,9953,1,79711,39564,40704
13274417,13274416,TXFE7,128,9953,1,79712,39565,40705
13274504,13274503,TXFE7,128,9952,1,79713,39566,40706
13274717,13274707,TXFE7,128,9952,1,79714,39567,40707
13274804,13274804,TXFE7,128,9952,1,79715,39568,40708
13274829,13274828,TXFE7,128,9953,1,79716,39569,40709
13274917,13274905,TXFE7,128,9952,2,79718,39570,40710
13275042,13275037,TXFE7,128,9952,1,79719,39571,40711
13275104,13275104,TXFE7,128,9952,1,79720,39572,40712
13275117,13275109,TXFE7,128,9952,1,79721,39573,40713
13275329,13275321,TXFE7,128,9952,1,79722,39574,40714
13275404,13275404,TXFE7,128,9952,1,79723,39575,40715
13275704,13275704,TXFE7,128,9952,1,79724,39576,40716
13275792,13275791,TXFE7,128,9952,8,79732,39581,40717
13280004,13280003,TXFE7,128,9952,2,79734,39582,40718
13280042,13280032,TXFE7,128,9952,1,79735,39583,40719
13280304,13280304,TXFE7,128,9952,1,79736,39584,40720
13280604,13280604,TXFE7,128,9952,1,79737,39585,40721
13280667,13280666,TXFE7,128,9952,1,79738,39586,40722
13280679,13280671,TXFE7,128,9953,9,79747,39587,40723
13280729,13280729,TXFE7,128,9952,1,79748,39588,40724
13280904,13280904,TXFE7,128,9952,1,79749,39589,40725
13281204,13281203,TXFE7,128,9952,1,79750,39590,40726
13281229,13281221,TXFE7,128,9952,1,79751,39591,40727
13281504,13281504,TXFE7,128,9952,2,79753,39593,40728
13281567,13281558,TXFE7,128,9953,1,79754,39594,40729
13281804,13281803,TXFE7,128,9952,1,79755,39595,40730
13281879,13281876,TXFE7,128,9953,2,79757,39596,40731
13281904,13281895,TXFE7,128,9953,4,79761,39597,40732
13281929,13281923,TXFE7,128,9952,1,79762,39598,40733
13282104,13282104,TXFE7,128,9952,1,79763,39599,40734
13282254,13282250,TXFE7,128,9952,1,79764,39600,40735
13282267,13282257,TXFE7,128,9953,3,79767,39601,40736
13282404,13282404,TXFE7,128,9952,1,79768,39602,40737
13282554,13282545,TXFE7,128,9952,5,79773,39605,40738
13282704,13282704,TXFE7,128,9952,1,79774,39606,40739
13283004,13282992,TXFE7,128,9952,2,79776,39608,40740
13283004,13283004,TXFE7,128,9952,1,79777,39609,40741
13283304,13283304,TXFE7,128,9952,2,79779,39611,40742
13283442,13283434,TXFE7,128,9953,1,79780,39612,40743
13283467,13283461,TXFE7,128,9952,7,79787,39618,40744
13283492,13283487,TXFE7,128,9953,7,79794,39619,40745
13283604,13283604,TXFE7,128,9952,1,79795,39620,40746
13283904,13283904,TXFE7,128,9952,1,79796,39621,40747
13283979,13283975,TXFE7,128,9952,1,79797,39622,40748
13284204,13284196,TXFE7,128,9952,6,79803,39623,40749
13284204,13284204,TXFE7,128,9952,1,79804,39624,40750
13284217,13284208,TXFE7,128,9952,1,79805,39625,40751
13284217,13284210,TXFE7,128,9952,1,79806,39626,40752
13284267,13284266,TXFE7,128,9952,34,79840,39646,40753
13284279,13284267,TXFE7,128,9952,2,79842,39648,40754
13284279,13284267,TXFE7,128,9952,1,79843,39649,40755
13284292,13284282,TXFE7,128,9952,1,79844,39650,40756
13284317,13284314,TXFE7,128,9952,1,79845,39651,40757
13284367,13284358,TXFE7,128,9952,2,79847,39653,40758
13284379,13284377,TXFE7,128,9952,1,79848,39654,40759
13284392,13284381,TXFE7,128,9952,4,79852,39656,40760
13284429,13284422,TXFE7,128,9952,1,79853,39657,40761
13284492,13284483,TXFE7,128,9952,1,79854,39658,40762
13284492,13284487,TXFE7,128,9952,1,79855,39659,40763
13284504,13284504,TXFE7,128,9952,1,79856,39660,40764
13284542,13284538,TXFE7,128,9952,7,79863,39661,40765
13284604,13284598,TXFE7,128,9952,7,79870,39662,40766
13284642,13284637,TXFE7,128,9952,4,79874,39665,40767
13284642,13284641,TXFE7,128,9952,1,79875,39666,40768
13284729,13284726,TXFE7,128,9953,1,79876,39667,40769
13284742,13284734,TXFE7,128,9952,2,79878,39668,40770
13284742,13284739,TXFE7,128,9952,2,79880,39669,40771
13284754,13284753,TXFE7,128,9952,1,79881,39670,40772
13284804,13284804,TXFE7,128,9952,2,79883,39672,40773
13285004,13284997,TXFE7,128,9952,1,79884,39673,40774
13285004,13284999,TXFE7,128,9952,5,79889,39677,40775
13285054,13285044,TXFE7,128,9952,3,79892,39680,40776
13285067,13285060,TXFE7,128,9952,3,79895,39682,40777
13285079,13285075,TXFE7,128,9952,1,79896,39683,40778
13285092,13285082,TXFE7,128,9952,1,79897,39684,40779
13285104,13285098,TXFE7,128,9952,5,79902,39685,40780
13285104,13285103,TXFE7,128,9951,1,79903,39686,40781
13285142,13285129,TXFE7,128,9952,1,79904,39687,40782
13285179,13285172,TXFE7,128,9951,2,79906,39688,40783
13285267,13285257,TXFE7,128,9952,2,79908,39690,40784
13285279,13285275,TXFE7,128,9952,5,79913,39691,40785
13285279,13285279,TXFE7,128,9952,3,79916,39692,40787
13285379,13285373,TXFE7,128,9953,4,79920,39693,40788
13285392,13285384,TXFE7,128,9951,3,79923,39696,40789
13285404,13285404,TXFE7,128,9951,1,79924,39697,40790
13285429,13285417,TXFE7,128,9952,1,79925,39698,40791
13285467,13285467,TXFE7,128,9952,1,79926,39699,40792
13285504,13285495,TXFE7,128,9952,1,79927,39700,40793
13285517,13285512,TXFE7,128,9951,15,79942,39706,40794
13285617,13285604,TXFE7,128,9952,3,79945,39707,40797
13285617,13285616,TXFE7,128,9952,4,79949,39708,40798
13285629,13285627,TXFE7,128,9952,41,79990,39720,40799
13285629,13285629,TXFE7,128,9952,2,79992,39721,40800
13285642,13285639,TXFE7,128,9952,5,79997,39722,40801
13285704,13285703,TXFE7,128,9951,1,79998,39723,40802
13285817,13285807,TXFE7,128,9952,1,79999,39724,40803
13285829,13285828,TXFE7,128,9952,1,80000,39725,40804
13285879,13285875,TXFE7,128,9951,7,80007,39729,40805
13285967,13285957,TXFE7,128,9952,1,80008,39730,40806
13290004,13285993,TXFE7,128,9952,3,80011,39731,40807
13290004,13290003,TXFE7,128,9951,1,80012,39732,40808
13290029,13290023,TXFE7,128,9952,2,80014,39733,40809
13290229,13290227,TXFE7,128,9951,1,80015,39734,40810
13290279,13290272,TXFE7,128,9951,1,80016,39735,40811
13290304,13290303,TXFE7,128,9951,2,80018,39737,40812
13290604,13290603,TXFE7,128,9951,1,80019,39738,40813
13290617,13290607,TXFE7,128,9951,10,80029,39746,40814
13290629,13290623,TXFE7,128,9952,1,80030,39747,40815
13290692,13290679,TXFE7,128,9951,1,80031,39748,40816
13290804,13290793,TXFE7,128,9951,10,80041,39752,40817
13290829,13290819,TXFE7,128,9951,5,80046,39755,40818
13290904,13290904,TXFE7,128,9951,1,80047,39756,40819
13290954,13290954,TXFE7,128,9952,1,80048,39757,40820
13291067,13291058,TXFE7,128,9952,3,80051,39758,40821
13291167,13291164,TXFE7,128,9951,1,80052,39759,40822
13291167,13291164,TXFE7,128,9951,1,80053,39760,40823
13291192,13291183,TXFE7,128,9951,1,80054,39761,40824
13291204,13291204,TXFE7,128,9951,1,80055,39762,40825
13291329,13291318,TXFE7,128,9952,3,80058,39763,40826
13291404,13291399,TXFE7,128,9951,1,80059,39764,40827
13291504,13291504,TXFE7,128,9951,1,80060,39765,40828
13291742,13291732,TXFE7,128,9952,1,80061,39766,40829
13291767,13291762,TXFE7,128,9952,2,80063,39767,40830
13291804,13291804,TXFE7,128,9951,1,80064,39768,40831
13291854,13291847,TXFE7,128,9951,1,80065,39769,40832
13291904,13291898,TXFE7,128,9952,1,80066,39770,40833
13291942,13291936,TXFE7,128,9952,1,80067,39771,40834
13292104,13292097,TXFE7,128,9952,2,80069,39772,40835
13292104,13292097,TXFE7,128,9952,1,80070,39773,40836
13292104,13292097,TXFE7,128,9952,1,80071,39774,40837
13292104,13292097,TXFE7,128,9952,6,80077,39775,40838
13292104,13292103,TXFE7,128,9951,2,80079,39776,40839
13292154,13292152,TXFE7,128,9952,1,80080,39777,40840
13292229,13292217,TXFE7,128,9951,1,80081,39778,40841
13292404,13292393,TXFE7,128,9951,1,80082,39779,40842
13292404,13292404,TXFE7,128,9951,1,80083,39780,40843
13292704,13292704,TXFE7,128,9951,1,80084,39781,40844
13293004,13293004,TXFE7,128,9951,1,80085,39782,40845
13293192,13293185,TXFE7,128,9951,26,80111,39791,40846
13293254,13293242,TXFE7,128,9951,3,80114,39792,40847
13293304,13293304,TXFE7,128,9951,1,80115,39793,40848
13293429,13293419,TXFE7,128,9951,1,80116,39794,40849
13293554,13293546,TXFE7,128,9952,1,80117,39795,40850
13293579,13293567,TXFE7,128,9951,27,80144,39808,40851
13293592,13293579,TXFE7,128,9951,1,80145,39809,40852
13293604,13293592,TXFE7,128,9951,1,80146,39810,40853
13293604,13293602,TXFE7,128,9952,1,80147,39811,40854
13293604,13293603,TXFE7,128,9951,2,80149,39812,40855
13293617,13293614,TXFE7,128,9951,2,80151,39814,40856
13293667,13293661,TXFE7,128,9952,3,80154,39815,40857
13293679,13293679,TXFE7,128,9951,1,80155,39816,40858
13293729,13293723,TXFE7,128,9951,1,80156,39817,40859
13293867,13293855,TXFE7,128,9952,6,80162,39818,40860
13293879,13293875,TXFE7,128,9951,9,80171,39822,40861
13293904,13293904,TXFE7,128,9951,1,80172,39823,40862
13293992,13293980,TXFE7,128,9951,8,80180,39826,40863
13294204,13294201,TXFE7,128,9951,1,80181,39827,40864
13294204,13294204,TXFE7,128,9951,1,80182,39828,40865
13294279,13294276,TXFE7,128,9951,1,80183,39829,40866
13294492,13294487,TXFE7,128,9951,52,80235,39841,40867
13294504,13294503,TXFE7,128,9951,1,80236,39842,40868
13294729,13294728,TXFE7,128,9951,2,80238,39843,40869
13294754,13294747,TXFE7,128,9951,1,80239,39844,40870
13294804,13294804,TXFE7,128,9951,1,80240,39845,40871
13294892,13294891,TXFE7,128,9952,4,80244,39846,40872
13294917,13294909,TXFE7,128,9951,43,80287,39862,40873
13294929,13294928,TXFE7,128,9951,5,80292,39863,40874
13294929,13294929,TXFE7,128,9952,1,80293,39864,40875
13294954,13294943,TXFE7,128,9952,1,80294,39865,40876
13294954,13294949,TXFE7,128,9951,3,80297,39866,40877
13294979,13294969,TXFE7,128,9951,2,80299,39867,40878
13294992,13294985,TXFE7,128,9951,2,80301,39868,40879
13295092,13295081,TXFE7,128,9952,1,80302,39869,40880
13295092,13295088,TXFE7,128,9951,1,80303,39870,40881
13295104,13295096,TXFE7,128,9951,5,80308,39872,40882
13295104,13295103,TXFE7,128,9951,1,80309,39873,40883
13295204,13295197,TXFE7,128,9951,6,80315,39877,40884
13295242,13295234,TXFE7,128,9951,1,80316,39878,40885
13295304,13295293,TXFE7,128,9951,6,80322,39880,40886
13295304,13295304,TXFE7,128,9952,1,80323,39881,40887
13295342,13295339,TXFE7,128,9951,4,80327,39882,40888
13295354,13295350,TXFE7,128,9952,2,80329,39883,40889
13295367,13295366,TXFE7,128,9952,1,80330,39884,40890
13295392,13295390,TXFE7,128,9951,6,80336,39887,40891
13295404,13295395,TXFE7,128,9951,1,80337,39888,40892
13295404,13295403,TXFE7,128,9951,2,80339,39890,40893
13295467,13295460,TXFE7,128,9951,1,80340,39891,40894
13295504,13295494,TXFE7,128,9951,7,80347,39894,40895
13295567,13295565,TXFE7,128,9951,5,80352,39897,40896
13295604,13295596,TXFE7,128,9951,1,80353,39898,40897
13295629,13295621,TXFE7,128,9951,4,80357,39900,40898
13295642,13295635,TXFE7,128,9951,4,80361,39902,40899
13295704,13295704,TXFE7,128,9950,1,80362,39903,40900
13295717,13295708,TXFE7,128,9950,6,80368,39904,40901
13295717,13295709,TXFE7,128,9952,2,80370,39905,40902
13295729,13295725,TXFE7,128,9950,6,80376,39906,40903
13295742,13295731,TXFE7,128,9950,3,80379,39909,40904
13295767,13295756,TXFE7,128,9950,4,80383,39911,40905
13295792,13295779,TXFE7,128,9951,1,80384,39912,40906
13295817,13295806,TXFE7,128,9951,2,80386,39913,40907
13295829,13295817,TXFE7,128,9951,4,80390,39914,40908
13295842,13295835,TXFE7,128,9951,2,80392,39915,40909
13295854,13295842,TXFE7,128,9951,10,80402,39916,40910
13295854,13295842,TXFE7,128,9951,6,80408,39917,40911
13295854,13295842,TXFE7,128,9951,4,80412,39918,40912
13295854,13295842,TXFE7,128,9951,1,80413,39919,40913
13295854,13295849,TXFE7,128,9952,5,80418,39920,40914
13295854,13295854,TXFE7,128,9950,1,80419,39921,40915
13295854,13295854,TXFE7,128,9952,1,80420,39922,40916
13295867,13295855,TXFE7,128,9952,2,80422,39923,40917
13295867,13295858,TXFE7,129,9951,1,80426,39926,40918
13295867,13295858,TXFE7,129,9950,3,80426,39926,40918
13295929,13295926,TXFE7,128,9950,14,80440,39932,40919
13295979,13295968,TXFE7,128,9951,1,80441,39933,40920
13300029,13300023,TXFE7,128,9951,3,80444,39934,40921
13300042,13300031,TXFE7,128,9950,11,80455,39935,40922
13300092,13300091,TXFE7,128,9950,1,80456,39936,40923
13300104,13300093,TXFE7,128,9950,1,80457,39937,40924
13300104,13300103,TXFE7,128,9950,6,80463,39938,40925
13300104,13300103,TXFE7,128,9950,6,80469,39939,40926
13300129,13300125,TXFE7,128,9950,1,80470,39940,40927
13300154,13300146,TXFE7,128,9950,2,80472,39941,40928
13300167,13300156,TXFE7,128,9950,2,80474,39943,40929
13300167,13300166,TXFE7,128,9950,2,80476,39944,40930
13300179,13300168,TXFE7,128,9950,2,80478,39945,40931
13300204,13300195,TXFE7,128,9950,4,80482,39949,40932
13300217,13300211,TXFE7,128,9951,4,80486,39950,40934
13300229,13300219,TXFE7,128,9951,15,80501,39951,40941
13300242,13300229,TXFE7,128,9951,1,80502,39952,40942
13300242,13300235,TXFE7,128,9951,2,80504,39953,40943
13300254,13300242,TXFE7,128,9951,1,80505,39954,40944
13300267,13300263,TXFE7,128,9951,1,80506,39955,40945
13300279,13300271,TXFE7,128,9951,1,80507,39956,40946
13300304,13300304,TXFE7,128,9951,2,80509,39957,40948
13300317,13300305,TXFE7,128,9951,5,80514,39958,40950
13300379,13300368,TXFE7,128,9951,2,80516,39959,40952
13300379,13300371,TXFE7,128,9951,2,80518,39960,40953
13300379,13300379,TXFE7,128,9951,1,80519,39961,40954
13300404,13300401,TXFE7,128,9950,1,80520,39962,40955
13300492,13300491,TXFE7,128,9951,1,80521,39963,40956
13300517,13300510,TXFE7,128,9951,2,80523,39964,40957
13300529,13300525,TXFE7,128,9951,1,80524,39965,40958
13300542,13300540,TXFE7,128,9950,1,80525,39966,40959
13300542,13300540,TXFE7,128,9950,2,80527,39968,40960
13300554,13300542,TXFE7,128,9950,1,80528,39969,40961
13300554,13300545,TXFE7,128,9950,1,80529,39970,40962
13300554,13300546,TXFE7,128,9951,2,80531,39971,40963
13300554,13300548,TXFE7,128,9950,1,80532,39972,40964
13300554,13300548,TXFE7,128,9951,1,80533,39973,40965
13300567,13300560,TXFE7,128,9951,1,80534,39974,40966
13300567,13300565,TXFE7,128,9951,1,80535,39975,40967
13300604,13300601,TXFE7,128,9951,2,80537,39976,40968
13300617,13300608,TXFE7,128,9951,1,80538,39977,40969
13300617,13300611,TXFE7,128,9950,2,80540,39979,40970
13300642,13300637,TXFE7,128,9951,1,80541,39980,40971
13300642,13300639,TXFE7,128,9951,1,80542,39981,40972
13300692,13300680,TXFE7,128,9952,1,80543,39982,40973
13300717,13300715,TXFE7,128,9951,1,80544,39983,40974
13300729,13300722,TXFE7,128,9951,2,80546,39984,40975
13300767,13300756,TXFE7,128,9952,2,80548,39985,40976
13300779,13300774,TXFE7,128,9952,1,80549,39986,40977
13300792,13300787,TXFE7,128,9951,1,80550,39987,40978
13300817,13300815,TXFE7,128,9951,6,80556,39988,40979
13300842,13300830,TXFE7,128,9951,2,80558,39990,40980
13300842,13300838,TXFE7,128,9952,1,80559,39991,40981
13300854,13300843,TXFE7,128,9952,1,80560,39992,40982
13300867,13300856,TXFE7,128,9952,5,80565,39993,40984
13300867,13300866,TXFE7,128,9952,1,80566,39994,40985
13300892,13300891,TXFE7,128,9952,1,80567,39995,40986
13300904,13300893,TXFE7,128,9952,1,80568,39996,40987
13300904,13300901,TXFE7,128,9951,1,80569,39997,40988
13300917,13300907,TXFE7,128,9952,2,80571,39998,40990
13300917,13300915,TXFE7,128,9951,10,80581,40000,40991
13300954,13300948,TXFE7,128,9952,9,80590,40001,40998
13300967,13300964,TXFE7,128,9952,1,80591,40002,40999
13300979,13300971,TXFE7,128,9952,1,80592,40003,41000
13301004,13301002,TXFE7,128,9952,1,80593,40004,41001
13301029,13301028,TXFE7,128,9952,1,80594,40005,41002
13301079,13301068,TXFE7,128,9952,2,80596,40006,41003
13301104,13301095,TXFE7,128,9951,1,80597,40007,41004
13301129,13301118,TXFE7,128,9952,4,80601,40008,41005
13301142,13301130,TXFE7,128,9952,1,80602,40009,41006
13301167,13301159,TXFE7,128,9952,1,80603,40010,41007
13301217,13301213,TXFE7,128,9952,1,80604,40011,41008
13301242,13301239,TXFE7,128,9952,1,80605,40012,41009
13301279,13301269,TXFE7,128,9952,1,80606,40013,41010
13301279,13301276,TXFE7,128,9952,1,80607,40014,41011
13301292,13301285,TXFE7,128,9952,2,80609,40015,41012
13301292,13301287,TXFE7,128,9952,2,80611,40016,41014
13301304,13301292,TXFE7,128,9952,2,80613,40017,41016
13301354,13301348,TXFE7,128,9952,1,80614,40018,41017
13301367,13301355,TXFE7,128,9952,2,80616,40019,41019
13301379,13301368,TXFE7,128,9952,2,80618,40020,41021
13301379,13301368,TXFE7,128,9952,1,80619,40021,41022
13301392,13301383,TXFE7,128,9952,3,80622,40023,41023
13301404,13301393,TXFE7,128,9952,1,80623,40024,41024
13301404,13301397,TXFE7,128,9952,4,80627,40027,41025
13301442,13301436,TXFE7,128,9952,1,80628,40028,41026
13301454,13301445,TXFE7,128,9953,3,80631,40029,41029
13301467,13301465,TXFE7,128,9953,7,80638,40030,41033
13301579,13301570,TXFE7,128,9952,1,80639,40031,41034
13301579,13301579,TXFE7,128,9953,1,80640,40032,41035
13301654,13301645,TXFE7,128,9953,5,80645,40033,41039
13301804,13301801,TXFE7,128,9952,1,80646,40034,41040
13301879,13301873,TXFE7,128,9953,1,80647,40035,41041
13301904,13301898,TXFE7,128,9953,1,80648,40036,41042
13301904,13301899,TXFE7,128,9953,2,80650,40037,41043
13301967,13301959,TXFE7,128,9953,4,80654,40038,41045
13301979,13301967,TXFE7,128,9953,14,80668,40039,41049
13301992,13301988,TXFE7,128,9953,1,80669,40040,41050
13302029,13302020,TXFE7,128,9953,1,80670,40041,41051
13302179,13302168,TXFE7,128,9952,1,80671,40042,41052
13302179,13302175,TXFE7,128,9953,1,80672,40043,41053
13302192,13302183,TXFE7,128,9953,1,80673,40044,41054
13302229,13302229,TXFE7,128,9953,1,80674,40045,41055
13302242,13302239,TXFE7,128,9953,4,80678,40046,41057
13302279,13302277,TXFE7,128,9953,1,80679,40047,41058
13302329,13302325,TXFE7,128,9953,1,80680,40048,41059
13302329,13302327,TXFE7,128,9953,1,80681,40049,41060
13302392,13302388,TXFE7,128,9953,1,80682,40050,41061
13302404,13302398,TXFE7,128,9953,1,80683,40051,41062
13302429,13302417,TXFE7,128,9953,1,80684,40052,41063
13302454,13302443,TXFE7,128,9953,1,80685,40053,41064
13302467,13302462,TXFE7,128,9953,1,80686,40054,41065
13302467,13302467,TXFE7,128,9953,1,80687,40055,41066
13302479,13302470,TXFE7,128,9953,4,80691,40056,41067
13302479,13302474,TXFE7,128,9952,1,80692,40057,41068
13302492,13302491,TXFE7,128,9953,2,80694,40058,41070
13302492,13302491,TXFE7,128,9953,1,80695,40059,41071
13302504,13302496,TXFE7,128,9953,1,80696,40060,41072
13302504,13302497,TXFE7,128,9953,1,80697,40061,41073
13302529,13302527,TXFE7,128,9953,1,80698,40062,41074
13302542,13302530,TXFE7,128,9953,1,80699,40063,41075
13302554,13302542,TXFE7,128,9953,1,80700,40064,41076
13302554,13302546,TXFE7,128,9953,1,80701,40065,41077
13302554,13302546,TXFE7,128,9953,10,80711,40066,41079
13302567,13302559,TXFE7,128,9953,1,80712,40067,41080
13302604,13302599,TXFE7,128,9953,1,80713,40068,41081
13302629,13302623,TXFE7,128,9953,1,80714,40069,41082
13302654,13302649,TXFE7,128,9953,1,80715,40070,41083
13302679,13302669,TXFE7,128,9953,1,80716,40071,41084
13302679,13302678,TXFE7,128,9954,2,80718,40072,41086
13302704,13302698,TXFE7,128,9954,5,80723,40073,41088
13302767,13302762,TXFE7,128,9953,10,80733,40076,41089
13302767,13302763,TXFE7,128,9953,6,80739,40081,41090
13302767,13302764,TXFE7,128,9954,1,80740,40082,41091
13302767,13302766,TXFE7,128,9954,11,80751,40083,41096
13302767,13302766,TXFE7,128,9954,10,80761,40084,41099
13302779,13302774,TXFE7,128,9953,1,80762,40085,41100
13302817,13302806,TXFE7,128,9954,6,80768,40086,41105
13302842,13302841,TXFE7,129,9953,8,80778,40094,41106
13302842,13302841,TXFE7,129,9952,2,80778,40094,41106
13302854,13302842,TXFE7,128,9952,2,80780,40096,41107
13302854,13302850,TXFE7,128,9954,1,80781,40097,41108
13302879,13302876,TXFE7,128,9954,2,80783,40098,41109
13302954,13302943,TXFE7,128,9953,1,80784,40099,41110
13302979,13302967,TXFE7,128,9954,5,80789,40100,41115
13302979,13302968,TXFE7,128,9954,4,80793,40101,41117
13303167,13303158,TXFE7,128,9954,2,80795,40102,41118
13303217,13303215,TXFE7,128,9953,2,80797,40104,41119
13303242,13303241,TXFE7,128,9954,20,80817,40105,41125
13303267,13303265,TXFE7,128,9953,12,80829,40112,41126
13303454,13303449,TXFE7,128,9954,1,80846,40118,41133
13303492,13303489,TXFE7,128,9954,1,80847,40119,41134
13303704,13303698,TXFE7,128,9954,11,80858,40120,41141
13303804,13303800,TXFE7,128,9953,1,80859,40121,41142
13303867,13303866,TXFE7,128,9954,1,80860,40122,41143
13303879,13303878,TXFE7,128,9954,1,80861,40123,41144
13303904,13303895,TXFE7,128,9954,1,80862,40124,41145
13303904,13303903,TXFE7,128,9953,4,80866,40125,41146
13303917,13303907,TXFE7,128,9954,1,80867,40126,41147
13303917,13303916,TXFE7,128,9954,1,80868,40127,41148
13304042,13304032,TXFE7,128,9954,1,80869,40128,41149
13304104,13304094,TXFE7,128,9954,1,80870,40129,41150
13304117,13304105,TXFE7,128,9954,1,80871,40130,41151
13304117,13304112,TXFE7,128,9954,1,80872,40131,41152
13304117,13304113,TXFE7,128,9954,1,80873,40132,41153
13304117,13304115,TXFE7,128,9954,5,80878,40133,41156
13304129,13304117,TXFE7,128,9953,10,80888,40136,41157
13304129,13304118,TXFE7,128,9954,1,80889,40137,41158
13304129,13304119,TXFE7,128,9954,3,80892,40138,41159
13304129,13304120,TXFE7,128,9953,2,80894,40139,41160
13304129,13304128,TXFE7,128,9954,1,80895,40140,41161
13304167,13304156,TXFE7,128,9954,1,80896,40141,41162
13304217,13304206,TXFE7,128,9954,3,80899,40142,41165
13304292,13304282,TXFE7,128,9954,2,80901,40143,41167
13304329,13304321,TXFE7,128,9954,1,80902,40144,41168
13304354,13304349,TXFE7,128,9953,1,80903,40145,41169
13304392,13304385,TXFE7,128,9954,1,80904,40146,41170
13304392,13304387,TXFE7,128,9953,10,80914,40152,41171
13304442,13304434,TXFE7,128,9954,1,80915,40153,41172
13304454,13304443,TXFE7,128,9953,2,80917,40155,41173
13304454,13304449,TXFE7,128,9953,2,80919,40157,41174
13304592,13304583,TXFE7,128,9954,1,80920,40158,41175
13304604,13304592,TXFE7,128,9954,1,80921,40159,41176
13304642,13304640,TXFE7,128,9953,10,80931,40163,41177
13304654,13304648,TXFE7,128,9953,1,80932,40164,41178
13304654,13304649,TXFE7,128,9953,1,80933,40165,41179
13304667,13304662,TXFE7,128,9953,1,80934,40166,41180
13304667,13304662,TXFE7,128,9953,2,80936,40167,41181
13304667,13304665,TXFE7,128,9953,1,80937,40168,41182
13304704,13304703,TXFE7,128,9954,6,80943,40169,41187
13304717,13304706,TXFE7,128,9954,3,80946,40170,41189
13304754,13304749,TXFE7,128,9954,5,80951,40171,41190
13304817,13304816,TXFE7,128,9954,2,80953,40172,41191
13304854,13304847,TXFE7,128,9953,1,80954,40173,41192
13304854,13304849,TXFE7,128,9954,1,80955,40174,41193
13304854,13304850,TXFE7,128,9953,1,80956,40175,41194
13304854,13304851,TXFE7,128,9954,3,80959,40176,41195
13304854,13304852,TXFE7,128,9954,4,80963,40177,41198
13304854,13304853,TXFE7,128,9954,4,80967,40178,41199
13304854,13304853,TXFE7,128,9954,1,80968,40179,41200
13304854,13304854,TXFE7,128,9954,1,80969,40180,41201
13304867,13304855,TXFE7,128,9953,1,80970,40181,41202
13304879,13304873,TXFE7,128,9954,2,80972,40182,41203
13304879,13304875,TXFE7,128,9954,2,80974,40183,41205
13304879,13304875,TXFE7,128,9954,2,80976,40184,41207
13304879,13304877,TXFE7,128,9954,8,80984,40185,41211
13304879,13304877,TXFE7,128,9954,4,80988,40186,41212
13304892,13304879,TXFE7,128,9954,1,80989,40187,41213
13304904,13304893,TXFE7,128,9954,1,80990,40188,41214
13304929,13304918,TXFE7,128,9954,1,80991,40189,41215
13304942,13304934,TXFE7,128,9954,1,80992,40190,41216
13305029,13305023,TXFE7,128,9954,1,80993,40191,41217
13305042,13305040,TXFE7,128,9954,2,80995,40192,41219
13305067,13305059,TXFE7,128,9953,1,80996,40193,41220
13305067,13305063,TXFE7,128,9954,1,80997,40194,41221
13305092,13305086,TXFE7,128,9954,1,80998,40195,41222
13305117,13305117,TXFE7,128,9953,1,80999,40196,41223
13305217,13305211,TXFE7,128,9954,1,81000,40197,41224
13305217,13305215,TXFE7,128,9954,1,81001,40198,41225
13305404,13305401,TXFE7,128,9954,3,81004,40199,41226
13305429,13305422,TXFE7,128,9954,1,81005,40200,41227
13305467,13305459,TXFE7,128,9953,1,81006,40201,41228
13305479,13305478,TXFE7,128,9954,24,81030,40202,41239
13305504,13305504,TXFE7,128,9955,1,81031,40203,41240
13305517,13305513,TXFE7,128,9955,1,81032,40204,41241
13305554,13305547,TXFE7,128,9954,1,81033,40205,41242
13305567,13305554,TXFE7,128,9954,1,81034,40206,41243
13305567,13305555,TXFE7,128,9954,1,81035,40207,41244
13305567,13305557,TXFE7,128,9954,1,81036,40208,41245
13305567,13305558,TXFE7,128,9954,1,81037,40209,41246
13305567,13305563,TXFE7,128,9954,2,81039,40210,41247
13305604,13305596,TXFE7,128,9954,1,81040,40211,41248
13305629,13305621,TXFE7,128,9955,1,81041,40212,41249
13305667,13305664,TXFE7,128,9954,2,81043,40214,41250
13305679,13305673,TXFE7,128,9953,1,81044,40215,41251
13305704,13305693,TXFE7,128,9954,1,81045,40216,41252
13305742,13305742,TXFE7,128,9953,5,81050,40218,41253
13305767,13305766,TXFE7,128,9954,2,81052,40219,41254
13305779,13305778,TXFE7,128,9953,1,81053,40220,41255
13305792,13305791,TXFE7,128,9955,1,81054,40221,41256
13305817,13305815,TXFE7,128,9955,2,81056,40222,41258
13305854,13305843,TXFE7,128,9953,2,81058,40223,41259
13305867,13305854,TXFE7,128,9954,4,81062,40224,41260
13305879,13305867,TXFE7,128,9955,1,81063,40225,41261
13305929,13305922,TXFE7,128,9955,20,81083,40226,41272
13305979,13305978,TXFE7,128,9954,2,81085,40228,41273
13310004,13310003,TXFE7,128,9954,1,81086,40229,41274
13310017,13310011,TXFE7,128,9954,1,81087,40230,41275
13310042,13310033,TXFE7,128,9953,1,81088,40231,41276
13310042,13310034,TXFE7,128,9954,1,81089,40232,41277
13310154,13310142,TXFE7,128,9954,1,81090,40233,41278
13310154,13310146,TXFE7,128,9953,1,81091,40234,41279
13310167,13310160,TXFE7,128,9954,1,81092,40235,41280
13310242,13310234,TXFE7,128,9954,1,81093,40236,41281
13310317,13310307,TXFE7,128,9954,1,81094,40237,41282
13310404,13310397,TXFE7,128,9953,2,81096,40239,41283
13310404,13310399,TXFE7,128,9955,1,81097,40240,41284
13310504,13310493,TXFE7,128,9955,2,81099,40241,41285
13310567,13310557,TXFE7,128,9953,1,81100,40242,41286
13310567,13310561,TXFE7,128,9954,1,81101,40243,41287
13310567,13310562,TXFE7,128,9953,1,81102,40244,41288
13310579,13310567,TXFE7,128,9953,1,81103,40245,41289
13310579,13310574,TXFE7,128,9953,1,81104,40246,41290
13310592,13310587,TXFE7,128,9954,1,81105,40247,41291
13310592,13310590,TXFE7,128,9954,3,81108,40248,41292
13310592,13310591,TXFE7,128,9953,2,81110,40249,41293
13310604,13310592,TXFE7,128,9953,2,81112,40250,41294
13310604,13310597,TXFE7,128,9954,1,81113,40251,41295
13310604,13310599,TXFE7,128,9954,3,81116,40252,41296
13310604,13310601,TXFE7,128,9954,1,81117,40253,41297
13310604,13310601,TXFE7,128,9954,2,81119,40254,41298
13310617,13310609,TXFE7,128,9954,4,81123,40255,41300
13310629,13310628,TXFE7,129,9954,1,81131,40256,41307
13310629,13310628,TXFE7,129,9955,7,81131,40256,41307
13310654,13310652,TXFE7,128,9955,1,81132,40257,41308
13310767,13310765,TXFE7,128,9955,1,81133,40258,41309
13310829,13310818,TXFE7,128,9954,2,81135,40259,41310
13310879,13310875,TXFE7,128,9953,1,81136,40260,41311
13310942,13310942,TXFE7,128,9954,3,81139,40261,41312
13311129,13311120,TXFE7,128,9954,1,81140,40262,41313
13311167,13311155,TXFE7,128,9954,1,81141,40263,41314
13311217,13311212,TXFE7,128,9954,1,81142,40264,41315
13311229,13311227,TXFE7,128,9955,4,81146,40265,41319
13311242,13311231,TXFE7,128,9955,1,81147,40266,41320
13311342,13311336,TXFE7,128,9954,1,81148,40267,41321
13311454,13311450,TXFE7,128,9954,1,81149,40268,41322
13311629,13311618,TXFE7,129,9954,6,81159,40274,41323
13311629,13311618,TXFE7,129,9953,4,81159,40274,41323
13311642,13311631,TXFE7,128,9954,1,81160,40275,41324
13311654,13311651,TXFE7,128,9955,1,81161,40276,41325
13311692,13311683,TXFE7,128,9955,5,81166,40277,41330
13312004,13311998,TXFE7,128,9954,1,81167,40278,41331
13312029,13312029,TXFE7,128,9954,1,81168,40279,41332
13312042,13312031,TXFE7,128,9954,1,81169,40280,41333
13312042,13312033,TXFE7,128,9954,1,81170,40281,41334
13312142,13312135,TXFE7,128,9954,2,81172,40282,41335
13312142,13312135,TXFE7,129,9954,1,81174,40284,41336
13312142,13312135,TXFE7,129,9953,1,81174,40284,41336
13312142,13312139,TXFE7,128,9953,1,81175,40285,41337
13312142,13312139,TXFE7,128,9953,1,81176,40286,41338
13312179,13312167,TXFE7,128,9953,2,81178,40287,41339
13312229,13312221,TXFE7,128,9954,1,81179,40288,41340
13312242,13312238,TXFE7,129,9954,1,81181,40289,41342
13312242,13312238,TXFE7,129,9955,1,81181,40289,41342
13312454,13312443,TXFE7,128,9955,1,81182,40290,41343
13312454,13312446,TXFE7,128,9954,1,81183,40291,41344
13312454,13312450,TXFE7,128,9955,1,81184,40292,41345
13312467,13312456,TXFE7,128,9954,1,81185,40293,41346
13312467,13312459,TXFE7,128,9955,1,81186,40294,41347
13312467,13312460,TXFE7,128,9955,1,81187,40295,41348
13312467,13312461,TXFE7,128,9954,1,81188,40296,41349
13312467,13312461,TXFE7,128,9955,1,81189,40297,41350
13312479,13312468,TXFE7,128,9955,1,81190,40298,41351
13312667,13312655,TXFE7,128,9955,1,81191,40299,41352
13312804,13312798,TXFE7,128,9954,1,81192,40300,41353
13312929,13312917,TXFE7,128,9954,1,81193,40301,41354
13312942,13312931,TXFE7,128,9955,1,81194,40302,41355
13312942,13312940,TXFE7,128,9954,2,81196,40304,41356
13312942,13312940,TXFE7,128,9954,3,81199,40305,41357
13313079,13313076,TXFE7,128,9955,1,81200,40306,41358
13313279,13313272,TXFE7,128,9955,1,81201,40307,41359
13313479,13313473,TXFE7,128,9954,1,81202,40308,41360
13313479,13313477,TXFE7,128,9954,2,81204,40310,41361
13313579,13313579,TXFE7,128,9954,1,81205,40311,41362
13313604,13313597,TXFE7,128,9954,1,81206,40312,41363
13313654,13313646,TXFE7,128,9954,1,81207,40313,41364
13313679,13313667,TXFE7,128,9954,1,81208,40314,41365
13313704,13313695,TXFE7,128,9954,1,81209,40315,41366
13313767,13313763,TXFE7,128,9954,3,81212,40316,41368
13313879,13313869,TXFE7,128,9954,1,81213,40317,41369
13313917,13313909,TXFE7,128,9954,3,81216,40318,41370
13313929,13313917,TXFE7,128,9954,4,81220,40319,41371
13314179,13314179,TXFE7,128,9954,1,81221,40320,41372
13314342,13314330,TXFE7,128,9954,4,81225,40321,41373
13314342,13314332,TXFE7,128,9954,1,81226,40322,41374
13314342,13314336,TXFE7,128,9953,4,81230,40323,41375
13314342,13314340,TXFE7,128,9954,1,81231,40324,41376
13314392,13314384,TXFE7,128,9954,1,81232,40325,41377
13314417,13314408,TXFE7,128,9954,1,81233,40326,41378
13314492,13314490,TXFE7,128,9954,1,81234,40327,41379
13314654,13314649,TXFE7,128,9954,2,81236,40328,41380
13314654,13314652,TXFE7,128,9954,1,81237,40329,41381
13314942,13314940,TXFE7,128,9954,1,81238,40330,41382
13314954,13314948,TXFE7,128,9954,2,81240,40331,41383
13314954,13314948,TXFE7,128,9954,1,81241,40332,41384
13314954,13314952,TXFE7,128,9954,1,81242,40333,41385
13314954,13314953,TXFE7,128,9954,1,81243,40334,41386
13314992,13314984,TXFE7,128,9954,1,81244,40335,41387
13315029,13315020,TXFE7,128,9954,1,81245,40336,41388
13315079,13315068,TXFE7,128,9954,1,81246,40337,41389
13315392,13315388,TXFE7,128,9954,1,81247,40338,41390
13315392,13315389,TXFE7,128,9954,1,81248,40339,41391
13315779,13315778,TXFE7,128,9955,1,81249,40340,41392
13315829,13315823,TXFE7,128,9954,7,81256,40341,41393
13320004,13320004,TXFE7,128,9954,1,81257,40342,41394
13320017,13320011,TXFE7,128,9954,1,81258,40343,41395
13320017,13320012,TXFE7,128,9954,1,81259,40344,41396
13320017,13320013,TXFE7,128,9954,2,81261,40345,41397
13320117,13320104,TXFE7,128,9954,1,81262,40346,41398
13320142,13320140,TXFE7,128,9954,1,81263,40347,41399
13320317,13320305,TXFE7,128,9954,2,81265,40348,41400
13320329,13320322,TXFE7,128,9954,1,81266,40349,41401
13320504,13320496,TXFE7,128,9954,1,81267,40350,41402
13320542,13320531,TXFE7,128,9954,5,81272,40355,41403
13320554,13320542,TXFE7,128,9954,5,81277,40360,41404
13320554,13320552,TXFE7,129,9954,1,81282,40362,41405
13320554,13320552,TXFE7,129,9953,4,81282,40362,41405
13320567,13320562,TXFE7,128,9953,5,81287,40363,41406
13320579,13320572,TXFE7,128,9953,5,81292,40364,41407
13320592,13320582,TXFE7,128,9953,3,81295,40365,41408
13320592,13320590,TXFE7,128,9954,1,81296,40366,41409
13320629,13320622,TXFE7,128,9955,4,81300,40367,41412
13320654,13320643,TXFE7,128,9955,1,81301,40368,41413
13320667,13320659,TXFE7,128,9954,1,81302,40369,41414
13320842,13320833,TXFE7,128,9953,1,81303,40370,41415
13320954,13320953,TXFE7,128,9954,1,81304,40371,41416
13321117,13321117,TXFE7,128,9953,2,81306,40372,41417
13321142,13321137,TXFE7,128,9954,2,81308,40373,41418
13321492,13321491,TXFE7,128,9954,1,81309,40374,41419
13321829,13321822,TXFE7,128,9954,1,81310,40375,41420
13321979,13321979,TXFE7,128,9953,1,81311,40376,41421
13321992,13321980,TXFE7,129,9954,11,81332,40377,41436
13321992,13321980,TXFE7,129,9955,10,81332,40377,41436
13321992,13321983,TXFE7,128,9953,1,81333,40378,41437
13322004,13321996,TXFE7,128,9954,3,81336,40379,41438
13322092,13322080,TXFE7,128,9954,1,81337,40380,41439
13322354,13322354,TXFE7,128,9954,2,81339,40381,41440
13322667,13322656,TXFE7,128,9954,1,81340,40382,41441
13322729,13322723,TXFE7,128,9953,10,81350,40383,41442
13322742,13322738,TXFE7,128,9954,6,81356,40384,41446
13323442,13323441,TXFE7,128,9954,1,81357,40385,41447
13323504,13323504,TXFE7,128,9954,1,81358,40386,41448
13323629,13323622,TXFE7,128,9954,2,81360,40388,41449
13323817,13323809,TXFE7,128,9954,10,81370,40393,41450
13323854,13323843,TXFE7,128,9954,1,81371,40394,41451
13323879,13323878,TXFE7,128,9954,3,81374,40396,41452
13323954,13323949,TXFE7,128,9954,1,81375,40397,41453
13324242,13324233,TXFE7,128,9954,1,81376,40398,41454
13324317,13324307,TXFE7,128,9954,1,81377,40399,41455
13324392,13324387,TXFE7,128,9955,8,81385,40400,41459
13324642,13324641,TXFE7,128,9954,1,81386,40401,41460
13324692,13324686,TXFE7,128,9954,1,81387,40402,41461
13324729,13324718,TXFE7,128,9954,2,81389,40403,41462
13324742,13324732,TXFE7,128,9954,2,81391,40404,41463
13324767,13324758,TXFE7,128,9954,1,81392,40405,41464
13325004,13324995,TXFE7,128,9954,1,81393,40406,41465
13325117,13325106,TXFE7,128,9954,1,81394,40407,41466
13325142,13325138,TXFE7,128,9954,3,81397,40408,41467
13325504,13325495,TXFE7,128,9953,1,81398,40409,41468
13325817,13325805,TXFE7,128,9953,8,81406,40413,41469
13325992,13325987,TXFE7,128,9954,1,81407,40414,41470
13325992,13325989,TXFE7,128,9953,2,81409,40416,41471
13330004,13330004,TXFE7,128,9954,1,81410,40417,41472
13330042,13330032,TXFE7,128,9953,5,81415,40421,41473
13330179,13330170,TXFE7,128,9953,1,81416,40422,41474
13330179,13330176,TXFE7,128,9953,1,81417,40423,41475
13330192,13330183,TXFE7,128,9953,4,81421,40427,41476
13330229,13330227,TXFE7,128,9954,2,81423,40428,41477
13330429,13330419,TXFE7,128,9953,1,81424,40429,41478
13330504,13330503,TXFE7,128,9953,1,81425,40430,41479
13330842,13330833,TXFE7,128,9954,1,81426,40431,41480
13330854,13330847,TXFE7,128,9953,1,81427,40432,41481
13330967,13330957,TXFE7,128,9954,1,81428,40433,41482
13331317,13331309,TXFE7,128,9954,1,81429,40434,41483
13331479,13331468,TXFE7,128,9954,6,81435,40435,41486
13331492,13331485,TXFE7,128,9953,2,81437,40436,41487
13331979,13331969,TXFE7,128,9954,1,81438,40437,41488
13332042,13332040,TXFE7,128,9954,1,81439,40438,41489
13332117,13332106,TXFE7,128,9954,1,81440,40439,41490
13332117,13332106,TXFE7,128,9954,1,81441,40440,41491
13332167,13332158,TXFE7,128,9954,1,81442,40441,41492
13332167,13332163,TXFE7,128,9954,1,81443,40442,41493
13332279,13332271,TXFE7,128,9954,7,81450,40443,41496
13332292,13332291,TXFE7,128,9953,7,81457,40444,41497
13332529,13332520,TXFE7,128,9954,4,81461,40445,41498
13332654,13332653,TXFE7,128,9954,3,81464,40446,41499
13332879,13332877,TXFE7,128,9954,2,81466,40447,41500
13332942,13332939,TXFE7,128,9954,2,81468,40448,41501
13332954,13332945,TXFE7,128,9954,1,81469,40449,41502
13332954,13332953,TXFE7,128,9954,5,81474,40450,41503
13332967,13332959,TXFE7,128,9954,1,81475,40451,41504
13332979,13332967,TXFE7,128,9954,1,81476,40452,41505
13332992,13332984,TXFE7,128,9954,1,81477,40453,41506
13333004,13332993,TXFE7,128,9954,2,81479,40454,41507
13333017,13333009,TXFE7,128,9954,2,81481,40455,41508
13333017,13333012,TXFE7,128,9954,1,81482,40456,41509
13333029,13333019,TXFE7,128,9954,1,81483,40457,41510
13333042,13333032,TXFE7,128,9954,1,81484,40458,41511
13333042,13333038,TXFE7,128,9954,1,81485,40459,41512
13333079,13333070,TXFE7,128,9954,2,81487,40460,41513
13333079,13333077,TXFE7,128,9954,2,81489,40461,41514
13333117,13333114,TXFE7,128,9954,1,81490,40462,41515
13333154,13333152,TXFE7,128,9954,3,81493,40463,41516
13333192,13333187,TXFE7,128,9954,1,81494,40464,41517
13333204,13333193,TXFE7,128,9954,1,81495,40465,41518
13333217,13333213,TXFE7,128,9954,3,81498,40466,41519
13333267,13333266,TXFE7,128,9954,4,81502,40467,41520
13333292,13333285,TXFE7,128,9954,2,81504,40468,41521
13333292,13333287,TXFE7,128,9954,4,81508,40469,41522
13333417,13333407,TXFE7,128,9954,1,81509,40470,41523
13333429,13333419,TXFE7,128,9954,2,81511,40471,41524
13333429,13333423,TXFE7,128,9954,1,81512,40472,41525
13333554,13333554,TXFE7,128,9954,1,81513,40473,41526
13333629,13333617,TXFE7,128,9954,1,81514,40474,41527
13333654,13333653,TXFE7,128,9954,8,81522,40475,41530
13333692,13333680,TXFE7,128,9954,2,81524,40476,41532
13333692,13333687,TXFE7,128,9954,1,81525,40477,41533
13333742,13333732,TXFE7,128,9954,7,81532,40478,41535
13333754,13333742,TXFE7,128,9954,6,81538,40479,41540
13333754,13333749,TXFE7,128,9954,1,81539,40480,41541
13333779,13333779,TXFE7,128,9954,1,81540,40481,41542
13333792,13333788,TXFE7,128,9954,1,81541,40482,41543
13333792,13333791,TXFE7,128,9954,1,81542,40483,41544
13333804,13333792,TXFE7,128,9954,5,81547,40484,41548
13333804,13333801,TXFE7,128,9954,1,81548,40485,41549
13333817,13333811,TXFE7,128,9955,2,81550,40486,41551
13333842,13333832,TXFE7,128,9954,2,81552,40488,41552
13333854,13333850,TXFE7,128,9955,1,81553,40489,41553
13333942,13333932,TXFE7,128,9955,1,81554,40490,41554
13333967,13333958,TXFE7,128,9954,1,81555,40491,41555
13334067,13334063,TXFE7,128,9955,30,81585,40492,41566
13334079,13334070,TXFE7,128,9955,1,81586,40493,41567
13334079,13334077,TXFE7,128,9955,1,81587,40494,41568
13334092,13334081,TXFE7,128,9955,1,81588,40495,41569
13334129,13334126,TXFE7,128,9955,1,81589,40496,41570
13334129,13334128,TXFE7,128,9955,3,81592,40497,41572
13334192,13334187,TXFE7,128,9955,2,81594,40498,41573
13334229,13334218,TXFE7,128,9955,1,81595,40499,41574
13334317,13334310,TXFE7,128,9955,1,81596,40500,41575
13334754,13334748,TXFE7,128,9955,4,81600,40501,41577
13334867,13334862,TXFE7,128,9955,1,81601,40502,41578
13335004,13334995,TXFE7,128,9954,2,81603,40503,41579
13335004,13334998,TXFE7,128,9954,1,81604,40504,41580
13335017,13335008,TXFE7,128,9955,1,81605,40505,41581
13335017,13335013,TXFE7,128,9955,2,81607,40506,41582
13335079,13335068,TXFE7,128,9955,1,81608,40507,41583
13335092,13335089,TXFE7,128,9955,1,81609,40508,41584
13335104,13335093,TXFE7,128,9955,1,81610,40509,41585
13335104,13335095,TXFE7,128,9955,1,81611,40510,41586
13335267,13335262,TXFE7,128,9955,4,81615,40511,41587
13335292,13335287,TXFE7,128,9955,12,81627,40512,41593
13335329,13335326,TXFE7,128,9955,1,81628,40513,41594
13335404,13335399,TXFE7,128,9955,4,81632,40514,41597
13335554,13335551,TXFE7,128,9955,5,81637,40515,41599
13335604,13335594,TXFE7,128,9954,1,81638,40516,41600
13335667,13335662,TXFE7,128,9955,2,81640,40517,41602
13335817,13335809,TXFE7,128,9955,2,81642,40518,41604
13335829,13335822,TXFE7,128,9955,5,81647,40519,41608
13335867,13335866,TXFE7,128,9955,1,81648,40520,41609
13340004,13335995,TXFE7,128,9955,5,81653,40521,41610
13340104,13340093,TXFE7,128,9955,3,81656,40522,41611
13340179,13340175,TXFE7,128,9954,1,81657,40523,41612
13340192,13340185,TXFE7,128,9955,1,81658,40524,41613
13340204,13340192,TXFE7,128,9955,1,81659,40525,41614
13340204,13340196,TXFE7,128,9954,2,81661,40527,41615
13340354,13340342,TXFE7,128,9955,1,81662,40528,41616
13340442,13340432,TXFE7,128,9955,10,81672,40529,41620
13340467,13340462,TXFE7,128,9954,1,81673,40530,41621
13340492,13340492,TXFE7,128,9955,1,81674,40531,41622
13340567,13340556,TXFE7,128,9955,1,81675,40532,41623
13340617,13340605,TXFE7,128,9955,2,81677,40533,41625
13340729,13340719,TXFE7,128,9955,2,81679,40534,41627
13340754,13340749,TXFE7,128,9955,2,81681,40535,41629
13340792,13340782,TXFE7,128,9955,2,81683,40536,41631
13340829,13340828,TXFE7,128,9955,2,81685,40537,41632
13340842,13340839,TXFE7,128,9955,10,81695,40538,41638
13340854,13340851,TXFE7,128,9955,1,81696,40539,41639
13340867,13340855,TXFE7,128,9955,1,81697,40540,41640
13340867,13340858,TXFE7,128,9955,10,81707,40541,41641
13340867,13340861,TXFE7,128,9955,2,81709,40542,41642
13340892,13340891,TXFE7,128,9955,2,81711,40543,41643
13340917,13340910,TXFE7,128,9955,10,81721,40544,41644
13340917,13340912,TXFE7,128,9955,6,81727,40545,41645
13340954,13340944,TXFE7,128,9955,1,81728,40546,41646
13340979,13340971,TXFE7,128,9955,1,81729,40547,41647
13341004,13340997,TXFE7,128,9955,1,81730,40548,41648
13341017,13341016,TXFE7,128,9955,1,81731,40549,41649
13341029,13341023,TXFE7,128,9955,4,81735,40550,41650
13341042,13341029,TXFE7,128,9955,2,81737,40551,41651
13341054,13341042,TXFE7,128,9955,1,81738,40552,41652
13341067,13341063,TXFE7,128,9955,2,81740,40553,41653
13341079,13341070,TXFE7,128,9955,3,81743,40554,41654
13341104,13341099,TXFE7,128,9954,1,81744,40555,41655
13341104,13341103,TXFE7,128,9955,1,81745,40556,41656
13341117,13341105,TXFE7,128,9955,5,81750,40557,41657
13341129,13341127,TXFE7,128,9955,2,81752,40558,41658
13341154,13341148,TXFE7,128,9955,1,81753,40559,41659
13341154,13341149,TXFE7,128,9955,1,81754,40560,41660
13341167,13341155,TXFE7,128,9955,1,81755,40561,41661
13341179,13341172,TXFE7,128,9955,1,81756,40562,41662
13341242,13341239,TXFE7,128,9955,3,81759,40563,41663
13341254,13341245,TXFE7,128,9955,2,81761,40564,41664
13341279,13341269,TXFE7,128,9955,2,81763,40565,41665
13341292,13341283,TXFE7,128,9955,1,81764,40566,41666
13341292,13341285,TXFE7,128,9955,1,81765,40567,41667
13341317,13341311,TXFE7,128,9955,3,81768,40568,41668
13341329,13341317,TXFE7,128,9955,1,81769,40569,41669
13341342,13341330,TXFE7,128,9955,1,81770,40570,41670
13341342,13341332,TXFE7,128,9955,2,81772,40571,41671
13341354,13341342,TXFE7,128,9955,3,81775,40572,41672
13341367,13341354,TXFE7,128,9955,2,81777,40573,41673
13341379,13341370,TXFE7,128,9955,1,81778,40574,41674
13341379,13341376,TXFE7,128,9955,3,81781,40575,41675
13341392,13341385,TXFE7,128,9955,3,81784,40576,41676
13341404,13341393,TXFE7,128,9955,5,81789,40577,41677
13341404,13341402,TXFE7,128,9955,1,81790,40578,41678
13341417,13341409,TXFE7,128,9955,3,81793,40579,41679
13341417,13341411,TXFE7,128,9955,5,81798,40580,41683
13341429,13341417,TXFE7,128,9955,2,81800,40581,41684
13341429,13341417,TXFE7,128,9955,1,81801,40582,41685
13341429,13341421,TXFE7,128,9955,2,81803,40583,41687
13341429,13341424,TXFE7,128,9955,2,81805,40584,41688
13341442,13341429,TXFE7,128,9955,3,81808,40585,41690
13341442,13341430,TXFE7,128,9955,4,81812,40586,41693
13341442,13341432,TXFE7,128,9955,25,81837,40587,41707
13341442,13341434,TXFE7,128,9955,2,81839,40588,41709
13341454,13341442,TXFE7,128,9955,8,81847,40589,41717
13341454,13341442,TXFE7,128,9955,1,81848,40590,41718
13341479,13341471,TXFE7,128,9956,1,81849,40591,41719
13341492,13341481,TXFE7,128,9956,1,81850,40592,41720
13341492,13341491,TXFE7,128,9955,1,81851,40593,41721
13341554,13341543,TXFE7,128,9956,1,81852,40594,41722
13341554,13341553,TXFE7,128,9956,2,81854,40595,41724
13341567,13341557,TXFE7,128,9956,1,81855,40596,41725
13341567,13341562,TXFE7,128,9956,2,81857,40597,41726
13341729,13341728,TXFE7,128,9955,2,81859,40598,41727
13341854,13341852,TXFE7,128,9956,1,81860,40599,41728
13341892,13341887,TXFE7,128,9956,6,81866,40600,41731
13341992,13341980,TXFE7,128,9956,1,81867,40601,41732
13342004,13342001,TXFE7,128,9956,2,81869,40602,41734
13342029,13342025,TXFE7,128,9956,1,81870,40603,41735
13342042,13342034,TXFE7,128,9955,1,81871,40604,41736
13342104,13342102,TXFE7,128,9956,1,81872,40605,41737
13342117,13342108,TXFE7,128,9955,1,81873,40606,41738
13342117,13342108,TXFE7,128,9956,1,81874,40607,41739
13342304,13342292,TXFE7,128,9956,1,81875,40608,41740
13342329,13342322,TXFE7,128,9956,2,81877,40609,41742
13342417,13342407,TXFE7,128,9956,2,81879,40610,41743
13342454,13342450,TXFE7,128,9955,1,81880,40611,41744
13342467,13342464,TXFE7,128,9955,15,81895,40615,41745
13342479,13342476,TXFE7,128,9956,1,81896,40616,41746
13342717,13342710,TXFE7,128,9956,2,81898,40617,41748
13342792,13342787,TXFE7,128,9956,1,81899,40618,41749
13342804,13342793,TXFE7,128,9956,8,81907,40619,41754
13342892,13342887,TXFE7,128,9956,2,81909,40620,41756
13343029,13343020,TXFE7,128,9956,1,81910,40621,41757
13343029,13343028,TXFE7,128,9956,1,81911,40622,41758
13343042,13343038,TXFE7,128,9956,2,81913,40623,41760
13343117,13343104,TXFE7,128,9956,1,81914,40624,41761
13343142,13343131,TXFE7,128,9956,1,81915,40625,41762
13343254,13343249,TXFE7,128,9955,2,81917,40627,41763
13343317,13343313,TXFE7,128,9956,1,81918,40628,41764
13343317,13343314,TXFE7,128,9956,1,81919,40629,41765
13343404,13343403,TXFE7,128,9956,5,81924,40630,41770
13343417,13343412,TXFE7,128,9956,1,81925,40631,41771
13343554,13343548,TXFE7,128,9956,1,81926,40632,41772
13343654,13343648,TXFE7,128,9956,1,81927,40633,41773
13343717,13343711,TXFE7,128,9955,2,81929,40635,41774
13343754,13343743,TXFE7,128,9956,3,81932,40636,41777
13343829,13343821,TXFE7,128,9956,8,81940,40637,41784
13343967,13343965,TXFE7,128,9956,15,81955,40638,41791
13344004,13343995,TXFE7,128,9955,1,81956,40639,41792
13344029,13344028,TXFE7,128,9956,1,81957,40640,41793
13344042,13344036,TXFE7,128,9956,1,81958,40641,41794
13344054,13344045,TXFE7,128,9956,1,81959,40642,41795
13344067,13344064,TXFE7,128,9956,10,81969,40643,41801
13344179,13344178,TXFE7,128,9956,5,81974,40644,41805
13344192,13344188,TXFE7,128,9956,3,81977,40645,41807
13344229,13344218,TXFE7,128,9956,1,81978,40646,41808
13344279,13344274,TXFE7,128,9956,2,81980,40647,41810
13344292,13344283,TXFE7,128,9956,10,81990,40648,41816
13344304,13344301,TXFE7,128,9956,1,81991,40649,41817
13344342,13344334,TXFE7,128,9956,2,81993,40650,41819
13344342,13344334,TXFE7,128,9956,3,81996,40651,41820
13344354,13344346,TXFE7,128,9956,1,81997,40652,41821
13344379,13344378,TXFE7,128,9956,5,82002,40653,41824
13344392,13344379,TXFE7,128,9956,2,82004,40654,41825
13344392,13344382,TXFE7,128,9956,3,82007,40655,41827
13344404,13344392,TXFE7,128,9956,5,82012,40656,41831
13344442,13344429,TXFE7,128,9956,9,82021,40657,41832
13344442,13344430,TXFE7,128,9956,2,82023,40658,41833
13344442,13344439,TXFE7,128,9956,1,82024,40659,41834
13344454,13344453,TXFE7,128,9956,1,82025,40660,41835
13344467,13344460,TXFE7,128,9956,3,82028,40661,41836
13344492,13344480,TXFE7,128,9956,2,82030,40662,41837
13344492,13344489,TXFE7,128,9956,1,82031,40663,41838
13344492,13344489,TXFE7,128,9956,1,82032,40664,41839
13344504,13344501,TXFE7,128,9956,1,82033,40665,41840
13344517,13344506,TXFE7,128,9956,2,82035,40666,41841
13344529,13344526,TXFE7,128,9956,1,82036,40667,41842
13344529,13344526,TXFE7,128,9956,1,82037,40668,41843
13344542,13344529,TXFE7,128,9956,38,82075,40669,41856
13344554,13344542,TXFE7,128,9956,8,82083,40670,41861
13344554,13344542,TXFE7,128,9956,8,82091,40671,41864
13344554,13344542,TXFE7,128,9955,3,82094,40674,41865
13344554,13344545,TXFE7,128,9956,4,82098,40675,41869
13344554,13344551,TXFE7,128,9957,1,82099,40676,41870
13344567,13344558,TXFE7,128,9957,1,82100,40677,41871
13344567,13344563,TXFE7,128,9957,4,82104,40678,41874
13344567,13344566,TXFE7,128,9956,1,82105,40679,41875
13344592,13344584,TXFE7,128,9957,2,82107,40680,41876
13344679,13344676,TXFE7,128,9957,3,82110,40681,41879
13344704,13344703,TXFE7,128,9957,1,82111,40682,41880
13344742,13344742,TXFE7,128,9957,1,82112,40683,41881
13344842,13344838,TXFE7,128,9957,1,82113,40684,41882
13344879,13344868,TXFE7,128,9956,3,82116,40686,41883
13344942,13344934,TXFE7,128,9957,2,82118,40687,41884
13344979,13344972,TXFE7,128,9956,3,82121,40688,41885
13345004,13345001,TXFE7,128,9956,1,82122,40689,41886
13345029,13345026,TXFE7,128,9957,1,82123,40690,41887
13345054,13345048,TXFE7,128,9957,1,82124,40691,41888
13345067,13345056,TXFE7,128,9957,1,82125,40692,41889
13345229,13345227,TXFE7,128,9956,1,82126,40693,41890
13345429,13345420,TXFE7,128,9956,1,82127,40694,41891
13345454,13345453,TXFE7,128,9957,1,82128,40695,41892
13345654,13345642,TXFE7,128,9956,1,82129,40696,41893
13345654,13345650,TXFE7,128,9956,2,82131,40697,41894
13345704,13345699,TXFE7,128,9957,10,82141,40698,41903
13345767,13345759,TXFE7,128,9957,4,82145,40699,41905
13345792,13345785,TXFE7,128,9957,1,82146,40700,41906
13345817,13345807,TXFE7,128,9956,2,82148,40702,41907
13345904,13345900,TXFE7,128,9957,1,82149,40703,41908
13345992,13345990,TXFE7,128,9956,9,82158,40709,41909
13350017,13350006,TXFE7,128,9957,1,82159,40710,41910
13350042,13350030,TXFE7,128,9957,1,82160,40711,41911
13350042,13350035,TXFE7,128,9956,1,82161,40712,41912
13350042,13350035,TXFE7,128,9956,1,82162,40713,41913
13350042,13350037,TXFE7,128,9956,1,82163,40714,41914
13350042,13350039,TXFE7,128,9956,1,82164,40715,41915
13350042,13350040,TXFE7,128,9956,1,82165,40716,41916
13350054,13350049,TXFE7,128,9956,1,82166,40717,41917
13350067,13350055,TXFE7,128,9956,1,82167,40718,41918
13350092,13350090,TXFE7,128,9957,1,82168,40719,41919
13350104,13350100,TXFE7,128,9957,1,82169,40720,41920
13350104,13350101,TXFE7,128,9957,1,82170,40721,41921
13350117,13350107,TXFE7,128,9957,1,82171,40722,41922
13350117,13350113,TXFE7,128,9956,1,82172,40723,41923
13350129,13350118,TXFE7,128,9956,1,82173,40724,41924
13350142,13350139,TXFE7,128,9956,1,82174,40725,41925
13350167,13350163,TXFE7,128,9957,1,82175,40726,41926
13350179,13350172,TXFE7,128,9957,4,82179,40727,41930
13350192,13350189,TXFE7,128,9956,2,82181,40729,41931
13350204,13350194,TXFE7,128,9957,2,82183,40730,41932
13350204,13350200,TXFE7,128,9956,1,82184,40731,41933
13350217,13350208,TXFE7,128,9957,5,82189,40732,41937
13350217,13350212,TXFE7,128,9956,1,82190,40733,41938
13350217,13350214,TXFE7,128,9957,1,82191,40734,41939
13350254,13350244,TXFE7,128,9956,1,82192,40735,41940
13350279,13350274,TXFE7,128,9957,1,82193,40736,41941
13350317,13350306,TXFE7,128,9956,1,82194,40737,41942
13350342,13350332,TXFE7,128,9956,1,82195,40738,41943
13350404,13350399,TXFE7,128,9957,1,82196,40739,41944
13350417,13350404,TXFE7,128,9956,8,82204,40741,41945
13350429,13350421,TXFE7,128,9956,10,82214,40746,41946
13350429,13350421,TXFE7,128,9956,2,82216,40748,41947
13350429,13350421,TXFE7,128,9956,6,82222,40752,41948
13350429,13350421,TXFE7,128,9956,8,82230,40753,41949
13350429,13350421,TXFE7,128,9956,6,82236,40758,41950
13350442,13350430,TXFE7,128,9956,3,82239,40759,41952
13350442,13350435,TXFE7,128,9956,5,82244,40760,41955
13350504,13350504,TXFE7,128,9956,1,82245,40761,41956
13350642,13350638,TXFE7,128,9956,1,82246,40762,41957
13350829,13350819,TXFE7,128,9956,9,82255,40763,41960
13350829,13350824,TXFE7,128,9956,5,82260,40764,41963
13350854,13350849,TXFE7,128,9956,1,82261,40765,41964
13350879,13350869,TXFE7,128,9956,2,82263,40766,41965
13350892,13350884,TXFE7,128,9956,2,82265,40767,41967
13350929,13350929,TXFE7,128,9956,2,82267,40768,41968
13351104,13351094,TXFE7,128,9956,1,82268,40769,41969
13351104,13351102,TXFE7,128,9956,1,82269,40770,41970
13351217,13351205,TXFE7,128,9956,1,82270,40771,41971
13351217,13351206,TXFE7,128,9956,1,82271,40772,41972
13351429,13351424,TXFE7,128,9956,1,82272,40773,41973
13351504,13351496,TXFE7,128,9956,2,82274,40774,41974
13351592,13351588,TXFE7,128,9956,1,82275,40775,41975
13351629,13351621,TXFE7,128,9956,3,82278,40776,41976
13351642,13351635,TXFE7,128,9955,17,82295,40778,41977
13351779,13351771,TXFE7,128,9956,5,82300,40779,41979
13351929,13351925,TXFE7,128,9955,4,82304,40780,41980
13352142,13352139,TXFE7,128,9956,1,82305,40781,41981
13352154,13352145,TXFE7,128,9956,1,82306,40782,41982
13352179,13352179,TXFE7,128,9955,1,82307,40783,41983
13352279,13352272,TXFE7,128,9955,2,82309,40784,41984
13352279,13352273,TXFE7,128,9955,2,82311,40785,41985
13352367,13352362,TXFE7,128,9956,14,82325,40786,41991
13352592,13352591,TXFE7,128,9956,2,82327,40787,41993
13352754,13352743,TXFE7,128,9956,1,82328,40788,41994
13352804,13352802,TXFE7,128,9956,3,82331,40789,41995
13352829,13352819,TXFE7,128,9955,1,82332,40790,41996
13352967,13352956,TXFE7,128,9956,3,82335,40791,41998
13352992,13352986,TXFE7,128,9956,10,82345,40792,42008
13352992,13352988,TXFE7,128,9956,1,82346,40793,42009
13353004,13352992,TXFE7,128,9956,6,82352,40794,42013
13353017,13353004,TXFE7,128,9956,8,82360,40795,42018
13353017,13353004,TXFE7,128,9956,2,82362,40796,42020
13353054,13353046,TXFE7,128,9956,1,82363,40797,42021
13353079,13353068,TXFE7,128,9956,1,82364,40798,42022
13353079,13353075,TXFE7,128,9956,1,82365,40799,42023
13353304,13353303,TXFE7,128,9956,2,82367,40800,42024
13353329,13353320,TXFE7,128,9956,2,82369,40801,42025
13353354,13353342,TXFE7,128,9956,1,82370,40802,42026
13353367,13353362,TXFE7,128,9956,1,82371,40803,42027
13353442,13353432,TXFE7,128,9956,1,82372,40804,42028
13353467,13353462,TXFE7,128,9956,1,82373,40805,42029
13353517,13353509,TXFE7,128,9956,1,82374,40806,42030
13353529,13353524,TXFE7,128,9956,1,82375,40807,42031
13353554,13353553,TXFE7,128,9956,1,82376,40808,42032
13353679,13353668,TXFE7,128,9956,1,82377,40809,42033
13353692,13353690,TXFE7,128,9956,5,82382,40810,42036
13353704,13353692,TXFE7,128,9956,4,82386,40811,42038
13353717,13353704,TXFE7,128,9956,6,82392,40812,42044
13353729,13353717,TXFE7,128,9956,8,82400,40813,42050
13353767,13353755,TXFE7,128,9957,7,82407,40814,42054
13353817,13353808,TXFE7,128,9957,1,82408,40815,42055
13354054,13354044,TXFE7,128,9957,1,82409,40816,42056
13354054,13354051,TXFE7,128,9957,1,82410,40817,42057
13354417,13354414,TXFE7,128,9956,1,82411,40818,42058
13354592,13354584,TXFE7,128,9957,1,82412,40819,42059
13354592,13354589,TXFE7,128,9957,8,82420,40820,42061
13354629,13354628,TXFE7,128,9956,1,82421,40821,42062
13355054,13355047,TXFE7,128,9957,1,82422,40822,42063
13355054,13355052,TXFE7,128,9957,1,82423,40823,42064
13355192,13355180,TXFE7,128,9956,1,82424,40824,42065
13355204,13355197,TXFE7,128,9957,2,82426,40825,42066
13355404,13355392,TXFE7,128,9956,1,82427,40826,42067
13355604,13355593,TXFE7,128,9957,1,82428,40827,42068
13355692,13355689,TXFE7,128,9956,1,82429,40828,42069
13355742,13355731,TXFE7,128,9957,1,82430,40829,42070
13355767,13355760,TXFE7,128,9957,10,82440,40830,42075
13355867,13355855,TXFE7,128,9956,7,82447,40831,42076
13360092,13360082,TXFE7,128,9957,1,82448,40832,42077
13360092,13360089,TXFE7,128,9957,1,82449,40833,42078
13360104,13360095,TXFE7,128,9957,1,82450,40834,42079
13360154,13360144,TXFE7,128,9957,10,82460,40835,42083
13360204,13360192,TXFE7,128,9956,2,82462,40836,42084
13360242,13360241,TXFE7,128,9957,3,82465,40837,42086
13360279,13360273,TXFE7,128,9956,1,82466,40838,42087
13360454,13360449,TXFE7,128,9956,1,82467,40839,42088
13360479,13360470,TXFE7,128,9957,2,82469,40840,42090
13360492,13360482,TXFE7,128,9957,10,82479,40841,42091
13360492,13360486,TXFE7,128,9957,1,82480,40842,42092
13360754,13360751,TXFE7,128,9956,20,82500,40844,42093
13360804,13360802,TXFE7,128,9957,5,82505,40845,42094
13360854,13360842,TXFE7,128,9957,1,82506,40846,42095
13360854,13360854,TXFE7,128,9957,1,82507,40847,42096
13360942,13360932,TXFE7,128,9956,1,82508,40848,42097
13360942,13360933,TXFE7,128,9957,3,82511,40849,42099
13360942,13360933,TXFE7,128,9956,2,82513,40850,42100
13360979,13360973,TXFE7,128,9957,1,82514,40851,42101
13361004,13360994,TXFE7,128,9957,1,82515,40852,42102
13361017,13361010,TXFE7,128,9957,1,82516,40853,42103
13361029,13361026,TXFE7,128,9957,2,82518,40854,42104
13361129,13361117,TXFE7,128,9957,1,82519,40855,42105
13361129,13361125,TXFE7,128,9957,1,82520,40856,42106
13361179,13361170,TXFE7,128,9957,1,82521,40857,42107
13361254,13361251,TXFE7,128,9957,1,82522,40858,42108
13361267,13361260,TXFE7,128,9956,1,82523,40859,42109
13361267,13361267,TXFE7,128,9957,1,82524,40860,42110
13361392,13361391,TXFE7,128,9956,1,82525,40861,42111
13361742,13361737,TXFE7,128,9957,1,82526,40862,42112
13361879,13361869,TXFE7,128,9956,1,82527,40863,42113
13362104,13362093,TXFE7,128,9957,1,82528,40864,42114
13362104,13362099,TXFE7,128,9957,1,82529,40865,42115
13362129,13362122,TXFE7,128,9957,1,82530,40866,42116
13362142,13362136,TXFE7,128,9957,10,82540,40867,42121
13362179,13362176,TXFE7,128,9957,5,82545,40868,42123
13362204,13362194,TXFE7,128,9957,1,82546,40869,42124
13362242,13362238,TXFE7,128,9957,5,82551,40870,42126
13362304,13362294,TXFE7,128,9957,1,82552,40871,42127
13362329,13362328,TXFE7,128,9957,1,82553,40872,42128
13362542,13362538,TXFE7,128,9957,1,82554,40873,42129
13362567,13362559,TXFE7,128,9956,1,82555,40874,42130
13362692,13362691,TXFE7,128,9957,15,82570,40875,42139
13362729,13362718,TXFE7,128,9957,1,82571,40876,42140
13362742,13362737,TXFE7,128,9957,1,82572,40877,42141
13362779,13362777,TXFE7,128,9957,5,82577,40878,42142
13362817,13362811,TXFE7,128,9957,4,82581,40879,42143
13362892,13362887,TXFE7,128,9957,2,82583,40880,42144
13362917,13362917,TXFE7,128,9957,1,82584,40881,42145
13362942,13362932,TXFE7,128,9957,4,82588,40882,42146
13362954,13362944,TXFE7,128,9957,2,82590,40883,42148
13362992,13362985,TXFE7,128,9957,1,82591,40884,42149
13363092,13363079,TXFE7,128,9957,1,82592,40885,42150
13363104,13363095,TXFE7,128,9957,1,82593,40886,42151
13363104,13363100,TXFE7,128,9957,1,82594,40887,42152
13363204,13363199,TXFE7,128,9957,2,82596,40888,42153
13363217,13363206,TXFE7,128,9957,1,82597,40889,42154
13363279,13363268,TXFE7,128,9957,1,82598,40890,42155
13363304,13363294,TXFE7,128,9957,1,82599,40891,42156
13363517,13363509,TXFE7,128,9957,1,82600,40892,42157
13363917,13363907,TXFE7,128,9957,1,82601,40893,42158
13363979,13363978,TXFE7,128,9957,5,82606,40894,42163
13364004,13363994,TXFE7,128,9957,2,82608,40895,42165
13364054,13364042,TXFE7,128,9957,1,82609,40896,42166
13364054,13364048,TXFE7,128,9957,1,82610,40897,42167
13364142,13364134,TXFE7,128,9957,1,82611,40898,42168
13364154,13364144,TXFE7,128,9957,1,82612,40899,42169
13364179,13364168,TXFE7,128,9956,4,82616,40900,42170
13364192,13364185,TXFE7,128,9957,2,82618,40901,42171
13364317,13364305,TXFE7,128,9957,1,82619,40902,42172
13364379,13364372,TXFE7,128,9957,5,82624,40903,42177
13364479,13364467,TXFE7,128,9957,2,82626,40904,42179
13364542,13364536,TXFE7,128,9956,3,82629,40907,42180
13364554,13364553,TXFE7,128,9957,2,82631,40908,42182
13364629,13364623,TXFE7,128,9956,1,82632,40909,42183
13364692,13364691,TXFE7,128,9957,2,82634,40910,42185
13364704,13364699,TXFE7,128,9957,5,82639,40911,42186
13364904,13364894,TXFE7,128,9957,3,82642,40912,42188
13365017,13365010,TXFE7,128,9957,1,82643,40913,42189
13365042,13365040,TXFE7,128,9957,1,82644,40914,42190
13365054,13365044,TXFE7,128,9957,1,82645,40915,42191
13365054,13365044,TXFE7,128,9957,1,82646,40916,42192
13365079,13365074,TXFE7,128,9957,1,82647,40917,42193
13365092,13365090,TXFE7,128,9957,10,82657,40918,42199
13365117,13365110,TXFE7,128,9957,1,82658,40919,42200
13365254,13365249,TXFE7,128,9957,3,82661,40920,42203
13365329,13365318,TXFE7,128,9957,1,82662,40921,42204
13365492,13365492,TXFE7,128,9957,3,82665,40922,42207
13365504,13365501,TXFE7,128,9957,1,82666,40923,42208
13365629,13365624,TXFE7,128,9957,2,82668,40924,42210
13365642,13365636,TXFE7,128,9957,1,82669,40925,42211
13365729,13365726,TXFE7,128,9957,2,82671,40926,42212
13365804,13365795,TXFE7,128,9957,2,82673,40927,42214
13365829,13365822,TXFE7,128,9957,3,82676,40928,42217
13365829,13365823,TXFE7,128,9957,3,82679,40929,42218
13365854,13365845,TXFE7,128,9957,1,82680,40930,42219
13370017,13370007,TXFE7,128,9956,1,82681,40931,42220
13370067,13370055,TXFE7,128,9957,1,82682,40932,42221
13370067,13370060,TXFE7,128,9957,1,82683,40933,42222
13370092,13370083,TXFE7,128,9957,12,82695,40934,42230
13370192,13370190,TXFE7,128,9957,1,82696,40935,42231
13370292,13370288,TXFE7,128,9957,1,82697,40936,42232
13370304,13370300,TXFE7,128,9956,2,82699,40937,42233
13370379,13370378,TXFE7,128,9957,1,82700,40938,42234
13370454,13370447,TXFE7,128,9957,1,82701,40939,42235
13370579,13370575,TXFE7,128,9957,2,82703,40940,42236
13370679,13370671,TXFE7,128,9957,1,82704,40941,42237
13370679,13370677,TXFE7,128,9957,7,82711,40942,42242
13370767,13370761,TXFE7,128,9957,15,82726,40943,42243
13370779,13370767,TXFE7,128,9957,1,82727,40944,42244
13370779,13370767,TXFE7,128,9957,2,82729,40945,42246
13370779,13370767,TXFE7,128,9957,3,82732,40946,42249
13370779,13370767,TXFE7,128,9957,2,82734,40947,42251
13370779,13370770,TXFE7,128,9957,18,82752,40948,42259
13370917,13370916,TXFE7,128,9958,2,82754,40949,42260
13370929,13370919,TXFE7,128,9958,2,82756,40950,42261
13370929,13370923,TXFE7,128,9958,1,82757,40951,42262
13370954,13370947,TXFE7,128,9958,1,82758,40952,42263
13371042,13371029,TXFE7,128,9957,1,82759,40953,42264
13371079,13371069,TXFE7,128,9958,1,82760,40954,42265
13371079,13371073,TXFE7,128,9958,1,82761,40955,42266
13371079,13371077,TXFE7,128,9958,1,82762,40956,42267
13371229,13371229,TXFE7,128,9957,20,82782,40958,42268
13371304,13371302,TXFE7,128,9958,5,82787,40959,42273
13371404,13371398,TXFE7,128,9958,1,82788,40960,42274
13371504,13371500,TXFE7,128,9958,1,82789,40961,42275
13371654,13371652,TXFE7,128,9958,6,82795,40962,42278
13371692,13371689,TXFE7,128,9957,2,82797,40963,42279
13371892,13371889,TXFE7,128,9957,1,82798,40964,42280
13371917,13371907,TXFE7,128,9958,1,82799,40965,42281
13371917,13371909,TXFE7,128,9958,1,82800,40966,42282
13371929,13371928,TXFE7,128,9958,1,82801,40967,42283
13371954,13371945,TXFE7,128,9958,1,82802,40968,42284
13371954,13371946,TXFE7,128,9958,1,82803,40969,42285
13371992,13371983,TXFE7,128,9958,1,82804,40970,42286
13371992,13371984,TXFE7,128,9958,1,82805,40971,42287
13372029,13372020,TXFE7,128,9958,1,82806,40972,42288
13372029,13372021,TXFE7,128,9958,1,82807,40973,42289
13372067,13372059,TXFE7,128,9958,1,82808,40974,42290
13372067,13372060,TXFE7,128,9958,1,82809,40975,42291
13372067,13372065,TXFE7,128,9958,1,82810,40976,42292
13372079,13372071,TXFE7,128,9958,1,82811,40977,42293
13372104,13372095,TXFE7,128,9958,1,82812,40978,42294
13372104,13372096,TXFE7,128,9958,1,82813,40979,42295
13372117,13372112,TXFE7,128,9958,1,82814,40980,42296
13372142,13372130,TXFE7,128,9958,1,82815,40981,42297
13372142,13372131,TXFE7,128,9958,1,82816,40982,42298
13372142,13372132,TXFE7,128,9957,2,82818,40983,42299
13372154,13372153,TXFE7,128,9958,3,82821,40984,42302
13372167,13372160,TXFE7,128,9958,1,82822,40985,42303
13372167,13372165,TXFE7,128,9958,1,82823,40986,42304
13372167,13372166,TXFE7,128,9958,1,82824,40987,42305
13372242,13372232,TXFE7,128,9958,1,82825,40988,42306
13372242,13372232,TXFE7,128,9958,1,82826,40989,42307
13372254,13372243,TXFE7,128,9958,1,82827,40990,42308
13372254,13372243,TXFE7,128,9958,1,82828,40991,42309
13372292,13372281,TXFE7,128,9958,1,82829,40992,42310
13372292,13372282,TXFE7,128,9958,1,82830,40993,42311
13372292,13372285,TXFE7,128,9958,2,82832,40994,42313
13372329,13372320,TXFE7,128,9958,1,82833,40995,42314
13372329,13372322,TXFE7,128,9958,1,82834,40996,42315
13372367,13372359,TXFE7,128,9958,1,82835,40997,42316
13372367,13372359,TXFE7,128,9958,2,82837,40998,42318
13372367,13372360,TXFE7,128,9958,1,82838,40999,42319
13372404,13372401,TXFE7,128,9958,1,82839,41000,42320
13372417,13372409,TXFE7,128,9958,1,82840,41001,42321
13372454,13372449,TXFE7,128,9958,1,82841,41002,42322
13372479,13372478,TXFE7,128,9958,15,82856,41003,42332
13372529,13372518,TXFE7,128,9958,1,82857,41004,42333
13372529,13372518,TXFE7,128,9958,5,82862,41005,42338
13372542,13372538,TXFE7,128,9958,5,82867,41006,42340
13372554,13372548,TXFE7,128,9958,1,82868,41007,42341
13372567,13372563,TXFE7,128,9958,1,82869,41008,42342
13372579,13372568,TXFE7,128,9958,2,82871,41009,42343
13372579,13372574,TXFE7,128,9958,1,82872,41010,42344
13372592,13372585,TXFE7,128,9958,1,82873,41011,42345
13372604,13372592,TXFE7,128,9958,5,82878,41012,42347
13372642,13372632,TXFE7,128,9958,1,82879,41013,42348
13372679,13372675,TXFE7,128,9958,44,82923,41014,42367
13372692,13372679,TXFE7,128,9958,9,82932,41015,42375
13372704,13372692,TXFE7,128,9959,1,82933,41016,42376
13372704,13372694,TXFE7,128,9958,1,82934,41017,42377
13372704,13372694,TXFE7,128,9958,1,82935,41018,42378
13372754,13372749,TXFE7,128,9958,1,82936,41019,42379
13372767,13372754,TXFE7,128,9958,1,82937,41020,42380
13372829,13372824,TXFE7,128,9958,1,82938,41021,42381
13372854,13372852,TXFE7,128,9958,3,82941,41022,42382
13372854,13372852,TXFE7,128,9958,1,82942,41023,42383
13372854,13372852,TXFE7,128,9958,1,82943,41024,42384
13372854,13372852,TXFE7,128,9958,1,82944,41025,42385
13372854,13372852,TXFE7,128,9958,1,82945,41026,42386
13372854,13372852,TXFE7,128,9958,1,82946,41027,42387
13372854,13372852,TXFE7,128,9958,1,82947,41028,42388
13372854,13372852,TXFE7,128,9958,2,82949,41029,42389
13372854,13372853,TXFE7,128,9958,4,82953,41030,42390
13372854,13372853,TXFE7,128,9958,1,82954,41031,42391
13372854,13372853,TXFE7,128,9958,1,82955,41032,42392
13372854,13372853,TXFE7,128,9958,1,82956,41033,42393
13372867,13372854,TXFE7,128,9958,2,82958,41035,42394
13372879,13372873,TXFE7,128,9958,1,82959,41036,42395
13372879,13372874,TXFE7,128,9959,1,82960,41037,42396
13372979,13372977,TXFE7,128,9959,1,82961,41038,42397
13373067,13373066,TXFE7,128,9959,1,82962,41039,42398
13373079,13373072,TXFE7,128,9959,1,82963,41040,42399
13373092,13373082,TXFE7,128,9958,2,82965,41042,42400
13373142,13373138,TXFE7,128,9959,5,82970,41043,42401
13373204,13373192,TXFE7,128,9959,1,82971,41044,42402
13373217,13373208,TXFE7,128,9959,1,82972,41045,42403
13373254,13373246,TXFE7,128,9959,1,82973,41046,42404
13373267,13373265,TXFE7,128,9958,1,82974,41047,42405
13373279,13373277,TXFE7,128,9958,1,82975,41048,42406
13373342,13373331,TXFE7,128,9959,1,82976,41049,42407
13373442,13373436,TXFE7,128,9958,1,82977,41050,42408
13373504,13373492,TXFE7,128,9958,1,82978,41051,42409
13373504,13373500,TXFE7,128,9959,5,82983,41052,42412
13373504,13373500,TXFE7,128,9958,1,82984,41053,42413
13373529,13373518,TXFE7,128,9959,2,82986,41054,42415
13373592,13373582,TXFE7,128,9958,1,82987,41055,42416
13373667,13373660,TXFE7,128,9958,1,82988,41056,42417
13373729,13373725,TXFE7,128,9958,1,82989,41057,42418
13373754,13373745,TXFE7,128,9958,1,82990,41058,42419
13373754,13373747,TXFE7,128,9958,1,82991,41059,42420
13373792,13373785,TXFE7,128,9959,1,82992,41060,42421
13373792,13373792,TXFE7,128,9959,1,82993,41061,42422
13374054,13374053,TXFE7,128,9958,1,82994,41062,42423
13374079,13374077,TXFE7,128,9959,1,82995,41063,42424
13374092,13374082,TXFE7,128,9958,1,82996,41064,42425
13374092,13374082,TXFE7,128,9959,1,82997,41065,42426
13374117,13374109,TXFE7,128,9958,1,82998,41066,42427
13374154,13374153,TXFE7,128,9959,1,82999,41067,42428
13374267,13374261,TXFE7,128,9959,1,83000,41068,42429
13374292,13374285,TXFE7,128,9958,1,83001,41069,42430
13374342,13374332,TXFE7,128,9959,3,83004,41070,42432
13374379,13374379,TXFE7,128,9959,1,83005,41071,42433
13374392,13374380,TXFE7,128,9958,1,83006,41072,42434
13374392,13374388,TXFE7,128,9958,1,83007,41073,42435
13374467,13374465,TXFE7,128,9959,1,83008,41074,42436
13374729,13374723,TXFE7,128,9959,11,83019,41075,42445
13374742,13374734,TXFE7,128,9958,1,83020,41076,42446
13374754,13374751,TXFE7,128,9959,1,83021,41077,42447
13374867,13374854,TXFE7,128,9958,1,83022,41078,42448
13374992,13374991,TXFE7,128,9959,1,83023,41079,42449
13375004,13375001,TXFE7,128,9959,2,83025,41080,42451
13375079,13375074,TXFE7,128,9959,1,83026,41081,42452
13375104,13375092,TXFE7,128,9958,3,83029,41083,42453
13375117,13375108,TXFE7,128,9959,1,83030,41084,42454
13375154,13375151,TXFE7,128,9958,1,83031,41085,42455
13375229,13375222,TXFE7,128,9959,1,83032,41086,42456
13375242,13375238,TXFE7,128,9959,1,83033,41087,42457
13375267,13375259,TXFE7,128,9959,2,83035,41088,42458
13375279,13375268,TXFE7,128,9958,1,83036,41089,42459
13375304,13375303,TXFE7,128,9959,1,83037,41090,42460
13375317,13375314,TXFE7,128,9959,1,83038,41091,42461
13375329,13375321,TXFE7,128,9959,1,83039,41092,42462
13375604,13375597,TXFE7,128,9958,1,83040,41093,42463
13375704,13375694,TXFE7,128,9959,1,83041,41094,42464
13375729,13375720,TXFE7,128,9959,1,83042,41095,42465
13375954,13375947,TXFE7,128,9959,1,83043,41096,42466
13375979,13375975,TXFE7,128,9959,1,83044,41097,42467
13380092,13380087,TXFE7,128,9959,1,83045,41098,42468
13380104,13380095,TXFE7,128,9959,1,83046,41099,42469
13380129,13380118,TXFE7,128,9958,6,83052,41100,42470
13380167,13380154,TXFE7,128,9958,2,83054,41102,42471
13380442,13380441,TXFE7,128,9959,1,83055,41103,42472
13380454,13380454,TXFE7,128,9959,11,83066,41104,42478
13380517,13380504,TXFE7,128,9958,1,83067,41105,42479
13380729,13380726,TXFE7,128,9959,1,83068,41106,42480
13380742,13380734,TXFE7,128,9958,2,83070,41108,42481
13380892,13380883,TXFE7,128,9959,1,83071,41109,42482
13381054,13381043,TXFE7,128,9959,1,83072,41110,42483
13381067,13381058,TXFE7,128,9959,1,83073,41111,42484
13381067,13381065,TXFE7,128,9959,1,83074,41112,42485
13381067,13381066,TXFE7,128,9959,1,83075,41113,42486
13381242,13381238,TXFE7,128,9958,1,83076,41114,42487
13381254,13381244,TXFE7,128,9959,1,83077,41115,42488
13381304,13381299,TXFE7,128,9959,10,83087,41116,42495
13381429,13381417,TXFE7,128,9958,1,83088,41117,42496
13381567,13381564,TXFE7,128,9959,2,83090,41118,42498
13381629,13381625,TXFE7,128,9958,3,83093,41119,42499
13381629,13381627,TXFE7,128,9959,1,83094,41120,42500
13381667,13381664,TXFE7,128,9959,100,83194,41121,42547
13381679,13381667,TXFE7,128,9959,2,83196,41122,42548
13381679,13381667,TXFE7,128,9959,28,83224,41123,42559
13381679,13381667,TXFE7,128,9959,5,83229,41124,42560
13381692,13381679,TXFE7,128,9959,6,83235,41125,42563
13381692,13381679,TXFE7,128,9959,8,83243,41126,42569
13381692,13381679,TXFE7,128,9959,6,83249,41127,42571
13381692,13381680,TXFE7,128,9960,1,83250,41128,42572
13381704,13381698,TXFE7,128,9960,1,83251,41129,42573
13381867,13381855,TXFE7,128,9959,5,83256,41132,42574
13381904,13381901,TXFE7,128,9959,1,83257,41133,42575
13382004,13382004,TXFE7,128,9959,1,83258,41134,42576
13382054,13382048,TXFE7,128,9959,1,83259,41135,42577
13382079,13382075,TXFE7,128,9960,1,83260,41136,42578
13382079,13382078,TXFE7,128,9960,1,83261,41137,42579
13382129,13382119,TXFE7,128,9959,5,83266,41139,42581
13382292,13382284,TXFE7,128,9960,1,83267,41140,42582
13382292,13382290,TXFE7,128,9959,5,83272,41143,42583
13382367,13382366,TXFE7,128,9960,1,83273,41144,42584
13382379,13382369,TXFE7,128,9959,5,83278,41146,42585
13382404,13382399,TXFE7,128,9959,1,83279,41147,42586
13382442,13382442,TXFE7,128,9959,2,83281,41148,42587
13382492,13382481,TXFE7,128,9959,5,83286,41151,42588
13382504,13382492,TXFE7,128,9959,3,83289,41152,42589
13382504,13382502,TXFE7,128,9959,1,83290,41153,42590
13382517,13382509,TXFE7,128,9959,5,83295,41157,42591
13382517,13382517,TXFE7,128,9959,1,83296,41158,42592
13382654,13382645,TXFE7,128,9959,1,83297,41159,42593
13382667,13382663,TXFE7,128,9960,1,83298,41160,42594
13382667,13382667,TXFE7,128,9959,1,83299,41161,42595
13382767,13382766,TXFE7,128,9959,1,83300,41162,42596
13382779,13382776,TXFE7,128,9959,5,83305,41164,42597
13382829,13382817,TXFE7,128,9960,1,83306,41165,42598
13382842,13382839,TXFE7,128,9960,1,83307,41166,42599
13382867,13382863,TXFE7,128,9959,4,83311,41167,42600
13382904,13382893,TXFE7,128,9959,4,83315,41169,42601
13382992,13382990,TXFE7,128,9959,2,83317,41170,42602
13383017,13383007,TXFE7,128,9959,9,83326,41176,42603
13383029,13383023,TXFE7,128,9959,1,83327,41177,42604
13383092,13383090,TXFE7,128,9959,1,83328,41178,42605
13383117,13383105,TXFE7,128,9959,1,83329,41179,42606
13383142,13383141,TXFE7,128,9959,1,83330,41180,42607
13383167,13383156,TXFE7,128,9959,1,83331,41181,42608
13383242,13383238,TXFE7,128,9959,1,83332,41182,42609
13383317,13383307,TXFE7,128,9959,1,83333,41183,42610
13383342,13383336,TXFE7,128,9959,1,83334,41184,42611
13383429,13383421,TXFE7,128,9959,2,83336,41185,42612
13383704,13383696,TXFE7,128,9959,1,83337,41186,42613
13383742,13383737,TXFE7,128,9959,2,83339,41187,42614
13383854,13383848,TXFE7,128,9959,1,83340,41188,42615
13383867,13383862,TXFE7,128,9959,1,83341,41189,42616
13383954,13383946,TXFE7,128,9958,1,83342,41190,42617
13383954,13383948,TXFE7,128,9958,2,83344,41192,42618
13383954,13383951,TXFE7,128,9958,1,83345,41193,42619
13383967,13383965,TXFE7,128,9959,1,83346,41194,42620
13383992,13383990,TXFE7,128,9959,1,83347,41195,42621
13384017,13384009,TXFE7,128,9959,1,83348,41196,42622
13384042,13384039,TXFE7,128,9959,4,83352,41197,42626
13384079,13384067,TXFE7,128,9959,5,83357,41198,42628
13384092,13384091,TXFE7,128,9959,1,83358,41199,42629
13384104,13384095,TXFE7,128,9959,1,83359,41200,42630
13384117,13384110,TXFE7,128,9959,1,83360,41201,42631
13384142,13384141,TXFE7,128,9959,1,83361,41202,42632
13384154,13384144,TXFE7,128,9959,1,83362,41203,42633
13384192,13384189,TXFE7,128,9959,5,83367,41204,42638
13384229,13384223,TXFE7,128,9958,3,83370,41205,42639
13384342,13384333,TXFE7,128,9959,2,83372,41206,42640
13384492,13384486,TXFE7,128,9960,1,83373,41207,42641
13384567,13384556,TXFE7,128,9960,5,83378,41208,42646
13384592,13384586,TXFE7,128,9959,1,83379,41209,42647
13384929,13384928,TXFE7,128,9959,1,83380,41210,42648
13384942,13384930,TXFE7,128,9959,1,83381,41211,42649
13384967,13384958,TXFE7,128,9959,1,83382,41212,42650
13385042,13385034,TXFE7,128,9959,1,83383,41213,42651
13385079,13385079,TXFE7,128,9960,2,83385,41214,42653
13385079,13385079,TXFE7,128,9959,2,83387,41215,42654
13385092,13385081,TXFE7,128,9960,1,83388,41216,42655
13385092,13385087,TXFE7,128,9960,1,83389,41217,42656
13385104,13385092,TXFE7,128,9959,1,83390,41218,42657
13385104,13385098,TXFE7,128,9959,2,83392,41220,42658
13385204,13385203,TXFE7,128,9959,1,83393,41221,42659
13385229,13385221,TXFE7,128,9959,1,83394,41222,42660
13385229,13385227,TXFE7,128,9959,1,83395,41223,42661
13385417,13385416,TXFE7,128,9960,2,83397,41224,42662
13385504,13385492,TXFE7,128,9959,21,83418,41236,42663
13385629,13385619,TXFE7,128,9960,9,83427,41237,42672
13385792,13385779,TXFE7,128,9960,3,83430,41238,42675
13385792,13385791,TXFE7,128,9959,1,83431,41239,42676
13385804,13385803,TXFE7,128,9959,2,83433,41240,42677
13385867,13385855,TXFE7,128,9959,1,83434,41241,42678
13385879,13385875,TXFE7,128,9959,1,83435,41242,42679
13385904,13385902,TXFE7,128,9959,1,83436,41243,42680
13390104,13390103,TXFE7,128,9960,1,83437,41244,42681
13390117,13390109,TXFE7,128,9960,1,83438,41245,42682
13390117,13390111,TXFE7,128,9959,2,83440,41246,42683
13390129,13390119,TXFE7,128,9959,2,83442,41247,42684
13390129,13390119,TXFE7,128,9959,2,83444,41249,42685
13390129,13390119,TXFE7,128,9959,2,83446,41250,42686
13390129,13390120,TXFE7,128,9960,1,83447,41251,42687
13390129,13390126,TXFE7,128,9959,3,83450,41252,42688
13390129,13390127,TXFE7,128,9959,2,83452,41254,42689
13390142,13390130,TXFE7,128,9959,7,83459,41255,42690
13390142,13390134,TXFE7,128,9959,5,83464,41256,42691
13390154,13390151,TXFE7,128,9959,2,83466,41258,42692
13390167,13390154,TXFE7,128,9959,6,83472,41261,42693
13390167,13390156,TXFE7,128,9959,2,83474,41262,42694
13390167,13390163,TXFE7,128,9959,1,83475,41263,42695
13390179,13390167,TXFE7,128,9959,8,83483,41268,42696
13390179,13390167,TXFE7,128,9959,6,83489,41271,42697
13390192,13390179,TXFE7,128,9959,7,83496,41272,42698
13390192,13390179,TXFE7,128,9959,2,83498,41273,42699
13390229,13390224,TXFE7,128,9959,10,83508,41276,42700
13390242,13390229,TXFE7,128,9959,2,83510,41278,42701
13390242,13390229,TXFE7,128,9959,1,83511,41279,42702
13390254,13390246,TXFE7,128,9959,1,83512,41280,42703
13390267,13390258,TXFE7,128,9959,1,83513,41281,42704
13390279,13390275,TXFE7,128,9959,5,83518,41284,42705
13390292,13390284,TXFE7,128,9959,1,83519,41285,42706
13390354,13390343,TXFE7,128,9959,1,83520,41286,42707
13390504,13390495,TXFE7,128,9959,1,83521,41287,42708
13390567,13390555,TXFE7,128,9958,1,83522,41288,42709
13390629,13390619,TXFE7,128,9959,10,83532,41289,42714
13390679,13390673,TXFE7,128,9959,4,83536,41290,42715
13390879,13390870,TXFE7,128,9959,1,83537,41291,42716
13390879,13390875,TXFE7,128,9959,10,83547,41292,42719
13390917,13390906,TXFE7,128,9959,1,83548,41293,42720
13391004,13390997,TXFE7,128,9958,1,83549,41294,42721
13391017,13391008,TXFE7,128,9958,1,83550,41295,42722
13391129,13391125,TXFE7,128,9959,1,83551,41296,42723
13391154,13391145,TXFE7,128,9959,1,83552,41297,42724
13391529,13391525,TXFE7,128,9959,2,83554,41298,42725
13391617,13391609,TXFE7,128,9959,10,83564,41299,42730
13391767,13391756,TXFE7,128,9959,1,83565,41300,42731
13391792,13391783,TXFE7,128,9959,2,83567,41301,42732
13391842,13391840,TXFE7,128,9959,10,83577,41302,42739
13391854,13391854,TXFE7,128,9959,1,83578,41303,42740
13391979,13391972,TXFE7,128,9958,2,83580,41304,42741
13391992,13391979,TXFE7,128,9958,1,83581,41305,42742
13392079,13392068,TXFE7,128,9959,1,83582,41306,42743
13392079,13392073,TXFE7,128,9959,1,83583,41307,42744
13392117,13392110,TXFE7,128,9959,1,83584,41308,42745
13392254,13392250,TXFE7,128,9959,1,83585,41309,42746
13392292,13392282,TXFE7,128,9959,1,83586,41310,42747
13392454,13392445,TXFE7,128,9959,1,83587,41311,42748
13392592,13392584,TXFE7,128,9959,4,83591,41312,42749
13392617,13392606,TXFE7,128,9958,4,83595,41313,42750
13392617,13392613,TXFE7,128,9958,2,83597,41314,42751
13392704,13392698,TXFE7,128,9959,1,83598,41315,42752
13392742,13392733,TXFE7,128,9959,1,83599,41316,42753
13392754,13392746,TXFE7,128,9959,1,83600,41317,42754
13392767,13392763,TXFE7,128,9958,2,83602,41319,42755
13392792,13392791,TXFE7,128,9958,1,83603,41320,42756
13392804,13392799,TXFE7,128,9958,1,83604,41321,42757
13393042,13393035,TXFE7,128,9959,1,83605,41322,42758
13393042,13393041,TXFE7,128,9959,1,83606,41323,42759
13393092,13393087,TXFE7,128,9958,1,83607,41324,42760
13393204,13393192,TXFE7,128,9959,1,83608,41325,42761
13393204,13393202,TXFE7,128,9958,19,83627,41333,42762
13393204,13393202,TXFE7,128,9958,36,83663,41339,42763
13393217,13393213,TXFE7,128,9958,3,83666,41341,42764
13393254,13393249,TXFE7,128,9958,1,83667,41342,42765
13393292,13393289,TXFE7,128,9958,7,83674,41348,42766
13393329,13393320,TXFE7,128,9958,2,83676,41349,42767
13393329,13393327,TXFE7,128,9958,1,83677,41350,42768
13393392,13393382,TXFE7,128,9958,2,83679,41351,42769
13393417,13393412,TXFE7,128,9958,1,83680,41352,42770
13393442,13393430,TXFE7,128,9958,2,83682,41353,42771
13393454,13393452,TXFE7,128,9958,6,83688,41354,42772
13393479,13393475,TXFE7,128,9958,2,83690,41355,42773
13393542,13393532,TXFE7,128,9958,5,83695,41357,42774
13393629,13393622,TXFE7,128,9958,2,83697,41359,42775
13393642,13393634,TXFE7,128,9958,1,83698,41360,42776
13393642,13393635,TXFE7,128,9958,1,83699,41361,42777
13393642,13393641,TXFE7,128,9958,1,83700,41362,42778
13393654,13393652,TXFE7,128,9958,2,83702,41363,42779
13393704,13393694,TXFE7,128,9959,2,83704,41364,42780
13393754,13393754,TXFE7,128,9959,1,83705,41365,42781
13393842,13393840,TXFE7,128,9958,9,83714,41368,42782
13393929,13393926,TXFE7,128,9958,1,83715,41369,42783
13393992,13393987,TXFE7,128,9958,1,83716,41370,42784
13394079,13394072,TXFE7,128,9959,1,83717,41371,42785
13394092,13394083,TXFE7,128,9959,1,83718,41372,42786
13394092,13394085,TXFE7,128,9959,1,83719,41373,42787
13394154,13394153,TXFE7,128,9958,2,83721,41375,42788
13394167,13394161,TXFE7,128,9958,1,83722,41376,42789
13394204,13394204,TXFE7,128,9959,100,83822,41377,42824
13394217,13394204,TXFE7,128,9959,2,83824,41378,42826
13394217,13394204,TXFE7,128,9959,2,83826,41379,42827
13394217,13394204,TXFE7,128,9959,19,83845,41380,42831
13394217,13394204,TXFE7,128,9959,1,83846,41381,42832
13394217,13394208,TXFE7,128,9959,1,83847,41382,42833
13394217,13394209,TXFE7,128,9959,3,83850,41383,42834
13394217,13394209,TXFE7,128,9959,2,83852,41384,42835
13394217,13394209,TXFE7,128,9959,6,83858,41385,42837
13394217,13394209,TXFE7,128,9959,2,83860,41386,42839
13394229,13394217,TXFE7,128,9959,6,83866,41387,42841
13394229,13394217,TXFE7,128,9959,7,83873,41388,42845
13394229,13394219,TXFE7,128,9959,1,83874,41389,42846
13394242,13394229,TXFE7,128,9959,1,83875,41390,42847
13394254,13394244,TXFE7,128,9959,1,83876,41391,42848
13394342,13394332,TXFE7,128,9959,1,83877,41392,42849
13394354,13394345,TXFE7,128,9959,1,83878,41393,42850
13394429,13394423,TXFE7,128,9959,1,83879,41394,42851
13394504,13394497,TXFE7,128,9959,1,83880,41395,42852
13394504,13394502,TXFE7,128,9959,1,83881,41396,42853
13394517,13394507,TXFE7,128,9959,1,83882,41397,42854
13394529,13394527,TXFE7,128,9959,2,83884,41399,42855
13394579,13394576,TXFE7,128,9958,1,83885,41400,42856
13394692,13394687,TXFE7,128,9959,3,83888,41401,42857
13394729,13394727,TXFE7,128,9959,4,83892,41402,42858
13394754,13394748,TXFE7,128,9959,2,83894,41403,42859
13394779,13394767,TXFE7,128,9958,2,83896,41404,42860
13394842,13394833,TXFE7,128,9959,1,83897,41405,42861
13394842,13394835,TXFE7,128,9959,1,83898,41406,42862
13394867,13394864,TXFE7,128,9960,100,83998,41407,42914
13394967,13394956,TXFE7,128,9959,2,84000,41409,42915
13395004,13394999,TXFE7,128,9959,1,84001,41410,42916
13395017,13395016,TXFE7,128,9960,5,84006,41411,42918
13395029,13395021,TXFE7,128,9960,5,84011,41412,42922
13395042,13395034,TXFE7,128,9960,5,84016,41413,42925
13395067,13395058,TXFE7,128,9960,5,84021,41414,42928
13395104,13395098,TXFE7,128,9960,1,84022,41415,42929
13395117,13395107,TXFE7,128,9960,1,84023,41416,42930
13395229,13395221,TXFE7,128,9959,1,84024,41417,42931
13395229,13395222,TXFE7,128,9959,2,84026,41419,42932
13395242,13395238,TXFE7,128,9960,1,84027,41420,42933
13395242,13395239,TXFE7,128,9960,6,84033,41421,42934
13395317,13395312,TXFE7,128,9960,1,84034,41422,42935
13395342,13395334,TXFE7,128,9959,1,84035,41423,42936
13395392,13395381,TXFE7,128,9960,1,84036,41424,42937
13395442,13395434,TXFE7,128,9960,5,84041,41425,42938
13395454,13395446,TXFE7,128,9960,5,84046,41426,42939
13395679,13395673,TXFE7,128,9959,1,84047,41427,42940
13395717,13395708,TXFE7,128,9960,3,84050,41428,42941
13395854,13395852,TXFE7,128,9959,2,84052,41429,42942
13395892,13395886,TXFE7,128,9959,7,84059,41433,42943
13395954,13395946,TXFE7,128,9959,10,84069,41436,42944
13400017,13400015,TXFE7,128,9959,2,84071,41438,42945
13400029,13400021,TXFE7,128,9960,2,84073,41439,42946
13400029,13400022,TXFE7,128,9960,5,84078,41440,42947
13400042,13400034,TXFE7,128,9960,5,84083,41441,42951
13400042,13400042,TXFE7,128,9959,1,84084,41442,42952
13400054,13400047,TXFE7,128,9960,5,84089,41443,42954
13400079,13400076,TXFE7,128,9960,5,84094,41444,42958
13400129,13400118,TXFE7,128,9960,2,84096,41445,42960
13400129,13400124,TXFE7,128,9960,1,84097,41446,42961
13400142,13400132,TXFE7,128,9960,1,84098,41447,42962
13400154,13400143,TXFE7,128,9959,2,84100,41448,42963
13400154,13400151,TXFE7,128,9959,1,84101,41449,42964
13400154,13400152,TXFE7,128,9960,3,84104,41450,42965
13400154,13400154,TXFE7,128,9960,3,84107,41451,42966
13400167,13400157,TXFE7,128,9960,1,84108,41452,42967
13400167,13400162,TXFE7,128,9960,2,84110,41453,42969
13400167,13400164,TXFE7,128,9960,1,84111,41454,42970
13400167,13400166,TXFE7,128,9959,1,84112,41455,42971
13400179,13400170,TXFE7,128,9960,1,84113,41456,42972
13400179,13400170,TXFE7,128,9960,1,84114,41457,42973
13400179,13400178,TXFE7,128,9960,1,84115,41458,42974
13400192,13400187,TXFE7,128,9959,3,84118,41461,42975
13400229,13400218,TXFE7,128,9960,1,84119,41462,42976
13400404,13400399,TXFE7,128,9959,2,84121,41463,42977
13400417,13400406,TXFE7,128,9960,1,84122,41464,42978
13400542,13400535,TXFE7,128,9960,1,84123,41465,42979
13400554,13400547,TXFE7,128,9959,1,84124,41466,42980
13400554,13400549,TXFE7,128,9959,8,84132,41471,42981
13400717,13400716,TXFE7,128,9959,3,84135,41474,42982
13400754,13400743,TXFE7,128,9959,1,84136,41475,42983
13401129,13401128,TXFE7,128,9960,1,84137,41476,42984
13401142,13401135,TXFE7,128,9960,1,84138,41477,42985
13401292,13401291,TXFE7,128,9959,4,84142,41478,42986
13401667,13401666,TXFE7,128,9960,1,84143,41479,42987
13401767,13401754,TXFE7,128,9960,10,84153,41480,42991
13401854,13401853,TXFE7,128,9959,8,84161,41484,42992
13401867,13401855,TXFE7,128,9959,5,84166,41486,42993
13401867,13401865,TXFE7,128,9959,1,84167,41487,42994
13401904,13401903,TXFE7,128,9959,3,84170,41488,42995
13401942,13401938,TXFE7,128,9959,1,84171,41489,42996
13402004,13401992,TXFE7,128,9959,1,84172,41490,42997
13402029,13402029,TXFE7,128,9960,1,84173,41491,42998
13402054,13402044,TXFE7,128,9960,1,84174,41492,42999
13402104,13402094,TXFE7,128,9959,1,84175,41493,43000
13402104,13402103,TXFE7,128,9959,1,84176,41494,43001
13402292,13402289,TXFE7,128,9959,5,84181,41495,43002
13402767,13402759,TXFE7,128,9960,5,84186,41496,43005
13402779,13402777,TXFE7,128,9960,2,84188,41497,43007
13402792,13402789,TXFE7,128,9960,2,84190,41498,43008
13402804,13402795,TXFE7,128,9960,1,84191,41499,43009
13403067,13403061,TXFE7,128,9960,1,84192,41500,43010
13403079,13403067,TXFE7,128,9960,1,84193,41501,43011
13403154,13403150,TXFE7,128,9959,2,84195,41503,43012
13403179,13403170,TXFE7,128,9960,1,84196,41504,43013
13403204,13403195,TXFE7,128,9960,1,84197,41505,43014
13403217,13403213,TXFE7,128,9960,1,84198,41506,43015
13403242,13403240,TXFE7,128,9960,1,84199,41507,43016
13403254,13403245,TXFE7,128,9960,2,84201,41508,43018
13403267,13403263,TXFE7,128,9960,1,84202,41509,43019
13403267,13403266,TXFE7,128,9959,1,84203,41510,43020
13403279,13403268,TXFE7,128,9960,1,84204,41511,43021
13403404,13403392,TXFE7,128,9959,1,84205,41512,43022
13403867,13403857,TXFE7,128,9960,1,84206,41513,43023
13404004,13403997,TXFE7,128,9959,1,84207,41514,43024
13404104,13404102,TXFE7,128,9959,1,84208,41515,43025
13404229,13404229,TXFE7,128,9960,3,84211,41516,43027
13404404,13404399,TXFE7,128,9960,1,84212,41517,43028
13404417,13404408,TXFE7,128,9960,1,84213,41518,43029
13404592,13404582,TXFE7,128,9959,1,84214,41519,43030
13404642,13404630,TXFE7,128,9960,15,84229,41520,43035
13404754,13404743,TXFE7,128,9960,3,84232,41521,43037
13404754,13404743,TXFE7,128,9960,1,84233,41522,43038
13404792,13404780,TXFE7,128,9960,1,84234,41523,43039
13404804,13404797,TXFE7,128,9960,1,84235,41524,43040
13404804,13404801,TXFE7,128,9960,1,84236,41525,43041
13404829,13404827,TXFE7,128,9960,1,84237,41526,43042
13404867,13404855,TXFE7,128,9960,1,84238,41527,43043
13404879,13404879,TXFE7,128,9960,1,84239,41528,43044
13404967,13404957,TXFE7,128,9960,6,84245,41529,43048
13404979,13404967,TXFE7,128,9960,2,84247,41530,43049
13404992,13404991,TXFE7,128,9960,1,84248,41531,43050
13405017,13405008,TXFE7,128,9960,1,84249,41532,43051
13405029,13405019,TXFE7,128,9959,1,84250,41533,43052
13405029,13405025,TXFE7,128,9960,5,84255,41534,43053
13405042,13405029,TXFE7,128,9960,4,84259,41535,43054
13405067,13405066,TXFE7,128,9960,5,84264,41536,43055
13405079,13405075,TXFE7,128,9960,1,84265,41537,43056
13405092,13405084,TXFE7,128,9960,10,84275,41538,43061
13405117,13405111,TXFE7,128,9960,10,84285,41539,43062
13405117,13405113,TXFE7,128,9960,5,84290,41540,43067
13405117,13405113,TXFE7,128,9960,5,84295,41541,43072
13405129,13405118,TXFE7,128,9960,5,84300,41542,43076
13405129,13405129,TXFE7,128,9960,5,84305,41543,43078
13405142,13405129,TXFE7,128,9960,6,84311,41544,43081
13405142,13405134,TXFE7,128,9960,5,84316,41545,43086
13405142,13405136,TXFE7,128,9960,1,84317,41546,43087
13405142,13405136,TXFE7,128,9960,5,84322,41547,43091
13405154,13405145,TXFE7,128,9960,3,84325,41548,43094
13405167,13405162,TXFE7,128,9960,5,84330,41549,43097
13405167,13405164,TXFE7,128,9960,5,84335,41550,43100
13405179,13405167,TXFE7,128,9960,1,84336,41551,43101
13405179,13405168,TXFE7,128,9960,2,84338,41552,43102
13405179,13405169,TXFE7,128,9960,1,84339,41553,43103
13405179,13405171,TXFE7,128,9960,7,84346,41554,43104
13405179,13405172,TXFE7,128,9960,1,84347,41555,43105
13405179,13405174,TXFE7,128,9960,5,84352,41556,43110
13405192,13405183,TXFE7,128,9960,1,84353,41557,43111
13405192,13405186,TXFE7,128,9960,2,84355,41558,43113
13405192,13405189,TXFE7,128,9960,10,84365,41559,43114
13405204,13405192,TXFE7,128,9960,8,84373,41560,43115
13405204,13405202,TXFE7,128,9960,10,84383,41561,43116
13405217,13405204,TXFE7,128,9960,6,84389,41562,43121
13405217,13405204,TXFE7,128,9960,3,84392,41563,43124
13405279,13405272,TXFE7,128,9960,4,84396,41564,43125
13405304,13405299,TXFE7,128,9961,1,84397,41565,43126
13405317,13405308,TXFE7,128,9961,1,84398,41566,43127
13405454,13405449,TXFE7,128,9961,1,84399,41567,43128
13405504,13405500,TXFE7,128,9961,1,84400,41568,43129
13405542,13405536,TXFE7,128,9961,3,84403,41569,43132
13405979,13405972,TXFE7,128,9961,1,84404,41570,43133
13410004,13405994,TXFE7,128,9961,2,84406,41571,43135
13410042,13410034,TXFE7,128,9961,2,84408,41572,43136
13410067,13410065,TXFE7,128,9961,1,84409,41573,43137
13410079,13410071,TXFE7,128,9961,1,84410,41574,43138
13410092,13410088,TXFE7,128,9961,1,84411,41575,43139
13410192,13410180,TXFE7,128,9961,1,84412,41576,43140
13410292,13410287,TXFE7,128,9960,1,84413,41577,43141
13410304,13410300,TXFE7,128,9961,3,84416,41578,43144
13410404,13410396,TXFE7,128,9960,1,84417,41579,43145
13410417,13410409,TXFE7,128,9960,1,84418,41580,43146
13410442,13410434,TXFE7,128,9961,1,84419,41581,43147
13410479,13410475,TXFE7,128,9960,3,84422,41582,43148
13410604,13410593,TXFE7,128,9960,1,84423,41583,43149
13410629,13410625,TXFE7,128,9961,3,84426,41584,43152
13410754,13410747,TXFE7,128,9960,1,84427,41585,43153
13410779,13410767,TXFE7,128,9960,3,84430,41586,43154
13410842,13410833,TXFE7,128,9961,1,84431,41587,43155
13410892,13410888,TXFE7,128,9960,1,84432,41588,43156
13410904,13410902,TXFE7,128,9961,1,84433,41589,43157
13411067,13411063,TXFE7,128,9961,1,84434,41590,43158
13411079,13411069,TXFE7,128,9961,1,84435,41591,43159
13411217,13411205,TXFE7,128,9960,1,84436,41592,43160
13411242,13411241,TXFE7,128,9960,5,84441,41593,43161
13411304,13411292,TXFE7,128,9960,5,84446,41594,43162
13411367,13411362,TXFE7,128,9961,1,84447,41595,43163
13411379,13411375,TXFE7,128,9961,1,84448,41596,43164
13411479,13411476,TXFE7,128,9961,1,84449,41597,43165
13411492,13411488,TXFE7,128,9960,4,84453,41598,43166
13411492,13411491,TXFE7,128,9960,2,84455,41599,43167
13411492,13411491,TXFE7,128,9960,1,84456,41600,43168
13411554,13411549,TXFE7,128,9960,8,84464,41602,43169
13411567,13411559,TXFE7,128,9960,1,84465,41603,43170
13411579,13411572,TXFE7,128,9961,1,84466,41604,43171
13411592,13411584,TXFE7,128,9960,1,84467,41605,43172
13412092,13412080,TXFE7,128,9961,1,84468,41606,43173
13412117,13412109,TXFE7,128,9961,1,84469,41607,43174
13412129,13412118,TXFE7,128,9961,1,84470,41608,43175
13412142,13412129,TXFE7,128,9961,1,84471,41609,43176
13412279,13412275,TXFE7,128,9960,2,84473,41611,43177
13412329,13412326,TXFE7,128,9961,1,84474,41612,43178
13412429,13412417,TXFE7,128,9960,3,84477,41613,43179
13412442,13412435,TXFE7,128,9960,1,84478,41614,43180
13412492,13412486,TXFE7,128,9960,2,84480,41615,43181
13412517,13412516,TXFE7,128,9961,10,84490,41616,43191
13412642,13412635,TXFE7,128,9961,2,84492,41617,43192
13412767,13412762,TXFE7,128,9960,2,84494,41618,43193
13412979,13412968,TXFE7,128,9960,1,84495,41619,43194
13413029,13413021,TXFE7,128,9961,1,84496,41620,43195
13413029,13413028,TXFE7,128,9961,1,84497,41621,43196
13413092,13413085,TXFE7,128,9960,2,84499,41622,43197
13413229,13413229,TXFE7,128,9960,1,84500,41623,43198
13413329,13413324,TXFE7,128,9960,1,84501,41624,43199
13413379,13413375,TXFE7,128,9960,1,84502,41625,43200
13413504,13413502,TXFE7,128,9961,1,84503,41626,43201
13413554,13413549,TXFE7,128,9961,1,84504,41627,43202
13413642,13413633,TXFE7,128,9961,1,84505,41628,43203
13413679,13413678,TXFE7,128,9961,1,84506,41629,43204
13413692,13413681,TXFE7,128,9961,1,84507,41630,43205
13413717,13413706,TXFE7,128,9961,1,84508,41631,43206
13413854,13413847,TXFE7,128,9961,1,84509,41632,43207
13413879,13413878,TXFE7,128,9961,5,84514,41633,43208
13413904,13413897,TXFE7,128,9961,1,84515,41634,43209
13413917,13413914,TXFE7,128,9961,2,84517,41635,43210
13413992,13413987,TXFE7,128,9960,2,84519,41636,43211
13414029,13414021,TXFE7,128,9961,1,84520,41637,43212
13414029,13414029,TXFE7,128,9961,1,84521,41638,43213
13414229,13414227,TXFE7,128,9961,2,84523,41639,43214
13414254,13414243,TXFE7,128,9961,1,84524,41640,43215
13414254,13414244,TXFE7,128,9961,1,84525,41641,43216
13414292,13414291,TXFE7,128,9961,2,84527,41642,43217
13414304,13414293,TXFE7,128,9961,1,84528,41643,43218
13414329,13414323,TXFE7,128,9961,2,84530,41644,43219
13414367,13414357,TXFE7,128,9961,1,84531,41645,43220
13414454,13414452,TXFE7,128,9961,1,84532,41646,43221
13414467,13414455,TXFE7,128,9961,5,84537,41647,43224
13414592,13414581,TXFE7,128,9961,1,84538,41648,43225
13414667,13414659,TXFE7,128,9960,3,84541,41649,43226
13414692,13414686,TXFE7,128,9961,2,84543,41650,43227
13414867,13414864,TXFE7,128,9961,1,84544,41651,43228
13414929,13414919,TXFE7,128,9960,2,84546,41652,43229
13415042,13415034,TXFE7,128,9961,1,84547,41653,43230
13415042,13415041,TXFE7,128,9961,1,84548,41654,43231
13415154,13415143,TXFE7,128,9961,1,84549,41655,43232
13415204,13415196,TXFE7,128,9961,1,84550,41656,43233
13415304,13415302,TXFE7,128,9960,3,84553,41657,43234
13415317,13415311,TXFE7,128,9960,4,84557,41658,43235
13415542,13415535,TXFE7,128,9960,3,84560,41659,43236
13415579,13415570,TXFE7,128,9961,1,84561,41660,43237
13415642,13415639,TXFE7,128,9961,1,84562,41661,43238
13415667,13415658,TXFE7,128,9961,2,84564,41662,43240
13415667,13415658,TXFE7,128,9961,5,84569,41663,43245
13415679,13415674,TXFE7,128,9961,1,84570,41664,43246
13415729,13415724,TXFE7,128,9961,1,84571,41665,43247
13415854,13415851,TXFE7,128,9960,7,84578,41666,43248
13415904,13415896,TXFE7,128,9960,2,84580,41667,43249
13415942,13415932,TXFE7,128,9961,1,84581,41668,43250
13415979,13415969,TXFE7,128,9961,5,84586,41669,43254
13415979,13415973,TXFE7,128,9961,1,84587,41670,43255
13415979,13415975,TXFE7,128,9961,3,84590,41671,43257
13420017,13420007,TXFE7,128,9961,1,84591,41672,43258
13420017,13420008,TXFE7,128,9960,2,84593,41673,43259
13420017,13420012,TXFE7,128,9960,4,84597,41674,43260
13420054,13420053,TXFE7,128,9961,2,84599,41675,43261
13420067,13420057,TXFE7,128,9961,1,84600,41676,43262
13420079,13420074,TXFE7,128,9961,1,84601,41677,43263
13420079,13420077,TXFE7,128,9961,1,84602,41678,43264
13420079,13420077,TXFE7,128,9960,2,84604,41679,43265
13420092,13420081,TXFE7,128,9960,2,84606,41680,43266
13420092,13420081,TXFE7,128,9960,2,84608,41681,43267
13420117,13420108,TXFE7,128,9960,8,84616,41685,43268
13420117,13420109,TXFE7,128,9961,1,84617,41686,43269
13420142,13420133,TXFE7,128,9960,1,84618,41687,43270
13420142,13420135,TXFE7,128,9960,1,84619,41688,43271
13420142,13420136,TXFE7,128,9960,1,84620,41689,43272
13420154,13420148,TXFE7,128,9960,1,84621,41690,43273
13420154,13420153,TXFE7,128,9960,1,84622,41691,43274
13420179,13420168,TXFE7,128,9960,2,84624,41693,43275
13420179,13420168,TXFE7,128,9960,2,84626,41694,43276
13420192,13420186,TXFE7,128,9960,1,84627,41695,43277
13420204,13420204,TXFE7,128,9960,1,84628,41696,43278
13420292,13420285,TXFE7,128,9961,13,84641,41697,43288
13420429,13420426,TXFE7,128,9961,1,84642,41698,43289
13420554,13420542,TXFE7,128,9961,2,84644,41699,43291
13420679,13420667,TXFE7,128,9961,1,84645,41700,43292
13420804,13420798,TXFE7,128,9961,1,84646,41701,43293
13420917,13420914,TXFE7,128,9961,7,84653,41702,43296
13420929,13420929,TXFE7,128,9961,4,84657,41703,43299
13420942,13420934,TXFE7,128,9961,1,84658,41704,43300
13420942,13420934,TXFE7,128,9961,1,84659,41705,43301
13420954,13420953,TXFE7,128,9961,1,84660,41706,43302
13420967,13420959,TXFE7,128,9961,1,84661,41707,43303
13420967,13420961,TXFE7,128,9961,1,84662,41708,43304
13420967,13420961,TXFE7,128,9961,1,84663,41709,43305
13421004,13421004,TXFE7,128,9960,4,84667,41711,43306
13421067,13421063,TXFE7,128,9961,1,84668,41712,43307
13421067,13421065,TXFE7,128,9960,2,84670,41713,43308
13421079,13421074,TXFE7,128,9960,1,84671,41714,43309
13421079,13421076,TXFE7,128,9961,1,84672,41715,43310
13421092,13421081,TXFE7,128,9961,1,84673,41716,43311
13421104,13421095,TXFE7,128,9960,1,84674,41717,43312
13421104,13421099,TXFE7,128,9960,1,84675,41718,43313
13421154,13421152,TXFE7,128,9961,5,84680,41719,43316
13421179,13421167,TXFE7,128,9961,2,84682,41720,43317
13421229,13421220,TXFE7,128,9961,2,84684,41721,43319
13421329,13421328,TXFE7,128,9961,1,84685,41722,43320
13421379,13421376,TXFE7,128,9961,3,84688,41723,43321
13421667,13421657,TXFE7,128,9961,4,84692,41724,43324
13421667,13421659,TXFE7,128,9961,3,84695,41725,43327
13421704,13421701,TXFE7,128,9961,2,84697,41726,43328
13421779,13421768,TXFE7,128,9961,3,84700,41727,43331
13421792,13421780,TXFE7,128,9961,1,84701,41728,43332
13421829,13421818,TXFE7,128,9961,1,84702,41729,43333
13421829,13421821,TXFE7,128,9961,1,84703,41730,43334
13421829,13421822,TXFE7,128,9961,1,84704,41731,43335
13421867,13421864,TXFE7,128,9961,1,84705,41732,43336
13421904,13421896,TXFE7,128,9961,1,84706,41733,43337
13421942,13421939,TXFE7,128,9960,6,84712,41738,43338
13421954,13421945,TXFE7,128,9961,1,84713,41739,43339
13421954,13421946,TXFE7,128,9961,1,84714,41740,43340
13421967,13421963,TXFE7,128,9961,5,84719,41741,43343
13422004,13422001,TXFE7,128,9961,1,84720,41742,43344
13422017,13422008,TXFE7,128,9961,2,84722,41743,43345
13422029,13422019,TXFE7,128,9961,1,84723,41744,43346
13422042,13422033,TXFE7,128,9961,1,84724,41745,43347
13422079,13422068,TXFE7,128,9961,20,84744,41746,43349
13422092,13422084,TXFE7,128,9961,1,84745,41747,43350
13422117,13422109,TXFE7,128,9961,1,84746,41748,43351
13422117,13422112,TXFE7,128,9961,1,84747,41749,43352
13422129,13422128,TXFE7,128,9961,1,84748,41750,43353
13422167,13422158,TXFE7,128,9961,5,84753,41751,43355
13422167,13422158,TXFE7,128,9961,1,84754,41752,43356
13422167,13422164,TXFE7,128,9961,11,84765,41753,43359
13422179,13422167,TXFE7,128,9961,2,84767,41754,43360
13422192,13422191,TXFE7,128,9961,1,84768,41755,43361
13422229,13422221,TXFE7,128,9961,5,84773,41756,43366
13422242,13422235,TXFE7,128,9960,2,84775,41757,43367
13422242,13422241,TXFE7,128,9961,2,84777,41758,43369
13422254,13422242,TXFE7,128,9961,1,84778,41759,43370
13422254,13422251,TXFE7,128,9961,2,84780,41760,43371
13422254,13422253,TXFE7,128,9961,1,84781,41761,43372
13422267,13422257,TXFE7,128,9961,1,84782,41762,43373
13422267,13422261,TXFE7,128,9960,3,84785,41763,43374
13422279,13422269,TXFE7,128,9961,6,84791,41764,43375
13422279,13422276,TXFE7,128,9961,2,84793,41765,43377
13422292,13422287,TXFE7,128,9961,1,84794,41766,43378
13422292,13422289,TXFE7,128,9961,2,84796,41767,43380
13422304,13422296,TXFE7,128,9961,1,84797,41768,43381
13422342,13422340,TXFE7,128,9961,1,84798,41769,43382
13422354,13422344,TXFE7,128,9961,1,84799,41770,43383
13422367,13422358,TXFE7,128,9961,12,84811,41771,43391
13422392,13422391,TXFE7,128,9961,1,84812,41772,43392
13422404,13422396,TXFE7,128,9961,1,84813,41773,43393
13422404,13422402,TXFE7,128,9960,1,84814,41774,43394
13422404,13422404,TXFE7,128,9961,2,84816,41775,43396
13422417,13422405,TXFE7,128,9961,5,84821,41776,43398
13422429,13422419,TXFE7,128,9961,1,84822,41777,43399
13422442,13422431,TXFE7,128,9961,1,84823,41778,43400
13422442,13422433,TXFE7,128,9961,1,84824,41779,43401
13422442,13422435,TXFE7,128,9961,2,84826,41780,43403
13422442,13422440,TXFE7,128,9961,1,84827,41781,43404
13422454,13422454,TXFE7,128,9960,2,84829,41782,43405
13422467,13422463,TXFE7,128,9961,5,84834,41783,43408
13422479,13422473,TXFE7,128,9961,1,84835,41784,43409
13422492,13422481,TXFE7,128,9961,1,84836,41785,43410
13422492,13422482,TXFE7,128,9961,2,84838,41786,43411
13422492,13422483,TXFE7,128,9961,1,84839,41787,43412
13422492,13422489,TXFE7,128,9961,5,84844,41788,43414
13422529,13422517,TXFE7,128,9961,1,84845,41789,43415
13422554,13422550,TXFE7,128,9961,2,84847,41790,43417
13422604,13422599,TXFE7,128,9961,2,84849,41791,43418
13422604,13422604,TXFE7,128,9961,5,84854,41792,43421
13422642,13422632,TXFE7,128,9961,1,84855,41793,43422
13422667,13422656,TXFE7,128,9961,1,84856,41794,43423
13422667,13422663,TXFE7,128,9961,1,84857,41795,43424
13422679,13422670,TXFE7,128,9961,2,84859,41796,43426
13422679,13422676,TXFE7,128,9961,7,84866,41797,43432
13422692,13422679,TXFE7,128,9961,1,84867,41798,43433
13422729,13422725,TXFE7,128,9961,2,84869,41799,43435
13422754,13422743,TXFE7,128,9961,1,84870,41800,43436
13422779,13422776,TXFE7,128,9961,5,84875,41801,43437
13422779,13422776,TXFE7,128,9961,1,84876,41802,43438
13422854,13422842,TXFE7,128,9961,1,84877,41803,43439
13422854,13422852,TXFE7,128,9961,1,84878,41804,43440
13422917,13422909,TXFE7,128,9960,1,84879,41805,43441
13422917,13422915,TXFE7,128,9961,1,84880,41806,43442
13422942,13422936,TXFE7,128,9961,3,84883,41807,43443
13423029,13423019,TXFE7,128,9961,5,84888,41808,43446
13423079,13423072,TXFE7,128,9961,7,84895,41809,43448
13423092,13423083,TXFE7,128,9962,1,84896,41810,43449
13423129,13423118,TXFE7,128,9962,1,84897,41811,43450
13423129,13423123,TXFE7,128,9962,1,84898,41812,43451
13423129,13423127,TXFE7,128,9962,1,84899,41813,43452
13423267,13423259,TXFE7,128,9961,1,84900,41814,43453
13423279,13423269,TXFE7,128,9962,12,84912,41815,43462
13423279,13423276,TXFE7,128,9961,1,84913,41816,43463
13423292,13423290,TXFE7,128,9961,1,84914,41817,43464
13423329,13423329,TXFE7,128,9961,1,84915,41818,43465
13423429,13423417,TXFE7,128,9961,2,84917,41819,43466
13423442,13423433,TXFE7,128,9962,1,84918,41820,43467
13423454,13423446,TXFE7,128,9961,1,84919,41821,43468
13423479,13423473,TXFE7,128,9961,1,84920,41822,43469
13423717,13423716,TXFE7,128,9961,2,84922,41823,43470
13423729,13423726,TXFE7,128,9961,1,84923,41824,43471
13423854,13423849,TXFE7,128,9962,1,84924,41825,43472
13423917,13423916,TXFE7,128,9961,10,84934,41828,43473
13423992,13423981,TXFE7,128,9961,2,84936,41830,43474
13424004,13423996,TXFE7,128,9962,1,84937,41831,43475
13424042,13424032,TXFE7,128,9961,4,84941,41833,43476
13424067,13424066,TXFE7,128,9962,1,84942,41834,43477
13424079,13424077,TXFE7,128,9962,1,84943,41835,43478
13424092,13424080,TXFE7,128,9962,1,84944,41836,43479
13424267,13424260,TXFE7,128,9962,2,84946,41837,43480
13424379,13424374,TXFE7,128,9961,1,84947,41838,43481
13424392,13424379,TXFE7,128,9961,9,84956,41841,43482
13424392,13424379,TXFE7,128,9961,16,84972,41850,43483
13424392,13424379,TXFE7,128,9961,4,84976,41854,43484
13424454,13424442,TXFE7,128,9962,1,84977,41855,43485
13424492,13424481,TXFE7,128,9961,10,84987,41857,43486
13424504,13424498,TXFE7,128,9961,1,84988,41858,43487
13424579,13424576,TXFE7,128,9961,3,84991,41859,43488
13424679,13424675,TXFE7,128,9962,1,84992,41860,43489
13424729,13424724,TXFE7,128,9962,2,84994,41861,43490
13424767,13424755,TXFE7,128,9961,2,84996,41862,43491
13424842,13424842,TXFE7,128,9961,4,85000,41863,43492
13424854,13424852,TXFE7,128,9962,3,85003,41864,43494
13425004,13425000,TXFE7,128,9961,1,85004,41865,43495
13425079,13425072,TXFE7,128,9962,1,85005,41866,43496
13425079,13425077,TXFE7,128,9962,1,85006,41867,43497
13425104,13425102,TXFE7,128,9962,2,85008,41868,43498
13425154,13425153,TXFE7,128,9961,20,85028,41872,43499
13425242,13425235,TXFE7,128,9961,1,85029,41873,43500
13425279,13425271,TXFE7,128,9961,1,85030,41874,43501
13425292,13425285,TXFE7,128,9962,1,85031,41875,43502
13425379,13425371,TXFE7,128,9961,1,85032,41876,43503
13425404,13425401,TXFE7,128,9961,1,85033,41877,43504
13425479,13425474,TXFE7,128,9961,1,85034,41878,43505
13425504,13425504,TXFE7,128,9961,11,85045,41885,43506
13425529,13425529,TXFE7,128,9962,1,85046,41886,43507
13425567,13425562,TXFE7,128,9961,25,85071,41901,43508
13425567,13425566,TXFE7,128,9961,1,85072,41902,43509
13425579,13425567,TXFE7,128,9961,2,85074,41903,43510
13425604,13425595,TXFE7,128,9961,1,85075,41904,43511
13425604,13425604,TXFE7,128,9961,5,85080,41909,43512
13425629,13425617,TXFE7,128,9961,11,85091,41910,43515
13425629,13425626,TXFE7,128,9960,1,85092,41911,43516
13425629,13425626,TXFE7,128,9960,1,85093,41912,43517
13425642,13425636,TXFE7,128,9961,1,85094,41913,43518
13425642,13425641,TXFE7,128,9961,2,85096,41914,43519
13425654,13425642,TXFE7,128,9961,1,85097,41915,43520
13425654,13425647,TXFE7,128,9960,7,85104,41916,43521
13425654,13425648,TXFE7,128,9961,5,85109,41917,43523
13425654,13425650,TXFE7,128,9961,1,85110,41918,43524
13425667,13425654,TXFE7,128,9961,1,85111,41919,43525
13425717,13425713,TXFE7,128,9961,1,85112,41920,43526
13425742,13425730,TXFE7,128,9961,1,85113,41921,43527
13425742,13425739,TXFE7,128,9960,6,85119,41924,43528
13425979,13425971,TXFE7,128,9961,1,85120,41925,43529
13425992,13425989,TXFE7,128,9960,4,85124,41926,43530
13430029,13430020,TXFE7,128,9961,1,85125,41927,43531
13430029,13430027,TXFE7,128,9961,1,85126,41928,43532
13430042,13430036,TXFE7,128,9961,1,85127,41929,43533
13430067,13430058,TXFE7,128,9961,1,85128,41930,43534
13430079,13430068,TXFE7,128,9961,1,85129,41931,43535
13430117,13430110,TXFE7,128,9961,2,85131,41932,43536
13430167,13430159,TXFE7,128,9960,1,85132,41933,43537
13430192,13430183,TXFE7,128,9960,10,85142,41937,43538
13430254,13430248,TXFE7,128,9960,3,85145,41939,43539
13430317,13430306,TXFE7,128,9960,4,85149,41942,43540
13430392,13430383,TXFE7,128,9960,10,85159,41951,43541
13430467,13430462,TXFE7,128,9961,1,85160,41952,43542
13430467,13430466,TXFE7,128,9960,2,85162,41954,43543
13430517,13430505,TXFE7,128,9960,1,85163,41955,43544
13430542,13430538,TXFE7,128,9961,1,85164,41956,43545
13430592,13430584,TXFE7,128,9960,10,85174,41963,43546
13430629,13430621,TXFE7,128,9960,1,85175,41964,43547
13430629,13430627,TXFE7,128,9960,1,85176,41965,43548
13430629,13430627,TXFE7,128,9961,1,85177,41966,43549
13430629,13430628,TXFE7,128,9960,1,85178,41967,43550
13430667,13430664,TXFE7,128,9961,1,85179,41968,43551
13430667,13430667,TXFE7,128,9961,1,85180,41969,43552
13430679,13430679,TXFE7,128,9961,50,85230,41970,43571
13430692,13430679,TXFE7,128,9961,11,85241,41971,43576
13430742,13430733,TXFE7,128,9961,1,85242,41972,43577
13430767,13430757,TXFE7,128,9961,1,85243,41973,43578
13430767,13430765,TXFE7,128,9960,3,85246,41974,43579
13430779,13430773,TXFE7,128,9960,1,85247,41975,43580
13430779,13430774,TXFE7,128,9960,1,85248,41976,43581
13430792,13430784,TXFE7,128,9960,10,85258,41981,43582
13430917,13430917,TXFE7,128,9960,1,85259,41982,43583
13430967,13430966,TXFE7,128,9961,2,85261,41983,43585
13430979,13430978,TXFE7,128,9961,1,85262,41984,43586
13430992,13430985,TXFE7,128,9960,10,85272,41989,43587
13431042,13431035,TXFE7,128,9961,1,85273,41990,43588
13431042,13431038,TXFE7,128,9961,1,85274,41991,43589
13431204,13431195,TXFE7,128,9960,1,85275,41992,43590
13431204,13431203,TXFE7,128,9961,1,85276,41993,43591
13431254,13431248,TXFE7,128,9960,1,85277,41994,43592
13431442,13431430,TXFE7,128,9960,2,85282,41999,43595
13431917,13431912,TXFE7,128,9961,1,85295,42006,43607
13432192,13432190,TXFE7,128,9960,1,85303,42011,43613
13432204,13432200,TXFE7,128,9961,1,85304,42012,43614
13432254,13432244,TXFE7,128,9960,2,85306,42013,43615
13432429,13432428,TXFE7,128,9961,1,85315,42020,43619
13432479,13432476,TXFE7,128,9961,4,85319,42021,43620
13432517,13432513,TXFE7,128,9961,1,85320,42022,43621
13432554,13432550,TXFE7,128,9961,1,85321,42023,43622
13432642,13432640,TXFE7,128,9961,1,85322,42024,43623
13432692,13432680,TXFE7,128,9960,1,85323,42025,43624
13432779,13432769,TXFE7,128,9960,6,85329,42029,43625
13432792,13432790,TXFE7,128,9960,1,85330,42030,43626
13432904,13432901,TXFE7,128,9960,1,85331,42031,43627
13432967,13432962,TXFE7,128,9960,1,85332,42032,43628
13433042,13433031,TXFE7,128,9961,1,85333,42033,43629
13433042,13433039,TXFE7,128,9961,3,85336,42034,43631
13433067,13433067,TXFE7,128,9961,10,85346,42035,43637
13433079,13433079,TXFE7,128,9961,1,85347,42036,43638
13433092,13433086,TXFE7,128,9961,1,85348,42037,43639
13433117,13433107,TXFE7,128,9960,1,85349,42038,43640
13433129,13433120,TXFE7,128,9960,1,85350,42039,43641
13433129,13433124,TXFE7,128,9960,1,85351,42040,43642
13433204,13433200,TXFE7,128,9961,1,85352,42041,43643
13433229,13433223,TXFE7,128,9961,1,85353,42042,43644
13433242,13433231,TXFE7,128,9961,5,85358,42043,43645
13433242,13433233,TXFE7,128,9961,2,85360,42044,43646
13433329,13433328,TXFE7,128,9960,1,85361,42045,43647
13433367,13433362,TXFE7,128,9960,1,85362,42046,43648
13433454,13433454,TXFE7,128,9960,2,85364,42048,43649
13433492,13433490,TXFE7,128,9960,1,85365,42049,43650
13433504,13433502,TXFE7,128,9961,3,85368,42050,43652
13433517,13433513,TXFE7,128,9960,7,85375,42055,43653
13433842,13433836,TXFE7,128,9960,1,85389,42064,43660
13433917,13433906,TXFE7,128,9960,2,85391,42066,43661
13433917,13433916,TXFE7,128,9961,1,85392,42067,43662
13433954,13433954,TXFE7,128,9961,4,85396,42068,43663
13433967,13433964,TXFE7,128,9960,1,85397,42069,43664
13433967,13433966,TXFE7,128,9960,1,85398,42070,43665
13434004,13433996,TXFE7,128,9960,2,85400,42071,43666
13434004,13434000,TXFE7,128,9960,1,85401,42072,43667
13434017,13434014,TXFE7,128,9961,1,85402,42073,43668
13434104,13434099,TXFE7,128,9961,1,85403,42074,43669
13434117,13434106,TXFE7,128,9961,1,85404,42075,43670
13434179,13434176,TXFE7,128,9961,63,85467,42076,43680
13434217,13434209,TXFE7,128,9961,3,85470,42077,43681
13434242,13434234,TXFE7,128,9961,1,85471,42078,43682
13434267,13434258,TXFE7,128,9960,3,85474,42080,43683
13434279,13434279,TXFE7,128,9961,63,85537,42081,43705
13434292,13434281,TXFE7,128,9960,2,85539,42083,43706
13434392,13434390,TXFE7,128,9961,1,85540,42084,43707
13434417,13434408,TXFE7,128,9960,1,85541,42085,43708
13434429,13434417,TXFE7,128,9960,7,85548,42088,43709
13434517,13434511,TXFE7,128,9961,1,85549,42089,43710
13434554,13434544,TXFE7,128,9961,1,85550,42090,43711
13434567,13434555,TXFE7,128,9961,1,85551,42091,43712
13434567,13434564,TXFE7,128,9961,1,85552,42092,43713
13434604,13434593,TXFE7,128,9960,1,85553,42093,43714
13434667,13434661,TXFE7,128,9961,1,85554,42094,43715
13434704,13434692,TXFE7,128,9961,2,85556,42095,43717
13434742,13434740,TXFE7,128,9961,12,85568,42096,43727
13434804,13434798,TXFE7,128,9961,5,85573,42097,43729
13434854,13434847,TXFE7,128,9961,1,85574,42098,43730
13434879,13434871,TXFE7,128,9961,1,85575,42099,43731
13434892,13434882,TXFE7,128,9961,1,85576,42100,43732
13435042,13435037,TXFE7,128,9961,2,85578,42101,43734
13435067,13435062,TXFE7,128,9960,1,85579,42102,43735
13435067,13435066,TXFE7,128,9961,3,85582,42103,43736
13435079,13435072,TXFE7,128,9961,1,85583,42104,43737
13435079,13435075,TXFE7,128,9961,2,85585,42105,43738
13435092,13435091,TXFE7,128,9961,1,85586,42106,43739
13435104,13435098,TXFE7,128,9961,1,85587,42107,43740
13435129,13435126,TXFE7,128,9961,1,85588,42108,43741
13435179,13435167,TXFE7,128,9961,2,85590,42109,43743
13435192,13435181,TXFE7,128,9961,5,85595,42110,43748
13435217,13435205,TXFE7,128,9960,1,85596,42111,43749
13435254,13435243,TXFE7,128,9961,1,85597,42112,43750
13435267,13435265,TXFE7,128,9960,2,85599,42113,43751
13435292,13435284,TXFE7,128,9961,5,85604,42114,43753
13435292,13435288,TXFE7,128,9961,1,85605,42115,43754
13435304,13435296,TXFE7,128,9960,1,85606,42116,43755
13435429,13435426,TXFE7,128,9960,1,85607,42117,43756
13435454,13435448,TXFE7,128,9961,1,85608,42118,43757
13435454,13435448,TXFE7,128,9961,1,85609,42119,43758
13435467,13435461,TXFE7,128,9961,1,85610,42120,43759
13435479,13435470,TXFE7,128,9961,1,85611,42121,43760
13435479,13435477,TXFE7,128,9961,1,85612,42122,43761
13435579,13435567,TXFE7,128,9960,2,85614,42124,43762
13435604,13435600,TXFE7,128,9961,4,85618,42125,43764
13435642,13435637,TXFE7,128,9960,1,85619,42126,43765
13435692,13435690,TXFE7,128,9961,1,85620,42127,43766
13435704,13435702,TXFE7,128,9961,1,85621,42128,43767
13435754,13435746,TXFE7,128,9961,1,85622,42129,43768
13435954,13435950,TXFE7,128,9961,1,85623,42130,43769
13435967,13435957,TXFE7,128,9961,5,85628,42131,43771
13435967,13435966,TXFE7,128,9960,16,85644,42132,43772
13435992,13435987,TXFE7,128,9961,5,85649,42133,43774
13435992,13435988,TXFE7,128,9960,6,85655,42134,43775
13440004,13435996,TXFE7,128,9961,1,85656,42135,43776
13440004,13440000,TXFE7,128,9961,1,85657,42136,43777
13440017,13440006,TXFE7,128,9961,1,85658,42137,43778
13440104,13440103,TXFE7,128,9960,1,85659,42138,43779
13440104,13440103,TXFE7,128,9961,1,85660,42139,43780
13440117,13440106,TXFE7,128,9961,1,85661,42140,43781
13440129,13440124,TXFE7,128,9960,3,85664,42141,43782
13440129,13440126,TXFE7,128,9960,9,85673,42143,43783
13440154,13440143,TXFE7,128,9961,1,85674,42144,43784
13440154,13440147,TXFE7,128,9960,1,85675,42145,43785
13440167,13440163,TXFE7,128,9960,3,85678,42146,43786
13440192,13440191,TXFE7,128,9960,1,85679,42147,43787
13440217,13440212,TXFE7,128,9961,1,85680,42148,43788
13440217,13440214,TXFE7,128,9960,2,85682,42149,43789
13440229,13440221,TXFE7,128,9960,1,85683,42150,43790
13440242,13440237,TXFE7,128,9961,1,85684,42151,43791
13440254,13440249,TXFE7,128,9960,2,85686,42152,43792
13440267,13440262,TXFE7,128,9960,1,85687,42153,43793
13440267,13440264,TXFE7,128,9961,3,85690,42154,43794
13440279,13440272,TXFE7,128,9961,2,85692,42155,43795
13440392,13440391,TXFE7,128,9961,1,85693,42156,43796
13440504,13440496,TXFE7,128,9960,2,85695,42157,43797
13440504,13440503,TXFE7,128,9960,6,85701,42158,43798
13440517,13440506,TXFE7,128,9960,20,85721,42161,43799
13440517,13440511,TXFE7,128,9961,2,85723,42162,43800
13440529,13440529,TXFE7,128,9961,1,85724,42163,43801
13440617,13440609,TXFE7,128,9961,1,85725,42164,43802
13440617,13440615,TXFE7,128,9960,20,85745,42180,43803
13440629,13440620,TXFE7,128,9961,1,85746,42181,43804
13440667,13440658,TXFE7,128,9960,4,85750,42182,43805
13440679,13440677,TXFE7,128,9961,7,85757,42183,43811
13440692,13440680,TXFE7,128,9961,1,85758,42184,43812
13440717,13440708,TXFE7,128,9960,2,85760,42185,43813
13440717,13440712,TXFE7,128,9961,1,85761,42186,43814
13440754,13440746,TXFE7,128,9960,1,85762,42187,43815
13440754,13440754,TXFE7,128,9961,1,85763,42188,43816
13440792,13440791,TXFE7,128,9960,1,85764,42189,43817
13440829,13440818,TXFE7,128,9961,1,85765,42190,43818
13440829,13440823,TXFE7,128,9961,1,85766,42191,43819
13440829,13440825,TXFE7,128,9961,2,85768,42192,43820
13440842,13440833,TXFE7,128,9961,1,85769,42193,43821
13440842,13440834,TXFE7,128,9961,1,85770,42194,43822
13440917,13440911,TXFE7,128,9961,3,85773,42195,43824
13440954,13440944,TXFE7,128,9961,2,85775,42196,43826
13440967,13440962,TXFE7,128,9961,1,85776,42197,43827
13440979,13440973,TXFE7,128,9961,1,85777,42198,43828
13440992,13440988,TXFE7,128,9961,5,85782,42199,43829
13441029,13441018,TXFE7,128,9961,1,85783,42200,43830
13441029,13441022,TXFE7,128,9961,1,85784,42201,43831
13441054,13441047,TXFE7,128,9960,1,85785,42202,43832
13441104,13441103,TXFE7,128,9961,5,85790,42203,43836
13441129,13441123,TXFE7,128,9961,5,85795,42204,43838
13441142,13441141,TXFE7,128,9961,2,85797,42205,43839
13441154,13441151,TXFE7,128,9961,1,85798,42206,43840
13441167,13441159,TXFE7,128,9961,3,85801,42207,43842
13441192,13441189,TXFE7,128,9961,1,85802,42208,43843
13441204,13441202,TXFE7,128,9960,4,85806,42209,43844
13441254,13441249,TXFE7,128,9961,1,85807,42210,43845
13441267,13441257,TXFE7,128,9961,3,85810,42211,43847
13441267,13441265,TXFE7,128,9961,1,85811,42212,43848
13441317,13441312,TXFE7,128,9961,1,85812,42213,43849
13441317,13441315,TXFE7,128,9961,1,85813,42214,43850
13441404,13441393,TXFE7,128,9960,1,85814,42215,43851
13441404,13441399,TXFE7,128,9960,1,85815,42216,43852
13441467,13441462,TXFE7,128,9961,1,85816,42217,43853
13441467,13441463,TXFE7,128,9961,2,85818,42218,43855
13441479,13441470,TXFE7,128,9960,3,85821,42220,43856
13441504,13441496,TXFE7,128,9960,1,85822,42221,43857
13441504,13441500,TXFE7,128,9961,1,85823,42222,43858
13441517,13441512,TXFE7,128,9961,1,85824,42223,43859
13441542,13441535,TXFE7,128,9960,2,85826,42224,43860
13441567,13441558,TXFE7,128,9961,1,85827,42225,43861
13441579,13441572,TXFE7,128,9961,1,85828,42226,43862
13441604,13441600,TXFE7,128,9960,2,85830,42227,43863
13441642,13441639,TXFE7,128,9960,1,85831,42228,43864
13441654,13441647,TXFE7,128,9961,3,85834,42229,43867
13441679,13441673,TXFE7,128,9960,2,85836,42231,43868
13441692,13441685,TXFE7,128,9960,1,85837,42232,43869
13441692,13441692,TXFE7,128,9960,1,85838,42233,43870
13441729,13441720,TXFE7,128,9961,2,85840,42234,43872
13441742,13441737,TXFE7,128,9960,1,85841,42235,43873
13441767,13441764,TXFE7,128,9961,8,85849,42236,43876
13441829,13441825,TXFE7,128,9961,2,85851,42237,43877
13441854,13441844,TXFE7,128,9960,10,85861,42241,43878
13441854,13441853,TXFE7,128,9961,1,85862,42242,43879
13441867,13441864,TXFE7,128,9960,2,85864,42244,43880
13441929,13441929,TXFE7,128,9960,1,85865,42245,43881
13441954,13441946,TXFE7,128,9961,1,85866,42246,43882
13441954,13441947,TXFE7,128,9961,1,85867,42247,43883
13441954,13441948,TXFE7,128,9961,1,85868,42248,43884
13441954,13441948,TXFE7,128,9961,5,85873,42249,43885
13441954,13441948,TXFE7,128,9961,1,85874,42250,43886
13441954,13441949,TXFE7,128,9961,1,85875,42251,43887
13441954,13441950,TXFE7,128,9961,1,85876,42252,43888
13441954,13441951,TXFE7,128,9961,1,85877,42253,43889
13441954,13441951,TXFE7,128,9961,1,85878,42254,43890
13441954,13441952,TXFE7,128,9961,1,85879,42255,43891
13441967,13441957,TXFE7,128,9960,2,85881,42257,43892
13441992,13441992,TXFE7,128,9960,2,85883,42259,43893
13442004,13441998,TXFE7,128,9961,1,85884,42260,43894
13442029,13442024,TXFE7,128,9960,1,85885,42261,43895
13442042,13442040,TXFE7,128,9961,1,85886,42262,43896
13442042,13442041,TXFE7,128,9960,1,85887,42263,43897
13442054,13442048,TXFE7,128,9961,1,85888,42264,43898
13442054,13442050,TXFE7,128,9961,1,85889,42265,43899
13442079,13442067,TXFE7,128,9960,28,85917,42280,43900
13442092,13442084,TXFE7,128,9960,1,85918,42281,43901
13442092,13442087,TXFE7,128,9960,6,85924,42286,43902
13442092,13442090,TXFE7,128,9960,4,85928,42289,43903
13442129,13442123,TXFE7,128,9961,2,85930,42290,43904
13442179,13442176,TXFE7,128,9961,1,85931,42291,43905
13442192,13442185,TXFE7,128,9961,2,85933,42292,43906
13442192,13442190,TXFE7,128,9960,1,85934,42293,43907
13442204,13442204,TXFE7,128,9960,10,85944,42297,43908
13442254,13442251,TXFE7,128,9960,2,85946,42298,43909
13442267,13442262,TXFE7,128,9961,1,85947,42299,43910
13442279,13442268,TXFE7,128,9960,1,85948,42300,43911
13442304,13442296,TXFE7,128,9960,10,85958,42305,43912
13442317,13442309,TXFE7,128,9960,10,85968,42310,43913
13442329,13442317,TXFE7,128,9960,10,85978,42313,43914
13442329,13442326,TXFE7,128,9960,10,85988,42318,43915
13442342,13442329,TXFE7,128,9960,6,85994,42322,43916
13442342,13442329,TXFE7,128,9960,2,85996,42323,43917
13442354,13442343,TXFE7,128,9960,10,86006,42328,43918
13442367,13442354,TXFE7,128,9960,1,86007,42329,43919
13442367,13442354,TXFE7,128,9960,20,86027,42332,43920
13442367,13442363,TXFE7,128,9960,10,86037,42333,43921
13442367,13442363,TXFE7,128,9961,1,86038,42334,43922
13442367,13442364,TXFE7,128,9960,5,86043,42337,43923
13442367,13442364,TXFE7,128,9960,1,86044,42338,43924
13442379,13442367,TXFE7,128,9960,7,86051,42343,43925
13442379,13442368,TXFE7,128,9961,1,86052,42344,43926
13442379,13442371,TXFE7,128,9960,5,86057,42349,43927
13442379,13442372,TXFE7,128,9961,1,86058,42350,43928
13442379,13442372,TXFE7,128,9960,10,86068,42355,43929
13442379,13442375,TXFE7,128,9961,1,86069,42356,43930
13442379,13442378,TXFE7,128,9960,6,86075,42361,43931
13442379,13442378,TXFE7,128,9960,15,86090,42369,43932
13442379,13442379,TXFE7,128,9960,16,86106,42378,43933
13442392,13442379,TXFE7,129,9960,3,86111,42383,43934
13442392,13442379,TXFE7,129,9959,2,86111,42383,43934
13442392,13442381,TXFE7,128,9961,1,86112,42384,43935
13442392,13442391,TXFE7,128,9959,4,86116,42386,43936
13442404,13442394,TXFE7,128,9959,20,86136,42387,43937
13442404,13442397,TXFE7,128,9959,10,86146,42390,43938
13442404,13442399,TXFE7,128,9960,1,86147,42391,43939
13442417,13442405,TXFE7,128,9959,9,86156,42396,43940
13442417,13442410,TXFE7,128,9959,6,86162,42398,43941
13442429,13442422,TXFE7,128,9960,2,86164,42399,43942
13442442,13442430,TXFE7,128,9960,1,86165,42400,43943
13442467,13442460,TXFE7,128,9960,3,86168,42401,43945
13442467,13442466,TXFE7,128,9960,5,86173,42402,43946
13442479,13442479,TXFE7,128,9960,1,86174,42403,43947
13442492,13442482,TXFE7,128,9960,1,86175,42404,43948
13442517,13442510,TXFE7,128,9959,4,86179,42406,43949
13442517,13442510,TXFE7,128,9960,1,86180,42407,43950
13442554,13442542,TXFE7,128,9960,2,86182,42408,43951
13442554,13442550,TXFE7,128,9960,2,86184,42409,43952
13442567,13442559,TXFE7,128,9960,2,86186,42410,43953
13442567,13442560,TXFE7,128,9960,2,86188,42411,43954
13442567,13442563,TXFE7,128,9960,1,86189,42412,43955
13442617,13442613,TXFE7,128,9959,3,86192,42413,43956
13442629,13442627,TXFE7,128,9959,3,86195,42414,43957
13442642,13442633,TXFE7,128,9959,2,86197,42415,43958
13442654,13442648,TXFE7,128,9960,1,86198,42416,43959
13442654,13442654,TXFE7,128,9960,1,86199,42417,43960
13442704,13442698,TXFE7,128,9959,4,86203,42418,43961
13442704,13442702,TXFE7,128,9959,2,86205,42419,43962
13442717,13442706,TXFE7,128,9960,11,86216,42420,43965
13442729,13442727,TXFE7,128,9960,6,86222,42421,43967
13442767,13442766,TXFE7,128,9960,3,86225,42422,43968
13442829,13442817,TXFE7,128,9960,1,86226,42423,43969
13442879,13442872,TXFE7,128,9960,1,86227,42424,43970
13442892,13442886,TXFE7,128,9960,1,86228,42425,43971
13442917,13442906,TXFE7,128,9960,1,86229,42426,43972
13442917,13442906,TXFE7,128,9960,1,86230,42427,43973
13442929,13442917,TXFE7,128,9959,2,86232,42428,43974
13442967,13442958,TXFE7,128,9960,1,86233,42429,43975
13443029,13443023,TXFE7,128,9959,1,86234,42430,43976
13443042,13443041,TXFE7,128,9960,1,86235,42431,43977
13443054,13443046,TXFE7,128,9959,5,86240,42432,43978
13443054,13443052,TXFE7,128,9959,1,86241,42433,43979
13443067,13443065,TXFE7,128,9959,5,86246,42434,43980
13443079,13443071,TXFE7,128,9960,1,86247,42435,43981
13443117,13443115,TXFE7,128,9960,1,86248,42436,43982
13443129,13443117,TXFE7,128,9960,1,86249,42437,43983
13443167,13443160,TXFE7,128,9960,1,86250,42438,43984
13443167,13443164,TXFE7,128,9960,1,86251,42439,43985
13443192,13443187,TXFE7,128,9959,1,86252,42440,43986
13443217,13443215,TXFE7,128,9959,2,86254,42441,43987
13443229,13443223,TXFE7,128,9959,1,86255,42442,43988
13443242,13443236,TXFE7,128,9960,1,86256,42443,43989
13443254,13443244,TXFE7,128,9960,1,86257,42444,43990
13443267,13443257,TXFE7,128,9960,1,86258,42445,43991
13443267,13443259,TXFE7,128,9960,5,86263,42446,43992
13443267,13443262,TXFE7,128,9960,1,86264,42447,43993
13443279,13443272,TXFE7,128,9960,5,86269,42448,43994
13443279,13443279,TXFE7,128,9960,1,86270,42449,43995
13443292,13443283,TXFE7,128,9960,12,86282,42450,43999
13443304,13443296,TXFE7,128,9960,5,86287,42451,44001
13443317,13443309,TXFE7,128,9960,5,86292,42452,44002
13443342,13443337,TXFE7,128,9959,2,86294,42454,44003
13443392,13443383,TXFE7,128,9960,1,86295,42455,44004
13443404,13443399,TXFE7,128,9960,7,86302,42456,44005
13443417,13443411,TXFE7,128,9960,2,86304,42457,44006
13443454,13443443,TXFE7,128,9960,1,86305,42458,44007
13443479,13443478,TXFE7,128,9959,10,86315,42461,44008
13443479,13443479,TXFE7,128,9960,5,86320,42462,44011
13443492,13443482,TXFE7,128,9960,1,86321,42463,44012
13443542,13443534,TXFE7,128,9960,1,86322,42464,44013
13443554,13443543,TXFE7,128,9960,1,86323,42465,44014
13443579,13443570,TXFE7,128,9960,1,86324,42466,44015
13443592,13443586,TXFE7,128,9960,3,86327,42467,44017
13443604,13443596,TXFE7,128,9959,5,86332,42471,44018
13443604,13443599,TXFE7,128,9960,1,86333,42472,44019
13443617,13443609,TXFE7,128,9959,10,86343,42480,44020
13443629,13443617,TXFE7,128,9960,1,86344,42481,44021
13443629,13443619,TXFE7,128,9960,2,86346,42482,44023
13443629,13443624,TXFE7,128,9959,1,86347,42483,44024
13443629,13443625,TXFE7,128,9959,1,86348,42484,44025
13443642,13443630,TXFE7,128,9960,1,86349,42485,44026
13443692,13443688,TXFE7,128,9960,2,86351,42486,44027
13443717,13443711,TXFE7,128,9960,1,86352,42487,44028
13443742,13443732,TXFE7,128,9960,1,86353,42488,44029
13443742,13443739,TXFE7,128,9959,1,86354,42489,44030
13443754,13443742,TXFE7,128,9959,2,86356,42490,44031
13443754,13443747,TXFE7,128,9960,2,86358,42491,44033
13443792,13443779,TXFE7,128,9960,2,86360,42492,44034
13443792,13443781,TXFE7,128,9960,3,86363,42493,44036
13443804,13443801,TXFE7,128,9959,1,86364,42494,44037
13443817,13443816,TXFE7,128,9960,1,86365,42495,44038
13443829,13443820,TXFE7,128,9959,1,86366,42496,44039
13443904,13443904,TXFE7,128,9959,2,86368,42497,44040
13444004,13443997,TXFE7,128,9959,1,86369,42498,44041
13444054,13444045,TXFE7,128,9959,2,86371,42499,44042
13444067,13444055,TXFE7,128,9960,1,86372,42500,44043
13444067,13444062,TXFE7,128,9960,1,86373,42501,44044
13444079,13444075,TXFE7,128,9960,1,86374,42502,44045
13444092,13444083,TXFE7,128,9959,1,86375,42503,44046
13444117,13444117,TXFE7,128,9960,3,86378,42504,44048
13444129,13444122,TXFE7,128,9959,1,86379,42505,44049
13444154,13444154,TXFE7,128,9960,5,86384,42506,44050
13444204,13444198,TXFE7,128,9959,1,86385,42507,44051
13444217,13444208,TXFE7,128,9959,1,86386,42508,44052
13444217,13444216,TXFE7,128,9960,1,86387,42509,44053
13444229,13444223,TXFE7,128,9960,1,86388,42510,44054
13444254,13444242,TXFE7,128,9960,5,86393,42511,44057
13444292,13444282,TXFE7,128,9960,1,86394,42512,44058
13444342,13444333,TXFE7,128,9960,1,86395,42513,44059
13444342,13444337,TXFE7,128,9959,1,86396,42514,44060
13444404,13444393,TXFE7,128,9960,1,86397,42515,44061
13444429,13444426,TXFE7,128,9959,1,86398,42516,44062
13444442,13444435,TXFE7,128,9959,1,86399,42517,44063
13444467,13444467,TXFE7,128,9960,3,86402,42518,44065
13444479,13444470,TXFE7,128,9959,4,86406,42519,44066
13444479,13444472,TXFE7,128,9959,2,86408,42520,44067
13444492,13444483,TXFE7,128,9960,7,86415,42521,44069
13444492,13444491,TXFE7,128,9960,2,86417,42522,44070
13444504,13444493,TXFE7,128,9959,1,86418,42523,44071
13444542,13444536,TXFE7,128,9959,1,86419,42524,44072
13444567,13444555,TXFE7,128,9960,1,86420,42525,44073
13444592,13444584,TXFE7,128,9959,1,86421,42526,44074
13444604,13444604,TXFE7,128,9959,1,86422,42527,44075
13444629,13444618,TXFE7,128,9959,4,86426,42528,44076
13444629,13444622,TXFE7,128,9960,3,86429,42529,44078
13444629,13444626,TXFE7,128,9959,2,86431,42530,44079
13444642,13444635,TXFE7,128,9959,1,86432,42531,44080
13444642,13444638,TXFE7,128,9960,1,86433,42532,44081
13444654,13444646,TXFE7,128,9960,10,86443,42533,44084
13444667,13444657,TXFE7,128,9960,2,86445,42534,44085
13444679,13444670,TXFE7,128,9959,1,86446,42535,44086
13444692,13444680,TXFE7,128,9960,1,86447,42536,44087
13444692,13444682,TXFE7,128,9960,5,86452,42537,44090
13444742,13444735,TXFE7,128,9959,1,86453,42538,44091
13444754,13444754,TXFE7,128,9960,1,86454,42539,44092
13444767,13444767,TXFE7,128,9959,2,86456,42540,44093
13444779,13444778,TXFE7,128,9960,1,86457,42541,44094
13444792,13444780,TXFE7,128,9959,5,86462,42542,44095
13444804,13444794,TXFE7,128,9959,1,86463,42543,44096
13444804,13444803,TXFE7,128,9960,8,86471,42544,44097
13444817,13444813,TXFE7,128,9959,1,86472,42545,44098
13444829,13444827,TXFE7,128,9960,1,86473,42546,44099
13444829,13444827,TXFE7,128,9960,9,86482,42547,44100
13444842,13444837,TXFE7,128,9959,1,86483,42548,44101
13444842,13444837,TXFE7,128,9960,6,86489,42549,44102
13444879,13444870,TXFE7,128,9959,1,86490,42550,44103
13444942,13444937,TXFE7,128,9959,1,86491,42551,44104
13444954,13444942,TXFE7,128,9959,70,86561,42567,44105
13444954,13444950,TXFE7,128,9959,5,86566,42568,44106
13444979,13444968,TXFE7,128,9960,3,86569,42569,44107
13444992,13444984,TXFE7,128,9959,16,86585,42575,44108
13445004,13444993,TXFE7,128,9959,1,86586,42576,44109
13445004,13444996,TXFE7,128,9959,2,86588,42578,44110
13445042,13445037,TXFE7,128,9959,1,86589,42579,44111
13445054,13445042,TXFE7,128,9959,2,86591,42581,44112
13445054,13445048,TXFE7,128,9959,1,86592,42582,44113
13445054,13445052,TXFE7,128,9960,1,86593,42583,44114
13445067,13445057,TXFE7,128,9959,15,86608,42585,44115
13445067,13445060,TXFE7,128,9960,1,86609,42586,44116
13445067,13445067,TXFE7,128,9959,1,86610,42587,44117
13445079,13445068,TXFE7,128,9960,3,86613,42588,44118
13445079,13445079,TXFE7,128,9960,1,86614,42589,44119
13445092,13445080,TXFE7,128,9960,1,86615,42590,44120
13445092,13445086,TXFE7,128,9959,6,86621,42595,44121
13445092,13445089,TXFE7,128,9960,1,86622,42596,44122
13445092,13445089,TXFE7,128,9960,5,86627,42597,44123
13445104,13445098,TXFE7,128,9959,1,86628,42598,44124
13445104,13445098,TXFE7,128,9959,1,86629,42599,44125
13445104,13445102,TXFE7,128,9959,1,86630,42600,44126
13445104,13445102,TXFE7,128,9959,1,86631,42601,44127
13445117,13445112,TXFE7,128,9960,2,86633,42602,44129
13445129,13445120,TXFE7,128,9959,2,86635,42604,44130
13445129,13445128,TXFE7,128,9960,4,86639,42605,44131
13445142,13445137,TXFE7,128,9959,1,86640,42606,44132
13445142,13445137,TXFE7,128,9959,1,86641,42607,44133
13445154,13445154,TXFE7,128,9959,5,86646,42608,44134
13445179,13445178,TXFE7,128,9960,2,86648,42609,44136
13445229,13445217,TXFE7,128,9959,10,86658,42614,44137
13445229,13445217,TXFE7,128,9960,5,86663,42615,44138
13445229,13445227,TXFE7,128,9960,35,86698,42616,44139
13445254,13445242,TXFE7,128,9959,3,86701,42617,44140
13445267,13445259,TXFE7,128,9960,1,86702,42618,44141
13445267,13445260,TXFE7,128,9959,1,86703,42619,44142
13445279,13445267,TXFE7,128,9960,2,86705,42620,44144
13445292,13445289,TXFE7,128,9960,2,86707,42621,44145
13445292,13445289,TXFE7,128,9960,3,86710,42622,44147
13445304,13445294,TXFE7,128,9960,2,86712,42623,44148
13445304,13445303,TXFE7,128,9960,1,86713,42624,44149
13445317,13445313,TXFE7,128,9960,2,86715,42625,44150
13445329,13445322,TXFE7,128,9959,5,86720,42627,44151
13445367,13445361,TXFE7,128,9960,1,86721,42628,44152
13445379,13445370,TXFE7,128,9959,2,86723,42629,44153
13445379,13445376,TXFE7,128,9960,2,86725,42630,44155
13445404,13445395,TXFE7,128,9960,23,86748,42631,44161
13445404,13445403,TXFE7,128,9959,5,86753,42632,44162
13445442,13445435,TXFE7,128,9960,1,86754,42633,44163
13445454,13445445,TXFE7,128,9959,6,86760,42634,44164
13445454,13445446,TXFE7,128,9959,13,86773,42638,44165
13445467,13445455,TXFE7,128,9959,5,86778,42640,44166
13445467,13445464,TXFE7,128,9960,5,86783,42641,44167
13445479,13445469,TXFE7,128,9960,1,86784,42642,44168
13445479,13445477,TXFE7,128,9960,1,86785,42643,44169
13445492,13445482,TXFE7,128,9960,1,86786,42644,44170
13445492,13445485,TXFE7,128,9960,5,86791,42645,44173
13445492,13445489,TXFE7,128,9960,2,86793,42646,44175
13445492,13445489,TXFE7,128,9960,2,86795,42647,44177
13445492,13445489,TXFE7,128,9960,2,86797,42648,44178
13445492,13445489,TXFE7,128,9960,2,86799,42649,44179
13445492,13445489,TXFE7,128,9960,2,86801,42650,44180
13445492,13445489,TXFE7,128,9960,2,86803,42651,44181
13445492,13445489,TXFE7,128,9960,1,86804,42652,44182
13445492,13445490,TXFE7,128,9959,1,86805,42653,44183
13445504,13445492,TXFE7,128,9960,2,86807,42654,44185
13445504,13445492,TXFE7,128,9960,2,86809,42655,44186
13445504,13445495,TXFE7,128,9960,1,86810,42656,44187
13445517,13445506,TXFE7,128,9959,2,86812,42657,44188
13445567,13445558,TXFE7,128,9959,4,86816,42660,44189
13445579,13445569,TXFE7,128,9960,1,86817,42661,44190
13445579,13445574,TXFE7,128,9959,1,86818,42662,44191
13445592,13445588,TXFE7,128,9960,4,86822,42663,44193
13445604,13445599,TXFE7,128,9959,2,86824,42665,44194
13445604,13445601,TXFE7,128,9960,1,86825,42666,44195
13445629,13445622,TXFE7,128,9960,1,86826,42667,44196
13445654,13445652,TXFE7,128,9959,1,86827,42668,44197
13445667,13445664,TXFE7,128,9959,1,86828,42669,44198
13445704,13445694,TXFE7,128,9959,3,86831,42670,44199
13445704,13445696,TXFE7,128,9960,1,86832,42671,44200
13445717,13445707,TXFE7,128,9959,6,86838,42673,44201
13445729,13445717,TXFE7,128,9960,1,86839,42674,44202
13445742,13445735,TXFE7,128,9960,1,86840,42675,44203
13445754,13445753,TXFE7,128,9960,10,86850,42676,44209
13445767,13445762,TXFE7,128,9959,2,86852,42678,44210
13445792,13445791,TXFE7,128,9960,5,86857,42679,44214
13445829,13445826,TXFE7,128,9960,2,86859,42680,44216
13445854,13445849,TXFE7,128,9960,1,86860,42681,44217
13445854,13445853,TXFE7,128,9960,1,86861,42682,44218
13445867,13445857,TXFE7,128,9959,1,86862,42683,44219
13445867,13445864,TXFE7,128,9959,8,86870,42689,44220
13445867,13445865,TXFE7,128,9960,1,86871,42690,44221
13445892,13445880,TXFE7,128,9959,1,86872,42691,44222
13445904,13445896,TXFE7,128,9960,1,86873,42692,44223
13445904,13445898,TXFE7,128,9958,1,86874,42693,44224
13445942,13445938,TXFE7,128,9960,1,86875,42694,44225
13445979,13445971,TXFE7,128,9959,1,86876,42695,44226
13450004,13445998,TXFE7,128,9959,2,86878,42696,44227
